Roll_Code,Math Marks,English Marks,Science_Marks,Total Marks,Year
2022_B10001,95,96,38,229,2021
2019_B10002,41,55,92,188,2019
2019_B10003,23,51,33,107,2019
2022_A10004,70,64,41,175,2021
2022_B10005,53,33,30,116,2021
2022_B10006,44,12,55,111,2022
2019_C10007,0,91,34,125,2022
2022_B10008,31,84,79,194,2019
2021_C10009,60,70,27,157,2019
2019_A10010,87,59,98,244,2022
2021_C10011,11,32,91,134,2022
2021_C10012,6,28,67,101,2019
2022_C10013,54,82,85,221,2021
2022_B10014,51,41,39,131,2022
2021_B10015,2,32,93,127,2019
2021_B10016,61,78,86,225,2022
2022_A10017,41,50,21,112,2021
2021_C10018,40,36,45,121,2019
2019_B10019,62,17,48,127,2022
2022_C10020,39,93,99,231,2021
2021_B10021,92,13,27,132,2022
2019_B10022,19,14,68,101,2019
2021_A10023,43,20,65,128,2019
2019_C10024,65,20,26,111,2021
2021_A10025,83,83,34,200,2019
2021_B10026,29,31,75,135,2022
2019_B10027,16,61,64,141,2019
2021_C10028,73,66,34,173,2022
2022_B10029,27,37,32,96,2019
2019_A10030,82,76,70,228,2019
2021_C10031,66,93,58,217,2021
2022_A10032,26,28,36,90,2022
2019_A10033,56,30,71,157,2021
2022_A10034,29,32,78,139,2022
2019_B10035,42,22,80,144,2021
2022_A10036,88,36,94,218,2022
2022_A10037,79,31,61,171,2019
2021_A10038,40,58,22,120,2019
2021_A10039,25,40,78,143,2019
2022_C10040,57,37,52,146,2022
2022_A10041,38,54,95,187,2019
2019_B10042,39,81,58,178,2019
2019_A10043,13,69,83,165,2019
2019_C10044,31,32,39,102,2019
2021_B10045,26,87,60,173,2021
2022_C10046,65,18,69,152,2021
2022_C10047,7,33,47,87,2019
2021_A10048,100,19,48,167,2019
2022_A10049,45,51,56,152,2019
2022_C10050,68,64,48,180,2019
2019_A10051,76,97,52,225,2021
2019_A10052,74,70,66,210,2021
2022_A10053,55,30,88,173,2022
2019_A10054,20,86,84,190,2021
2022_A10055,40,16,49,105,2019
2021_B10056,90,93,73,256,2022
2022_B10057,83,52,80,215,2022
2019_A10058,71,33,30,134,2021
2021_B10059,61,14,53,128,2019
2022_A10060,73,20,58,151,2021
2019_B10061,36,92,72,200,2019
2021_B10062,12,39,86,137,2021
2019_A10063,55,32,98,185,2022
2022_A10064,48,19,44,111,2021
2019_C10065,9,76,71,156,2021
2022_B10066,1,96,25,122,2021
2019_B10067,64,29,43,136,2019
2022_A10068,83,35,43,161,2019
2019_C10069,50,51,53,154,2019
2022_C10070,80,66,63,209,2022
2019_C10071,52,46,31,129,2022
2022_C10072,60,74,52,186,2022
2022_C10073,10,51,55,116,2019
2021_C10074,10,27,85,122,2019
2019_C10075,98,35,83,216,2021
2022_B10076,41,42,60,143,2022
2021_C10077,61,32,44,137,2022
2019_C10078,13,27,41,81,2021
2021_A10079,1,86,96,183,2019
2021_A10080,81,87,83,251,2019
2021_B10081,0,53,94,147,2022
2021_B10082,28,63,36,127,2022
2021_B10083,68,86,36,190,2021
2019_B10084,88,17,23,128,2019
2022_C10085,59,93,54,206,2022
2022_A10086,64,96,50,210,2021
2019_C10087,24,54,55,133,2021
2021_B10088,26,42,37,105,2022
2019_A10089,20,27,85,132,2019
2021_B10090,91,39,93,223,2022
2022_B10091,50,85,70,205,2019
2019_A10092,25,44,83,152,2021
2022_A10093,54,71,59,184,2021
2022_A10094,30,83,96,209,2022
2019_C10095,90,94,21,205,2019
2021_C10096,27,15,63,105,2021
2022_C10097,64,18,84,166,2019
2021_C10098,27,24,56,107,2022
2022_B10099,48,59,90,197,2021
2022_C10100,16,80,82,178,2019
2021_A10101,6,39,34,79,2022
2019_B10102,99,83,32,214,2022
2021_B10103,30,59,57,146,2021
2021_B10104,100,40,41,181,2021
2021_A10105,7,95,54,156,2022
2019_A10106,6,14,51,71,2022
2022_A10107,74,87,71,232,2022
2021_B10108,94,92,55,241,2021
2019_C10109,49,68,45,162,2021
2021_A10110,52,77,75,204,2019
2021_A10111,27,14,50,91,2019
2022_B10112,70,47,53,170,2021
2021_B10113,3,66,60,129,2019
2022_B10114,54,81,90,225,2022
2019_B10115,38,60,29,127,2021
2021_A10116,85,27,49,161,2021
2022_A10117,38,54,66,158,2021
2021_C10118,91,90,61,242,2021
2019_B10119,81,94,75,250,2022
2019_B10120,46,31,48,125,2019
2022_B10121,17,78,72,167,2022
2019_A10122,30,79,49,158,2022
2021_A10123,27,40,29,96,2021
2019_A10124,98,65,97,260,2021
2021_C10125,86,56,27,169,2019
2019_C10126,91,31,94,216,2019
2019_C10127,44,54,44,142,2021
2021_C10128,46,16,61,123,2022
2022_A10129,92,55,39,186,2019
2022_C10130,21,50,40,111,2022
2022_B10131,68,58,60,186,2019
2019_C10132,87,30,27,144,2021
2022_A10133,78,32,80,190,2019
2021_C10134,72,58,92,222,2019
2022_A10135,95,39,35,169,2022
2019_C10136,93,59,38,190,2022
2019_A10137,18,74,80,172,2019
2019_C10138,57,32,73,162,2021
2019_A10139,42,60,24,126,2022
2021_A10140,52,71,99,222,2022
2021_C10141,34,20,72,126,2021
2021_B10142,89,84,78,251,2022
2022_A10143,100,55,35,190,2019
2021_B10144,27,17,64,108,2019
2022_B10145,85,57,39,181,2021
2022_A10146,78,52,54,184,2022
2022_A10147,99,23,45,167,2022
2019_A10148,54,29,81,164,2021
2021_C10149,49,58,67,174,2022
2022_B10150,4,36,95,135,2019
2021_A10151,84,83,86,253,2021
2021_B10152,91,60,83,234,2021
2022_B10153,82,84,93,259,2019
2019_A10154,70,74,93,237,2021
2022_B10155,81,72,82,235,2022
2019_B10156,53,82,40,175,2022
2022_C10157,18,20,79,117,2019
2021_A10158,14,83,37,134,2022
2022_A10159,1,88,92,181,2021
2022_C10160,80,75,33,188,2019
2019_C10161,25,39,36,100,2022
2021_A10162,29,36,82,147,2022
2022_B10163,58,21,63,142,2022
2022_C10164,58,46,60,164,2019
2019_B10165,27,58,42,127,2022
2021_A10166,7,12,39,58,2022
2019_B10167,37,41,80,158,2019
2021_A10168,25,73,99,197,2022
2021_B10169,61,65,21,147,2019
2022_B10170,1,70,82,153,2021
2022_B10171,33,91,92,216,2022
2019_A10172,33,91,36,160,2022
2021_A10173,42,22,56,120,2019
2022_C10174,36,14,99,149,2021
2022_C10175,79,93,70,242,2022
2021_C10176,21,87,39,147,2021
2019_A10177,99,13,78,190,2022
2022_B10178,88,43,22,153,2022
2022_C10179,63,43,42,148,2021
2022_C10180,95,74,71,240,2019
2022_A10181,29,28,98,155,2021
2019_B10182,27,27,73,127,2019
2019_A10183,58,57,68,183,2022
2022_A10184,80,48,34,162,2022
2021_A10185,29,25,27,81,2021
2022_B10186,12,92,47,151,2019
2019_C10187,71,21,92,184,2021
2019_A10188,31,16,30,77,2021
2021_C10189,47,84,88,219,2019
2021_C10190,33,95,76,204,2019
2019_B10191,5,72,33,110,2022
2019_C10192,59,13,54,126,2022
2022_C10193,13,90,41,144,2019
2019_C10194,81,46,50,177,2022
2019_B10195,54,50,87,191,2022
2021_C10196,95,62,26,183,2019
2019_C10197,55,25,47,127,2022
2022_B10198,71,54,66,191,2019
2022_B10199,31,97,34,162,2019
2019_C10200,69,80,49,198,2021
2022_B10201,95,34,48,177,2021
2021_C10202,92,41,25,158,2019
2022_B10203,42,61,67,170,2019
2021_C10204,43,40,30,113,2022
2022_A10205,91,58,24,173,2022
2022_A10206,44,45,31,120,2022
2022_C10207,48,82,79,209,2019
2019_A10208,58,54,67,179,2021
2019_B10209,33,86,40,159,2021
2021_B10210,28,90,43,161,2022
2019_C10211,61,58,91,210,2021
2021_A10212,5,54,41,100,2022
2021_C10213,51,86,84,221,2022
2022_A10214,4,29,92,125,2019
2022_B10215,29,73,48,150,2022
2022_C10216,10,27,88,125,2019
2021_A10217,56,55,85,196,2021
2019_C10218,8,69,60,137,2019
2019_B10219,28,23,98,149,2022
2019_A10220,40,52,72,164,2021
2019_B10221,95,86,86,267,2021
2021_B10222,98,36,49,183,2022
2019_B10223,12,33,88,133,2021
2019_B10224,34,80,39,153,2022
2022_C10225,73,93,81,247,2021
2022_A10226,50,77,25,152,2019
2021_B10227,9,52,23,84,2021
2021_B10228,30,70,49,149,2019
2019_A10229,72,25,93,190,2019
2022_C10230,44,52,22,118,2019
2021_C10231,43,51,51,145,2022
2019_A10232,12,60,42,114,2021
2019_B10233,25,88,66,179,2021
2019_C10234,32,78,53,163,2019
2022_A10235,46,69,21,136,2022
2022_C10236,39,22,77,138,2021
2022_C10237,99,26,81,206,2021
2021_C10238,21,86,31,138,2021
2021_A10239,23,72,87,182,2021
2021_C10240,83,27,59,169,2022
2022_A10241,73,92,86,251,2021
2022_B10242,63,93,25,181,2021
2022_B10243,86,21,52,159,2019
2021_C10244,61,77,28,166,2021
2019_B10245,93,26,92,211,2019
2022_B10246,14,85,44,143,2019
2021_A10247,98,60,57,215,2022
2022_B10248,13,19,55,87,2021
2019_B10249,56,81,55,192,2021
2022_A10250,12,19,78,109,2019
2022_B10251,98,90,84,272,2019
2019_C10252,76,91,35,202,2022
2021_A10253,17,57,30,104,2019
2021_B10254,78,54,29,161,2021
2022_A10255,53,74,77,204,2022
2019_A10256,10,47,95,152,2021
2019_B10257,88,46,32,166,2022
2021_A10258,86,27,50,163,2019
2022_B10259,92,23,62,177,2019
2019_A10260,43,17,59,119,2021
2019_A10261,59,23,58,140,2021
2021_B10262,12,70,32,114,2019
2019_C10263,64,28,30,122,2019
2019_A10264,89,65,40,194,2019
2019_B10265,100,78,53,231,2021
2021_B10266,53,78,29,160,2021
2021_B10267,98,49,71,218,2021
2019_C10268,81,33,66,180,2021
2019_B10269,47,43,65,155,2019
2021_B10270,77,15,38,130,2022
2021_A10271,67,71,36,174,2019
2021_C10272,38,46,56,140,2019
2021_B10273,94,25,21,140,2021
2019_A10274,87,52,94,233,2019
2021_B10275,43,19,79,141,2021
2019_C10276,46,43,92,181,2019
2022_B10277,17,74,53,144,2019
2019_C10278,79,27,35,141,2019
2021_C10279,67,79,47,193,2021
2019_C10280,30,64,69,163,2021
2019_A10281,26,32,56,114,2022
2019_C10282,42,12,76,130,2022
2022_A10283,35,49,57,141,2019
2019_B10284,3,59,73,135,2021
2019_A10285,65,82,80,227,2021
2019_C10286,4,30,85,119,2019
2021_A10287,95,11,53,159,2022
2022_B10288,47,54,40,141,2022
2019_C10289,49,19,65,133,2022
2021_C10290,12,97,55,164,2019
2022_B10291,81,47,49,177,2019
2019_B10292,92,59,58,209,2019
2019_C10293,14,87,50,151,2022
2021_B10294,0,79,73,152,2019
2022_B10295,93,72,32,197,2022
2022_A10296,58,17,56,131,2022
2022_C10297,74,20,93,187,2019
2019_A10298,87,95,25,207,2021
2022_A10299,69,30,67,166,2021
2022_B10300,68,28,45,141,2021
2019_C10301,80,27,99,206,2021
2022_B10302,14,71,34,119,2021
2022_C10303,16,38,50,104,2022
2021_B10304,84,48,34,166,2021
2022_A10305,20,30,74,124,2022
2022_C10306,43,19,88,150,2021
2022_B10307,30,39,42,111,2019
2021_A10308,42,23,50,115,2019
2019_B10309,59,77,93,229,2021
2021_C10310,91,95,69,255,2021
2021_A10311,63,54,43,160,2022
2021_A10312,1,11,41,53,2021
2019_C10313,60,61,29,150,2019
2019_B10314,74,26,24,124,2019
2019_C10315,32,61,82,175,2019
2019_A10316,69,89,78,236,2022
2022_C10317,35,19,48,102,2021
2021_A10318,4,43,69,116,2021
2019_B10319,18,87,55,160,2022
2019_C10320,7,44,96,147,2019
2022_A10321,31,21,53,105,2019
2022_C10322,80,83,54,217,2022
2021_C10323,73,63,27,163,2021
2021_B10324,43,70,40,153,2022
2019_A10325,8,67,37,112,2019
2019_C10326,77,78,41,196,2019
2021_B10327,88,30,39,157,2019
2019_A10328,79,97,36,212,2019
2022_B10329,78,14,79,171,2021
2021_B10330,92,40,97,229,2019
2022_A10331,15,26,63,104,2019
2021_B10332,26,56,58,140,2022
2021_C10333,9,89,58,156,2022
2021_C10334,71,13,23,107,2019
2022_A10335,19,15,32,66,2019
2019_B10336,32,51,85,168,2021
2022_A10337,28,35,85,148,2019
2021_A10338,9,89,23,121,2019
2019_B10339,37,80,66,183,2019
2019_B10340,71,89,53,213,2021
2022_C10341,59,16,73,148,2019
2022_A10342,9,71,95,175,2019
2019_B10343,3,82,81,166,2021
2022_C10344,23,85,61,169,2019
2019_C10345,15,71,68,154,2019
2022_A10346,29,25,31,85,2022
2022_A10347,82,91,84,257,2022
2021_A10348,52,77,29,158,2021
2021_B10349,82,49,28,159,2021
2019_A10350,88,40,33,161,2021
2021_C10351,55,25,55,135,2022
2021_C10352,92,52,92,236,2022
2019_B10353,64,25,33,122,2019
2022_C10354,8,18,53,79,2019
2021_C10355,87,29,36,152,2019
2019_B10356,1,73,67,141,2019
2019_B10357,92,93,77,262,2021
2019_A10358,64,97,72,233,2022
2022_C10359,69,33,98,200,2022
2021_C10360,93,96,38,227,2019
2022_A10361,62,48,22,132,2019
2022_B10362,94,80,95,269,2021
2019_C10363,51,92,85,228,2019
2021_A10364,9,53,96,158,2019
2019_A10365,0,34,51,85,2021
2021_A10366,20,20,31,71,2019
2022_C10367,21,38,68,127,2019
2021_A10368,38,38,94,170,2019
2021_C10369,16,32,95,143,2021
2022_B10370,48,48,54,150,2021
2022_C10371,95,26,30,151,2019
2022_B10372,8,70,43,121,2021
2022_C10373,51,27,89,167,2019
2019_A10374,56,77,30,163,2022
2022_A10375,24,19,31,74,2019
2022_C10376,65,22,78,165,2022
2019_B10377,76,90,51,217,2021
2021_B10378,42,14,93,149,2021
2019_C10379,84,84,37,205,2021
2021_B10380,47,74,27,148,2022
2021_B10381,46,82,41,169,2019
2021_A10382,66,61,28,155,2019
2021_C10383,86,16,90,192,2022
2019_B10384,22,52,39,113,2021
2022_A10385,41,67,23,131,2022
2022_A10386,53,76,63,192,2022
2022_B10387,8,96,97,201,2021
2019_B10388,2,50,94,146,2019
2019_A10389,19,11,30,60,2021
2022_B10390,56,61,88,205,2022
2021_C10391,97,42,63,202,2022
2022_A10392,52,79,97,228,2019
2019_C10393,60,28,80,168,2021
2019_A10394,63,44,38,145,2022
2019_C10395,89,59,21,169,2019
2021_B10396,92,14,46,152,2019
2019_A10397,81,19,98,198,2019
2022_C10398,7,11,53,71,2019
2022_B10399,7,42,59,108,2022
2021_B10400,33,79,73,185,2022
2021_A10401,72,54,64,190,2022
2022_B10402,60,86,93,239,2019
2022_C10403,45,35,72,152,2022
2019_B10404,57,14,87,158,2022
2022_B10405,44,12,33,89,2022
2021_B10406,74,91,96,261,2022
2019_A10407,50,35,80,165,2022
2021_A10408,94,93,88,275,2019
2022_A10409,85,49,90,224,2022
2022_C10410,1,73,60,134,2021
2022_C10411,78,92,54,224,2022
2019_B10412,41,38,98,177,2022
2022_A10413,75,38,77,190,2019
2021_B10414,40,76,86,202,2019
2022_C10415,68,29,99,196,2019
2021_B10416,70,57,50,177,2021
2019_C10417,13,75,62,150,2022
2022_B10418,98,28,30,156,2022
2022_A10419,35,76,33,144,2022
2019_A10420,93,29,52,174,2022
2022_C10421,62,22,57,141,2022
2019_A10422,53,54,24,131,2022
2021_A10423,54,50,45,149,2021
2019_B10424,29,83,96,208,2022
2019_B10425,32,90,68,190,2021
2021_A10426,36,49,54,139,2019
2022_A10427,32,53,58,143,2022
2021_C10428,76,81,83,240,2022
2019_B10429,85,61,98,244,2019
2019_C10430,63,75,35,173,2019
2019_C10431,86,64,46,196,2022
2019_C10432,38,37,39,114,2021
2022_C10433,2,41,76,119,2022
2019_C10434,28,69,63,160,2019
2021_B10435,56,60,82,198,2021
2022_C10436,44,28,28,100,2022
2019_A10437,57,60,31,148,2019
2019_A10438,41,69,66,176,2019
2021_B10439,39,78,24,141,2022
2019_B10440,5,24,65,94,2021
2021_C10441,18,76,61,155,2021
2022_A10442,89,66,79,234,2021
2022_B10443,26,97,28,151,2021
2021_A10444,72,73,91,236,2021
2021_C10445,19,78,52,149,2022
2022_C10446,90,32,30,152,2019
2021_B10447,89,86,77,252,2021
2021_B10448,32,75,49,156,2019
2019_C10449,39,85,36,160,2021
2021_A10450,8,55,63,126,2021
2019_A10451,79,29,30,138,2019
2019_A10452,73,48,39,160,2021
2022_C10453,58,92,84,234,2022
2019_A10454,97,23,40,160,2022
2022_C10455,32,57,58,147,2022
2019_C10456,34,61,53,148,2019
2021_A10457,52,31,40,123,2019
2019_A10458,99,70,62,231,2019
2022_B10459,27,89,22,138,2021
2019_C10460,95,50,25,170,2019
2021_A10461,15,96,45,156,2019
2022_A10462,83,38,28,149,2021
2019_C10463,43,72,71,186,2019
2019_A10464,29,78,39,146,2021
2021_A10465,93,32,51,176,2022
2019_C10466,5,77,23,105,2019
2021_C10467,45,36,76,157,2022
2019_C10468,41,62,35,138,2019
2019_A10469,61,35,85,181,2022
2022_C10470,58,13,85,156,2021
2022_A10471,18,28,56,102,2021
2019_A10472,95,39,53,187,2022
2019_A10473,61,90,65,216,2022
2019_C10474,51,94,88,233,2019
2022_B10475,76,39,47,162,2022
2021_C10476,72,67,92,231,2021
2022_A10477,90,82,50,222,2019
2019_B10478,39,71,53,163,2022
2019_A10479,86,49,43,178,2021
2019_C10480,69,26,95,190,2019
2019_A10481,90,87,81,258,2022
2019_B10482,67,89,70,226,2019
2022_B10483,69,71,47,187,2021
2022_B10484,25,92,35,152,2022
2021_B10485,8,49,57,114,2021
2019_B10486,25,85,56,166,2022
2021_B10487,64,21,29,114,2019
2022_C10488,34,87,95,216,2022
2022_C10489,83,11,86,180,2019
2019_C10490,22,50,24,96,2021
2021_B10491,21,77,30,128,2022
2019_C10492,12,75,48,135,2019
2019_A10493,23,68,27,118,2022
2022_A10494,14,84,79,177,2021
2022_B10495,16,72,80,168,2019
2019_A10496,88,64,58,210,2019
2021_A10497,87,35,53,175,2019
2022_B10498,44,34,94,172,2019
2021_B10499,22,38,21,81,2022
2021_A10500,64,42,54,160,2019
2022_B10501,25,55,81,161,2022
2021_C10502,64,60,74,198,2021
2022_B10503,63,50,83,196,2021
2022_B10504,10,72,99,181,2022
2021_C10505,16,38,26,80,2021
2022_C10506,67,77,66,210,2021
2021_B10507,86,95,26,207,2021
2021_B10508,53,78,89,220,2019
2021_C10509,60,62,77,199,2019
2022_C10510,86,58,93,237,2021
2022_A10511,37,69,23,129,2022
2021_B10512,37,32,68,137,2022
2021_B10513,77,27,60,164,2022
2022_A10514,43,69,53,165,2019
2019_B10515,70,60,83,213,2021
2022_A10516,5,27,99,131,2021
2019_B10517,57,12,72,141,2019
2021_A10518,85,48,97,230,2021
2021_C10519,44,74,29,147,2021
2022_B10520,47,95,27,169,2022
2019_B10521,8,93,80,181,2022
2021_B10522,40,30,54,124,2022
2021_A10523,5,34,46,85,2021
2022_B10524,63,19,51,133,2021
2019_A10525,3,79,86,168,2019
2019_B10526,75,87,83,245,2021
2022_C10527,6,16,76,98,2022
2022_A10528,2,83,51,136,2019
2021_B10529,52,63,74,189,2019
2019_A10530,16,66,35,117,2019
2019_A10531,29,21,91,141,2022
2022_A10532,88,72,64,224,2019
2021_B10533,45,93,60,198,2019
2021_A10534,15,67,85,167,2022
2019_A10535,13,97,73,183,2021
2022_B10536,47,65,48,160,2019
2019_B10537,81,36,64,181,2022
2021_A10538,24,20,75,119,2019
2019_B10539,15,37,60,112,2019
2019_A10540,55,53,52,160,2021
2021_B10541,12,94,86,192,2022
2022_A10542,0,82,43,125,2019
2022_B10543,54,71,98,223,2021
2021_A10544,6,19,32,57,2021
2022_A10545,17,26,67,110,2021
2021_B10546,24,91,28,143,2022
2019_A10547,45,66,29,140,2019
2022_B10548,78,41,24,143,2019
2019_C10549,51,77,80,208,2021
2019_A10550,99,39,67,205,2019
2021_B10551,23,26,32,81,2021
2022_B10552,10,61,97,168,2021
2021_B10553,33,39,77,149,2022
2021_C10554,52,46,72,170,2022
2022_B10555,99,60,23,182,2021
2021_B10556,74,36,21,131,2021
2019_B10557,8,80,24,112,2021
2021_A10558,24,48,91,163,2021
2021_A10559,35,47,42,124,2022
2019_B10560,91,74,54,219,2022
2022_C10561,60,53,43,156,2021
2021_B10562,90,66,70,226,2021
2022_B10563,96,30,33,159,2021
2021_B10564,91,63,97,251,2022
2021_C10565,47,42,58,147,2022
2019_A10566,32,92,50,174,2021
2022_C10567,36,65,54,155,2019
2022_C10568,53,42,45,140,2022
2022_A10569,20,43,35,98,2022
2022_C10570,3,84,49,136,2019
2021_A10571,9,67,30,106,2019
2022_C10572,83,74,55,212,2019
2019_C10573,29,16,51,96,2019
2022_A10574,63,22,62,147,2019
2021_A10575,43,24,98,165,2022
2022_B10576,28,53,76,157,2019
2019_A10577,4,86,38,128,2019
2022_B10578,81,57,74,212,2022
2022_A10579,18,91,59,168,2019
2021_C10580,11,69,91,171,2019
2022_A10581,80,48,25,153,2019
2021_C10582,64,19,72,155,2019
2022_C10583,78,70,90,238,2019
2022_B10584,77,42,36,155,2022
2021_B10585,49,63,27,139,2019
2022_C10586,69,81,40,190,2019
2019_B10587,6,26,75,107,2021
2019_C10588,94,13,44,151,2021
2019_C10589,59,86,22,167,2022
2019_B10590,52,75,45,172,2019
2019_A10591,69,39,78,186,2019
2019_A10592,83,92,24,199,2021
2019_A10593,27,30,73,130,2021
2019_A10594,6,65,78,149,2021
2019_A10595,89,82,22,193,2019
2022_A10596,30,92,51,173,2019
2019_A10597,5,77,59,141,2019
2022_A10598,82,92,81,255,2019
2021_C10599,85,96,87,268,2021
2022_A10600,39,56,91,186,2022
2019_A10601,17,83,91,191,2022
2021_B10602,47,77,54,178,2019
2022_A10603,96,81,63,240,2021
2019_B10604,52,62,91,205,2019
2021_C10605,76,12,63,151,2021
2019_B10606,89,89,83,261,2019
2022_A10607,80,30,61,171,2022
2022_A10608,9,42,93,144,2021
2019_B10609,60,23,87,170,2019
2019_B10610,41,25,53,119,2019
2022_A10611,0,34,90,124,2021
2021_A10612,53,43,24,120,2019
2021_B10613,30,16,88,134,2019
2021_A10614,100,57,64,221,2019
2019_B10615,53,72,83,208,2022
2021_C10616,3,40,79,122,2019
2021_C10617,55,41,80,176,2021
2022_A10618,70,50,27,147,2019
2022_B10619,42,94,85,221,2022
2021_B10620,73,68,24,165,2022
2019_C10621,23,26,44,93,2022
2021_A10622,89,33,91,213,2022
2022_C10623,68,81,87,236,2019
2019_C10624,69,42,95,206,2019
2021_B10625,90,68,84,242,2019
2021_C10626,88,82,22,192,2022
2019_B10627,28,45,42,115,2019
2019_B10628,8,45,26,79,2021
2021_B10629,52,65,31,148,2019
2021_C10630,69,39,93,201,2021
2019_B10631,52,59,69,180,2019
2019_B10632,32,12,41,85,2022
2022_A10633,38,96,98,232,2021
2019_A10634,16,65,57,138,2022
2019_C10635,92,74,71,237,2019
2022_B10636,44,40,98,182,2021
2022_C10637,93,45,89,227,2019
2019_C10638,5,94,56,155,2022
2021_C10639,65,17,69,151,2022
2021_B10640,90,37,59,186,2022
2019_A10641,18,56,85,159,2021
2022_C10642,36,70,83,189,2021
2021_A10643,34,54,35,123,2019
2019_A10644,81,20,39,140,2022
2022_A10645,94,66,57,217,2019
2019_B10646,45,38,88,171,2022
2019_A10647,32,45,52,129,2021
2022_C10648,79,42,77,198,2022
2021_A10649,27,60,52,139,2019
2021_C10650,74,31,44,149,2022
2021_A10651,21,84,39,144,2022
2021_C10652,67,13,26,106,2019
2022_B10653,79,57,71,207,2019
2019_C10654,82,94,68,244,2019
2019_B10655,34,74,41,149,2022
2022_A10656,32,52,63,147,2021
2021_C10657,49,86,71,206,2019
2021_B10658,58,76,73,207,2022
2022_C10659,50,81,69,200,2021
2021_B10660,100,45,84,229,2022
2022_C10661,63,73,60,196,2019
2022_C10662,50,66,94,210,2021
2022_B10663,7,74,33,114,2019
2022_B10664,77,68,84,229,2022
2022_B10665,43,69,22,134,2019
2022_B10666,71,46,76,193,2021
2021_C10667,98,87,59,244,2022
2021_C10668,55,26,33,114,2021
2019_A10669,39,65,25,129,2019
2022_C10670,34,75,33,142,2019
2021_C10671,22,67,86,175,2022
2022_A10672,92,26,34,152,2019
2022_B10673,1,32,72,105,2022
2019_C10674,4,40,50,94,2019
2022_B10675,80,35,58,173,2022
2021_C10676,38,84,51,173,2021
2022_A10677,8,11,40,59,2022
2019_B10678,56,21,27,104,2021
2019_A10679,80,80,44,204,2022
2021_C10680,43,49,79,171,2022
2022_B10681,14,37,67,118,2019
2019_A10682,29,40,60,129,2021
2019_A10683,46,52,95,193,2019
2021_C10684,3,46,89,138,2019
2022_B10685,92,93,82,267,2022
2021_A10686,38,74,89,201,2021
2022_B10687,25,53,97,175,2022
2021_C10688,68,24,38,130,2022
2021_A10689,93,93,44,230,2019
2021_B10690,50,38,54,142,2019
2021_C10691,64,12,39,115,2022
2022_A10692,31,27,87,145,2019
2019_B10693,76,20,23,119,2019
2021_A10694,44,39,94,177,2019
2021_C10695,77,73,66,216,2021
2021_A10696,93,24,85,202,2022
2021_C10697,73,69,74,216,2021
2022_B10698,79,92,97,268,2019
2021_C10699,55,17,85,157,2022
2019_A10700,79,94,56,229,2022
2022_C10701,55,87,60,202,2021
2022_B10702,66,31,23,120,2021
2022_C10703,98,82,61,241,2019
2019_A10704,12,71,94,177,2022
2022_B10705,31,69,62,162,2021
2021_C10706,35,94,87,216,2019
2022_A10707,97,86,46,229,2021
2019_A10708,14,17,32,63,2019
2022_A10709,89,82,52,223,2019
2021_A10710,0,48,61,109,2022
2022_C10711,31,49,63,143,2022
2021_B10712,1,89,99,189,2021
2021_B10713,83,86,90,259,2021
2019_C10714,51,64,52,167,2019
2021_B10715,37,95,56,188,2019
2021_B10716,98,87,23,208,2021
2021_A10717,49,53,85,187,2021
2021_A10718,85,80,85,250,2021
2021_A10719,36,80,29,145,2021
2019_B10720,47,53,87,187,2021
2019_C10721,29,33,81,143,2021
2022_A10722,73,53,76,202,2022
2019_B10723,20,35,38,93,2021
2022_B10724,3,31,70,104,2019
2021_C10725,11,13,91,115,2022
2021_B10726,87,37,71,195,2022
2021_C10727,7,26,90,123,2019
2022_C10728,86,88,70,244,2021
2022_C10729,15,78,74,167,2021
2022_C10730,44,73,90,207,2021
2019_B10731,60,80,58,198,2021
2021_C10732,51,61,24,136,2019
2021_B10733,22,13,79,114,2022
2022_C10734,72,27,82,181,2022
2021_C10735,70,28,75,173,2019
2021_B10736,68,32,93,193,2019
2021_A10737,68,15,42,125,2021
2019_B10738,34,25,44,103,2019
2022_B10739,18,62,81,161,2019
2019_C10740,69,67,88,224,2021
2021_C10741,85,63,55,203,2022
2022_A10742,74,12,82,168,2022
2022_A10743,54,57,91,202,2021
2021_A10744,62,54,58,174,2022
2022_A10745,97,95,40,232,2021
2019_A10746,52,25,97,174,2019
2019_C10747,40,15,93,148,2019
2022_A10748,84,64,86,234,2019
2021_A10749,94,72,70,236,2021
2022_B10750,27,35,48,110,2019
2021_A10751,33,13,95,141,2021
2019_C10752,80,94,75,249,2021
2021_A10753,5,84,44,133,2021
2022_C10754,72,65,97,234,2021
2019_C10755,95,28,80,203,2022
2019_C10756,39,93,23,155,2022
2021_B10757,10,84,37,131,2022
2022_A10758,67,72,52,191,2021
2022_B10759,9,94,89,192,2021
2022_A10760,41,52,73,166,2019
2022_A10761,5,87,28,120,2021
2019_C10762,54,59,34,147,2019
2021_B10763,99,17,61,177,2021
2021_A10764,34,97,42,173,2019
2019_B10765,90,44,77,211,2022
2021_A10766,46,55,97,198,2019
2022_C10767,40,83,86,209,2022
2019_C10768,83,41,70,194,2021
2019_C10769,15,79,51,145,2021
2019_A10770,85,20,50,155,2019
2022_A10771,72,73,85,230,2021
2021_C10772,16,74,87,177,2019
2019_A10773,65,69,66,200,2019
2021_C10774,23,95,61,179,2022
2021_B10775,34,54,56,144,2019
2021_C10776,36,55,27,118,2022
2022_A10777,58,59,27,144,2021
2022_B10778,68,87,38,193,2021
2022_B10779,82,23,88,193,2022
2019_A10780,54,16,80,150,2022
2021_C10781,42,64,30,136,2021
2019_C10782,48,55,53,156,2022
2019_A10783,78,90,79,247,2021
2022_A10784,64,50,82,196,2021
2021_B10785,20,94,41,155,2019
2021_A10786,33,63,37,133,2022
2021_A10787,64,12,45,121,2022
2019_B10788,96,89,63,248,2021
2019_A10789,31,83,78,192,2019
2022_C10790,75,95,31,201,2019
2021_A10791,63,22,22,107,2021
2022_C10792,92,83,65,240,2019
2019_A10793,27,41,54,122,2021
2021_A10794,67,74,60,201,2022
2019_B10795,19,50,85,154,2019
2022_A10796,34,73,85,192,2019
2019_A10797,34,73,88,195,2019
2019_A10798,98,63,48,209,2022
2021_B10799,31,36,38,105,2019
2021_B10800,65,44,49,158,2019
2019_B10801,50,81,25,156,2022
2022_C10802,76,87,65,228,2019
2021_C10803,49,62,71,182,2021
2022_A10804,73,18,25,116,2021
2021_A10805,72,53,84,209,2019
2022_B10806,35,86,79,200,2019
2022_C10807,28,88,58,174,2021
2021_A10808,36,91,77,204,2021
2021_A10809,89,46,54,189,2019
2021_C10810,6,96,92,194,2019
2019_A10811,81,35,75,191,2019
2021_B10812,99,15,37,151,2019
2021_A10813,16,92,48,156,2021
2022_B10814,20,14,79,113,2019
2022_B10815,45,77,77,199,2019
2022_C10816,41,86,75,202,2021
2021_A10817,48,46,97,191,2022
2021_A10818,75,33,81,189,2021
2019_A10819,17,40,95,152,2021
2019_C10820,92,41,92,225,2021
2022_B10821,37,39,61,137,2019
2019_A10822,41,49,75,165,2022
2019_C10823,51,51,68,170,2022
2021_B10824,69,96,90,255,2019
2022_B10825,70,39,74,183,2019
2019_B10826,52,81,74,207,2021
2019_B10827,53,14,86,153,2019
2019_A10828,96,30,63,189,2021
2021_C10829,6,96,41,143,2021
2022_C10830,27,46,24,97,2019
2022_A10831,70,20,80,170,2022
2019_A10832,3,54,58,115,2022
2021_B10833,11,16,80,107,2019
2019_B10834,3,47,92,142,2019
2021_A10835,43,58,39,140,2019
2021_B10836,8,15,38,61,2019
2022_C10837,7,54,39,100,2022
2022_C10838,15,23,83,121,2021
2021_C10839,67,41,30,138,2019
2019_A10840,41,49,69,159,2021
2019_B10841,39,67,86,192,2021
2019_A10842,51,33,58,142,2022
2021_B10843,95,48,30,173,2022
2021_B10844,35,35,54,124,2019
2019_C10845,96,46,90,232,2021
2022_A10846,41,86,39,166,2021
2022_B10847,47,15,73,135,2022
2021_B10848,68,88,56,212,2019
2022_A10849,29,64,21,114,2021
2022_C10850,79,95,41,215,2021
2022_B10851,17,78,89,184,2022
2022_B10852,11,18,48,77,2021
2019_A10853,33,31,73,137,2022
2019_C10854,57,12,70,139,2022
2022_A10855,65,57,51,173,2022
2021_B10856,26,86,45,157,2019
2019_A10857,31,70,95,196,2021
2022_A10858,82,46,51,179,2021
2022_B10859,99,38,22,159,2021
2019_C10860,58,26,64,148,2022
2019_B10861,50,45,46,141,2022
2019_A10862,74,82,55,211,2022
2021_B10863,1,74,58,133,2019
2019_B10864,53,92,93,238,2019
2021_C10865,80,45,55,180,2021
2022_B10866,69,42,55,166,2019
2022_A10867,100,50,25,175,2019
2021_B10868,53,71,23,147,2021
2019_A10869,31,69,31,131,2021
2022_C10870,38,64,90,192,2022
2022_C10871,67,15,43,125,2021
2019_A10872,2,36,93,131,2021
2022_B10873,30,48,55,133,2022
2022_C10874,30,58,28,116,2019
2019_A10875,36,74,88,198,2019
2019_B10876,47,48,55,150,2021
2021_C10877,60,81,26,167,2022
2022_C10878,12,88,68,168,2022
2021_B10879,11,90,41,142,2019
2022_A10880,40,96,88,224,2022
2019_A10881,31,36,85,152,2019
2019_C10882,69,71,96,236,2021
2019_B10883,8,91,57,156,2019
2021_C10884,54,86,91,231,2019
2019_C10885,33,33,45,111,2019
2021_B10886,61,70,91,222,2022
2021_A10887,51,71,99,221,2021
2019_A10888,37,63,66,166,2019
2019_C10889,26,51,39,116,2022
2019_A10890,92,26,35,153,2022
2021_B10891,0,82,88,170,2019
2022_A10892,73,31,76,180,2021
2021_B10893,10,26,89,125,2021
2021_B10894,57,89,38,184,2021
2021_B10895,35,55,36,126,2021
2019_B10896,76,83,74,233,2019
2021_B10897,100,24,42,166,2019
2021_C10898,47,94,55,196,2019
2021_C10899,10,63,48,121,2021
2022_A10900,75,11,74,160,2022
2021_A10901,65,95,51,211,2022
2021_C10902,78,52,56,186,2022
2021_C10903,7,42,81,130,2021
2021_B10904,38,71,56,165,2022
2022_B10905,0,14,70,84,2022
2022_B10906,5,61,72,138,2022
2022_A10907,16,85,36,137,2021
2022_A10908,25,43,59,127,2021
2022_A10909,90,25,23,138,2019
2022_C10910,19,80,62,161,2022
2021_A10911,4,46,40,90,2019
2019_A10912,82,47,83,212,2019
2022_A10913,82,76,66,224,2019
2019_A10914,41,77,84,202,2021
2022_C10915,10,96,86,192,2019
2021_B10916,43,46,27,116,2022
2022_A10917,73,96,64,233,2022
2022_A10918,54,78,79,211,2022
2022_B10919,19,68,88,175,2019
2021_C10920,17,85,32,134,2019
2022_B10921,47,64,50,161,2019
2021_C10922,8,56,94,158,2021
2022_C10923,16,24,86,126,2022
2019_C10924,7,22,66,95,2022
2021_B10925,74,83,23,180,2019
2022_B10926,7,57,49,113,2019
2019_C10927,31,59,59,149,2021
2022_A10928,26,83,82,191,2019
2021_C10929,52,96,79,227,2022
2019_A10930,91,47,97,235,2022
2021_B10931,95,19,77,191,2021
2019_B10932,77,80,56,213,2022
2021_B10933,89,33,54,176,2021
2019_C10934,100,28,69,197,2019
2021_B10935,30,61,89,180,2021
2021_C10936,54,41,94,189,2021
2021_B10937,68,17,89,174,2021
2022_A10938,46,42,93,181,2019
2022_C10939,91,35,91,217,2019
2021_C10940,37,64,37,138,2022
2022_C10941,66,14,33,113,2021
2022_C10942,88,92,21,201,2019
2019_A10943,87,18,54,159,2021
2021_A10944,2,90,88,180,2022
2022_C10945,83,82,73,238,2021
2022_A10946,86,35,59,180,2022
2021_C10947,94,81,61,236,2021
2019_A10948,87,89,79,255,2022
2021_B10949,95,68,81,244,2021
2019_B10950,92,59,90,241,2021
2021_A10951,70,89,51,210,2019
2022_B10952,40,30,76,146,2021
2022_C10953,99,95,79,273,2019
2022_C10954,79,42,83,204,2019
2021_B10955,92,33,39,164,2022
2019_B10956,97,65,27,189,2019
2022_C10957,10,14,56,80,2021
2019_B10958,83,53,89,225,2022
2021_A10959,83,53,22,158,2019
2019_B10960,90,43,45,178,2019
2022_C10961,14,18,51,83,2022
2021_A10962,11,31,73,115,2019
2022_A10963,4,62,76,142,2019
2019_C10964,58,16,24,98,2021
2022_A10965,3,69,57,129,2019
2022_B10966,70,13,76,159,2021
2021_C10967,100,75,24,199,2019
2021_C10968,9,50,89,148,2022
2021_B10969,27,61,67,155,2022
2021_B10970,11,45,41,97,2019
2019_C10971,26,45,48,119,2019
2021_C10972,75,32,21,128,2019
2021_C10973,89,28,92,209,2022
2021_C10974,71,82,98,251,2019
2021_C10975,52,85,68,205,2021
2021_B10976,81,39,38,158,2019
2022_A10977,79,34,39,152,2021
2022_C10978,89,51,52,192,2019
2021_C10979,25,52,75,152,2022
2021_C10980,34,58,33,125,2021
2019_A10981,75,31,85,191,2019
2022_C10982,74,37,70,181,2019
2022_B10983,67,91,24,182,2021
2022_B10984,62,92,67,221,2021
2019_C10985,68,18,76,162,2022
2019_A10986,50,69,44,163,2021
2021_C10987,75,21,56,152,2019
2021_C10988,33,48,85,166,2019
2019_C10989,13,26,82,121,2021
2022_B10990,6,83,63,152,2019
2019_B10991,71,39,96,206,2021
2021_B10992,9,48,96,153,2022
2022_C10993,39,21,29,89,2019
2019_B10994,59,58,54,171,2019
2019_B10995,78,52,38,168,2021
2022_A10996,47,75,33,155,2021
2022_B10997,33,61,76,170,2019
2022_B10998,88,55,49,192,2021
2022_A10999,90,13,75,178,2021
2021_C11000,32,33,40,105,2022
2019_C11001,74,24,67,165,2022
2019_B11002,23,88,84,195,2021
2019_A11003,27,37,46,110,2021
2019_B11004,92,18,41,151,2022
2022_A11005,67,96,93,256,2019
2022_B11006,60,16,79,155,2022
2022_C11007,84,42,28,154,2022
2022_C11008,31,80,91,202,2021
2022_B11009,53,69,30,152,2021
2021_B11010,26,88,33,147,2021
2022_A11011,93,37,22,152,2022
2021_C11012,56,72,62,190,2019
2022_B11013,97,87,87,271,2022
2021_B11014,51,44,52,147,2022
2022_A11015,4,78,42,124,2022
2019_A11016,7,52,55,114,2022
2022_C11017,85,96,30,211,2019
2022_A11018,25,74,32,131,2019
2022_C11019,21,13,35,69,2022
2019_C11020,1,88,70,159,2021
2021_C11021,93,53,60,206,2022
2019_C11022,24,12,55,91,2021
2019_B11023,92,88,56,236,2022
2021_B11024,30,52,71,153,2022
2019_A11025,23,21,63,107,2019
2019_A11026,25,68,85,178,2019
2022_A11027,68,78,87,233,2021
2021_A11028,27,42,32,101,2019
2022_B11029,78,61,36,175,2022
2021_B11030,85,26,31,142,2021
2022_C11031,82,79,42,203,2022
2021_B11032,92,94,92,278,2022
2022_B11033,13,87,57,157,2022
2022_A11034,68,44,53,165,2021
2019_C11035,83,48,92,223,2021
2022_B11036,17,46,86,149,2021
2021_B11037,57,55,22,134,2022
2022_B11038,10,75,64,149,2022
2022_B11039,92,17,58,167,2019
2021_C11040,82,66,39,187,2022
2021_A11041,17,92,68,177,2022
2022_C11042,50,60,97,207,2022
2021_B11043,95,72,69,236,2019
2021_C11044,23,43,62,128,2021
2021_C11045,88,74,72,234,2021
2021_C11046,42,62,25,129,2021
2021_A11047,5,51,24,80,2022
2019_B11048,34,87,23,144,2022
2022_A11049,99,55,44,198,2021
2022_A11050,36,36,71,143,2022
2021_C11051,68,69,64,201,2019
2022_B11052,3,19,46,68,2019
2022_C11053,54,81,25,160,2022
2021_A11054,23,73,48,144,2022
2019_B11055,63,52,77,192,2019
2021_C11056,29,41,98,168,2022
2021_B11057,58,76,57,191,2021
2019_B11058,40,89,34,163,2021
2022_A11059,34,68,41,143,2021
2022_A11060,5,87,69,161,2019
2021_B11061,94,94,40,228,2019
2019_C11062,16,56,90,162,2022
2021_B11063,55,27,34,116,2021
2019_A11064,30,72,61,163,2019
2019_B11065,55,55,32,142,2019
2019_C11066,34,23,52,109,2022
2021_A11067,72,56,97,225,2019
2019_C11068,55,86,34,175,2021
2019_C11069,6,92,98,196,2021
2022_C11070,91,14,55,160,2021
2019_C11071,56,14,77,147,2021
2021_A11072,58,15,84,157,2022
2021_A11073,62,95,85,242,2022
2022_B11074,11,48,84,143,2022
2019_C11075,76,90,67,233,2021
2019_C11076,21,43,73,137,2021
2021_C11077,99,84,63,246,2022
2019_A11078,100,85,73,258,2019
2019_C11079,19,61,85,165,2021
2019_B11080,59,85,70,214,2021
2022_C11081,80,70,69,219,2019
2022_A11082,63,58,35,156,2021
2021_C11083,96,78,68,242,2022
2021_A11084,52,54,46,152,2021
2021_A11085,8,48,33,89,2022
2019_C11086,4,67,44,115,2021
2022_C11087,42,59,29,130,2019
2019_C11088,50,15,82,147,2021
2021_C11089,35,92,35,162,2022
2022_B11090,98,29,23,150,2019
2022_C11091,89,35,77,201,2021
2021_A11092,89,85,37,211,2021
2022_A11093,92,94,97,283,2022
2021_C11094,82,30,57,169,2019
2019_A11095,49,87,53,189,2019
2021_A11096,0,82,52,134,2022
2021_C11097,81,96,66,243,2021
2022_A11098,49,80,34,163,2021
2021_C11099,63,28,50,141,2019
2022_C11100,19,67,53,139,2019
2019_C11101,18,56,75,149,2019
2022_B11102,6,52,44,102,2019
2022_B11103,82,97,33,212,2021
2021_A11104,90,70,39,199,2022
2022_B11105,89,39,54,182,2019
2019_B11106,96,74,65,235,2019
2022_C11107,79,56,74,209,2022
2021_A11108,75,29,72,176,2021
2021_A11109,72,53,63,188,2022
2021_C11110,42,95,26,163,2022
2022_C11111,82,59,99,240,2022
2021_C11112,89,48,80,217,2021
2019_C11113,15,65,89,169,2019
2019_C11114,92,16,60,168,2019
2019_A11115,96,89,58,243,2019
2022_B11116,90,31,44,165,2022
2022_C11117,34,71,91,196,2021
2021_B11118,67,19,38,124,2019
2021_A11119,35,50,21,106,2019
2021_B11120,83,59,55,197,2019
2022_B11121,12,56,79,147,2021
2021_A11122,82,18,96,196,2022
2021_A11123,82,75,72,229,2021
2021_B11124,56,52,56,164,2019
2021_B11125,84,54,93,231,2019
2021_B11126,95,75,58,228,2021
2021_A11127,86,32,64,182,2019
2021_C11128,3,13,81,97,2021
2022_C11129,68,31,80,179,2021
2022_A11130,21,15,82,118,2019
2022_A11131,89,32,66,187,2021
2022_B11132,37,39,53,129,2022
2021_C11133,6,93,27,126,2022
2022_C11134,25,51,52,128,2022
2019_A11135,96,15,22,133,2022
2022_C11136,49,11,26,86,2019
2019_C11137,66,19,52,137,2019
2021_C11138,30,55,46,131,2019
2021_C11139,24,81,96,201,2019
2022_B11140,97,26,74,197,2019
2021_B11141,87,37,25,149,2022
2019_C11142,45,89,90,224,2022
2021_A11143,25,44,26,95,2021
2019_A11144,69,97,97,263,2019
2019_C11145,62,48,76,186,2021
2022_A11146,33,84,92,209,2022
2019_A11147,14,83,42,139,2019
2021_C11148,44,58,34,136,2022
2021_A11149,36,72,47,155,2021
2021_B11150,2,82,43,127,2019
2022_A11151,11,82,71,164,2021
2022_B11152,18,91,64,173,2022
2021_B11153,27,64,98,189,2022
2019_A11154,70,86,23,179,2021
2022_A11155,29,57,32,118,2021
2021_A11156,58,42,93,193,2021
2019_C11157,15,17,26,58,2022
2019_B11158,43,72,27,142,2019
2019_A11159,98,86,39,223,2022
2021_A11160,10,73,37,120,2022
2022_A11161,26,84,60,170,2019
2019_C11162,99,71,43,213,2022
2019_C11163,36,61,36,133,2019
2022_A11164,15,30,32,77,2021
2019_A11165,54,24,76,154,2019
2022_C11166,66,66,93,225,2019
2021_B11167,63,93,61,217,2019
2019_C11168,84,26,52,162,2021
2022_A11169,42,20,57,119,2021
2021_B11170,88,50,74,212,2021
2019_A11171,16,51,56,123,2021
2019_A11172,10,84,85,179,2021
2021_C11173,59,61,44,164,2022
2022_A11174,68,67,47,182,2022
2019_B11175,54,75,61,190,2022
2019_B11176,64,17,90,171,2022
2021_A11177,62,79,97,238,2021
2021_A11178,2,38,25,65,2019
2021_B11179,11,45,60,116,2021
2019_A11180,88,27,53,168,2022
2019_B11181,44,77,49,170,2019
2021_A11182,95,28,81,204,2022
2019_A11183,75,26,73,174,2022
2022_B11184,84,82,74,240,2021
2021_A11185,74,49,61,184,2022
2022_A11186,33,74,42,149,2019
2021_C11187,29,20,73,122,2022
2022_C11188,24,67,86,177,2021
2021_C11189,8,73,28,109,2022
2021_C11190,9,63,45,117,2022
2022_B11191,4,82,89,175,2022
2022_A11192,9,31,99,139,2019
2022_C11193,36,12,25,73,2022
2022_A11194,70,33,58,161,2021
2022_A11195,62,28,33,123,2022
2021_A11196,48,86,90,224,2021
2021_B11197,67,85,37,189,2022
2021_C11198,33,38,65,136,2021
2019_B11199,40,54,91,185,2019
2021_C11200,7,30,80,117,2021
2021_B11201,81,75,49,205,2019
2022_B11202,56,78,52,186,2019
2019_B11203,87,20,74,181,2021
2022_B11204,50,95,37,182,2019
2021_A11205,31,88,72,191,2022
2022_B11206,93,36,30,159,2022
2019_A11207,81,75,79,235,2021
2019_A11208,91,21,61,173,2019
2021_B11209,3,68,29,100,2019
2019_A11210,62,39,72,173,2021
2021_A11211,80,13,55,148,2022
2022_B11212,69,43,81,193,2021
2019_C11213,88,68,24,180,2019
2019_C11214,2,83,54,139,2022
2021_B11215,30,21,90,141,2021
2021_C11216,78,78,48,204,2019
2021_C11217,28,26,24,78,2019
2019_B11218,100,46,62,208,2021
2019_C11219,9,67,93,169,2022
2022_C11220,32,46,88,166,2019
2021_B11221,33,25,64,122,2022
2021_C11222,60,92,67,219,2019
2021_B11223,56,39,26,121,2021
2022_C11224,61,77,80,218,2021
2022_B11225,14,55,88,157,2022
2019_A11226,2,35,42,79,2019
2022_B11227,9,87,74,170,2022
2019_C11228,5,84,26,115,2022
2021_A11229,60,59,81,200,2022
2019_B11230,4,56,28,88,2021
2021_A11231,56,65,54,175,2022
2022_A11232,64,66,30,160,2022
2019_C11233,63,18,66,147,2022
2022_C11234,26,20,95,141,2021
2019_A11235,23,26,66,115,2021
2021_B11236,56,92,63,211,2021
2021_C11237,52,72,66,190,2019
2021_A11238,20,69,53,142,2019
2022_B11239,66,41,70,177,2021
2022_A11240,61,23,80,164,2022
2019_A11241,87,31,77,195,2021
2022_A11242,22,80,64,166,2019
2019_A11243,7,84,33,124,2019
2019_A11244,40,74,56,170,2019
2019_C11245,77,69,45,191,2021
2021_B11246,71,87,58,216,2019
2021_A11247,14,55,31,100,2019
2019_A11248,74,70,59,203,2022
2021_B11249,34,82,95,211,2019
2019_B11250,61,21,84,166,2021
2021_B11251,88,73,67,228,2021
2021_A11252,89,61,24,174,2021
2022_A11253,60,66,48,174,2022
2021_C11254,97,34,28,159,2019
2022_B11255,38,49,55,142,2022
2022_B11256,3,24,55,82,2019
2021_A11257,48,86,69,203,2021
2021_C11258,71,20,97,188,2022
2021_A11259,24,93,50,167,2021
2019_B11260,53,70,67,190,2021
2019_A11261,80,88,63,231,2019
2021_C11262,17,53,22,92,2019
2019_A11263,95,39,28,162,2021
2022_A11264,30,34,65,129,2021
2022_C11265,96,41,80,217,2022
2022_B11266,89,90,38,217,2021
2019_B11267,35,29,65,129,2021
2022_A11268,56,33,92,181,2019
2019_C11269,27,53,23,103,2019
2019_B11270,77,69,79,225,2022
2021_B11271,5,44,56,105,2019
2019_C11272,44,11,68,123,2019
2022_A11273,28,19,90,137,2022
2021_A11274,14,36,98,148,2022
2022_A11275,15,36,41,92,2021
2019_A11276,54,52,35,141,2021
2021_A11277,6,72,37,115,2021
2019_A11278,86,47,43,176,2019
2022_C11279,28,12,76,116,2022
2022_A11280,7,92,71,170,2019
2019_A11281,70,93,80,243,2022
2021_B11282,39,14,44,97,2022
2019_C11283,62,73,28,163,2022
2021_B11284,34,72,29,135,2022
2021_A11285,82,32,84,198,2021
2019_B11286,77,34,80,191,2022
2019_C11287,19,95,94,208,2022
2021_C11288,100,58,64,222,2022
2022_B11289,22,91,28,141,2022
2022_A11290,59,70,43,172,2022
2022_C11291,10,37,82,129,2022
2021_B11292,97,77,35,209,2019
2019_B11293,40,13,36,89,2021
2019_C11294,51,21,61,133,2021
2019_A11295,72,53,90,215,2022
2022_A11296,76,55,42,173,2021
2019_C11297,82,77,66,225,2021
2019_A11298,19,45,94,158,2019
2021_C11299,13,87,68,168,2021
2022_B11300,61,33,58,152,2021
2022_B11301,52,74,51,177,2022
2022_C11302,43,91,61,195,2019
2022_C11303,6,64,99,169,2019
2022_C11304,72,78,32,182,2019
2022_C11305,44,18,61,123,2021
2021_A11306,97,27,77,201,2021
2022_C11307,56,13,76,145,2019
2019_C11308,88,66,49,203,2021
2019_C11309,24,79,39,142,2019
2021_B11310,57,51,36,144,2019
2021_C11311,24,13,25,62,2019
2021_A11312,5,11,89,105,2022
2019_A11313,66,32,37,135,2021
2022_A11314,54,86,39,179,2019
2022_A11315,74,94,59,227,2021
2022_A11316,74,55,64,193,2022
2021_A11317,64,35,25,124,2019
2022_A11318,65,71,79,215,2021
2019_C11319,68,56,99,223,2021
2019_B11320,95,37,29,161,2021
2022_A11321,10,91,49,150,2021
2022_C11322,33,44,50,127,2021
2021_C11323,96,79,43,218,2021
2019_A11324,35,48,53,136,2022
2022_A11325,48,25,56,129,2021
2019_B11326,94,62,62,218,2019
2022_B11327,66,46,33,145,2019
2022_B11328,32,24,53,109,2022
2019_C11329,20,29,27,76,2021
2022_C11330,83,50,53,186,2019
2019_C11331,70,42,83,195,2021
2021_A11332,9,76,28,113,2019
2021_A11333,14,86,93,193,2021
2022_A11334,9,72,39,120,2021
2021_B11335,55,44,79,178,2022
2019_A11336,91,76,43,210,2022
2019_B11337,82,91,67,240,2022
2022_A11338,93,13,90,196,2019
2019_A11339,66,73,24,163,2019
2022_C11340,5,80,65,150,2022
2019_B11341,27,12,30,69,2021
2021_A11342,31,75,95,201,2019
2021_A11343,11,83,97,191,2021
2021_C11344,84,28,69,181,2021
2022_C11345,65,59,32,156,2022
2019_B11346,27,69,57,153,2021
2019_B11347,65,68,54,187,2019
2019_C11348,65,96,60,221,2019
2021_A11349,22,54,99,175,2019
2021_B11350,3,45,39,87,2019
2022_B11351,64,70,77,211,2021
2019_C11352,51,29,94,174,2022
2022_A11353,31,20,22,73,2019
2022_C11354,88,71,98,257,2019
2019_A11355,53,61,37,151,2022
2021_B11356,64,53,52,169,2022
2019_B11357,59,96,45,200,2021
2022_C11358,28,33,52,113,2022
2019_C11359,10,42,61,113,2021
2022_A11360,1,89,49,139,2019
2019_B11361,60,67,56,183,2022
2021_C11362,86,12,44,142,2022
2022_B11363,4,74,79,157,2021
2021_A11364,94,83,21,198,2021
2022_C11365,67,52,50,169,2019
2022_C11366,24,30,21,75,2022
2019_C11367,30,65,88,183,2022
2021_C11368,0,94,99,193,2022
2019_C11369,56,42,61,159,2019
2019_C11370,61,17,86,164,2022
2019_B11371,73,92,45,210,2021
2021_B11372,55,70,93,218,2021
2021_A11373,30,14,28,72,2021
2022_B11374,24,48,26,98,2019
2021_A11375,66,23,47,136,2022
2022_C11376,80,77,46,203,2021
2019_A11377,87,45,96,228,2019
2019_C11378,56,79,38,173,2019
2019_C11379,95,22,24,141,2022
2021_C11380,69,89,47,205,2021
2021_C11381,42,52,34,128,2019
2021_A11382,28,60,96,184,2022
2022_B11383,98,66,61,225,2019
2022_B11384,15,63,66,144,2022
2019_A11385,71,11,61,143,2019
2019_B11386,4,77,98,179,2021
2021_A11387,95,26,34,155,2021
2019_B11388,91,18,98,207,2022
2019_A11389,19,38,40,97,2021
2021_C11390,24,37,45,106,2019
2022_B11391,31,89,80,200,2019
2022_B11392,7,77,54,138,2021
2019_A11393,29,77,32,138,2022
2021_C11394,76,44,82,202,2021
2019_A11395,76,12,96,184,2019
2019_C11396,11,84,28,123,2022
2022_A11397,35,46,46,127,2022
2019_B11398,7,50,31,88,2021
2019_B11399,44,36,41,121,2021
2022_C11400,94,80,70,244,2021
2021_A11401,16,32,71,119,2021
2022_A11402,32,51,72,155,2021
2019_B11403,1,48,66,115,2021
2022_A11404,13,56,51,120,2021
2019_B11405,61,95,88,244,2019
2022_C11406,59,93,40,192,2022
2019_B11407,13,21,73,107,2022
2022_C11408,11,67,58,136,2022
2021_B11409,36,40,91,167,2022
2022_C11410,85,85,36,206,2021
2022_A11411,77,93,55,225,2019
2019_C11412,97,77,92,266,2022
2021_B11413,73,97,87,257,2022
2019_B11414,45,69,97,211,2021
2019_A11415,5,62,99,166,2019
2022_C11416,21,79,63,163,2019
2019_B11417,70,49,38,157,2022
2019_A11418,9,91,58,158,2021
2019_C11419,76,25,82,183,2022
2022_A11420,26,49,96,171,2022
2021_C11421,68,64,68,200,2021
2019_C11422,100,35,24,159,2021
2021_C11423,20,32,73,125,2022
2022_A11424,15,82,87,184,2019
2022_C11425,13,91,69,173,2019
2022_A11426,62,93,68,223,2021
2021_B11427,52,25,98,175,2019
2021_B11428,76,59,97,232,2021
2021_C11429,79,86,31,196,2021
2022_A11430,76,15,96,187,2021
2019_C11431,17,64,50,131,2022
2019_C11432,45,92,72,209,2021
2022_A11433,96,51,93,240,2022
2022_B11434,93,28,37,158,2022
2022_A11435,23,60,97,180,2019
2019_C11436,78,23,45,146,2022
2021_B11437,72,86,83,241,2022
2019_B11438,88,48,78,214,2021
2021_A11439,78,94,88,260,2019
2019_B11440,33,36,86,155,2022
2021_B11441,0,63,92,155,2022
2022_A11442,24,39,57,120,2022
2021_B11443,2,61,31,94,2022
2022_A11444,60,59,22,141,2021
2019_C11445,82,62,62,206,2021
2022_C11446,27,80,25,132,2019
2019_C11447,93,77,82,252,2021
2021_C11448,7,25,32,64,2022
2022_B11449,65,46,70,181,2019
2019_A11450,27,59,95,181,2022
2021_C11451,32,52,51,135,2021
2021_A11452,36,58,22,116,2022
2021_A11453,47,24,60,131,2022
2022_A11454,50,88,89,227,2021
2022_C11455,100,90,59,249,2022
2021_C11456,28,70,83,181,2021
2021_B11457,82,57,87,226,2019
2021_A11458,66,84,21,171,2019
2021_A11458,31,40,32,103,2022
2019_A11460,7,53,32,92,2021
2021_B11461,52,18,47,117,2021
2021_C11462,73,31,32,136,2021
2022_B11463,34,44,88,166,2019
2019_A11464,32,24,66,122,2022
2022_C11465,56,67,39,162,2021
2022_C11466,7,30,52,89,2022
2022_B11467,63,71,88,222,2019
2021_A11468,54,95,60,209,2019
2019_A11469,40,96,64,200,2022
2022_C11470,33,81,51,165,2021
2019_C11471,42,75,29,146,2022
2019_A11472,82,16,40,138,2022
2022_C11473,51,37,43,131,2022
2021_B11474,15,42,73,130,2022
2019_B11475,45,35,96,176,2019
2021_B11476,92,25,45,162,2022
2021_B11477,37,32,94,163,2022
2021_B11478,97,31,92,220,2022
2021_B11479,88,57,93,238,2019
2021_A11480,52,71,35,158,2021
2022_C11481,15,43,35,93,2021
2022_C11482,99,75,70,244,2022
2019_C11483,14,55,42,111,2022
2021_A11484,79,47,95,221,2022
2021_C11485,70,59,73,202,2022
2019_C11486,1,33,46,80,2021
2022_B11487,42,20,44,106,2021
2021_A11488,60,45,49,154,2021
2021_A11489,69,51,51,171,2022
2019_C11490,15,77,73,165,2022
2022_C11491,98,95,88,281,2022
2022_C11492,63,89,86,238,2022
2021_C11493,10,74,30,114,2021
2022_A11494,86,94,34,214,2019
2022_C11495,40,30,53,123,2022
2021_B11496,79,46,30,155,2019
2019_C11497,47,15,98,160,2019
2022_B11498,48,53,51,152,2022
2022_C11499,95,48,80,223,2021
2021_A11500,56,94,58,208,2022
2019_A11501,43,91,97,231,2022
2019_C11502,68,80,56,204,2019
2022_A11503,94,41,88,223,2021
2021_C11504,93,81,60,234,2021
2022_C11505,2,23,81,106,2019
2019_C11506,27,62,79,168,2019
2021_C11507,99,38,63,200,2021
2019_B11508,95,93,95,283,2019
2019_B11509,3,17,69,89,2019
2022_A11510,43,64,22,129,2019
2021_A11511,61,70,97,228,2019
2019_C11512,34,18,27,79,2021
2022_A11513,3,62,31,96,2019
2019_B11514,54,69,56,179,2021
2021_B11515,61,20,88,169,2022
2021_B11516,54,31,66,151,2022
2021_A11517,36,84,33,153,2021
2019_C11518,54,22,51,127,2022
2021_B11519,71,11,36,118,2021
2021_B11520,9,87,86,182,2019
2022_A11521,59,70,45,174,2019
2019_C11522,20,56,36,112,2019
2022_A11523,31,56,95,182,2019
2022_C11524,44,95,32,171,2021
2019_B11525,86,44,45,175,2022
2022_B11526,1,23,50,74,2019
2021_C11527,24,40,29,93,2019
2021_A11528,86,59,87,232,2021
2021_A11529,89,19,68,176,2019
2021_B11530,58,50,70,178,2019
2021_B11531,51,72,21,144,2019
2022_B11532,26,64,47,137,2019
2019_A11533,31,38,58,127,2019
2021_C11534,75,28,77,180,2019
2021_C11535,1,80,43,124,2021
2019_A11536,13,41,60,114,2019
2019_C11537,78,71,30,179,2022
2019_B11538,99,61,32,192,2019
2021_A11539,88,16,23,127,2021
2022_B11540,34,85,99,218,2021
2022_A11541,19,83,72,174,2019
2019_B11542,88,37,46,171,2022
2022_C11543,50,36,83,169,2022
2021_A11544,34,87,36,157,2022
2022_A11545,58,68,73,199,2019
2022_C11546,24,61,59,144,2021
2019_C11547,40,84,89,213,2021
2021_C11548,39,70,55,164,2019
2022_C11549,24,52,34,110,2022
2021_A11550,29,32,55,116,2019
2019_A11551,13,97,62,172,2021
2019_A11552,1,90,67,158,2019
2021_B11553,8,45,49,102,2021
2022_A11554,35,46,50,131,2021
2021_B11555,40,84,86,210,2021
2019_C11556,68,33,76,177,2019
2022_B11557,37,33,37,107,2022
2021_C11558,19,88,78,185,2022
2022_C11559,77,12,27,116,2019
2021_B11560,78,24,25,127,2022
2019_A11561,31,95,41,167,2022
2019_B11562,18,32,99,149,2022
2022_A11563,21,96,21,138,2021
2019_C11564,33,73,80,186,2021
2021_A11565,65,87,98,250,2019
2022_A11566,2,63,44,109,2019
2019_A11567,22,31,50,103,2022
2022_C11568,17,83,25,125,2019
2021_C11569,26,36,33,95,2021
2022_B11570,19,25,32,76,2021
2019_A11571,7,94,28,129,2019
2019_B11572,77,60,87,224,2021
2021_A11573,88,64,78,230,2021
2021_A11574,18,30,40,88,2019
2021_B11575,53,51,29,133,2021
2021_A11576,47,13,42,102,2022
2022_A11577,76,67,58,201,2021
2019_A11578,41,29,37,107,2019
2019_A11579,57,74,95,226,2019
2021_A11580,8,35,75,118,2021
2019_B11581,58,75,66,199,2019
2022_B11582,52,14,88,154,2021
2019_A11583,58,21,47,126,2021
2022_B11584,21,39,72,132,2022
2022_A11585,18,71,29,118,2022
2021_B11586,24,34,70,128,2021
2022_C11587,35,51,38,124,2019
2022_C11588,67,30,26,123,2022
2021_A11589,56,52,82,190,2019
2022_B11590,22,20,22,64,2019
2019_C11591,55,95,68,218,2021
2022_B11592,21,92,59,172,2019
2021_A11593,37,29,77,143,2021
2019_C11594,94,92,88,274,2021
2022_B11595,79,67,88,234,2019
2022_C11596,69,23,32,124,2022
2019_B11597,88,20,63,171,2019
2021_A11598,91,95,52,238,2021
2019_B11599,49,27,89,165,2021
2022_A11600,8,88,67,163,2021
2019_A11601,43,59,87,189,2021
2019_A11602,8,56,43,107,2022
2022_C11603,2,74,59,135,2021
2019_C11604,68,57,80,205,2022
2022_A11605,70,93,90,253,2021
2021_B11606,56,17,31,104,2022
2021_B11607,58,22,67,147,2021
2021_A11608,72,26,79,177,2021
2019_A11609,36,14,67,117,2021
2022_B11610,41,13,97,151,2019
2019_B11611,23,13,26,62,2022
2019_A11612,33,14,72,119,2022
2022_A11613,11,18,80,109,2019
2022_A11614,42,80,31,153,2022
2022_B11615,6,37,83,126,2019
2022_B11616,65,50,22,137,2019
2019_A11617,3,75,84,162,2019
2019_B11618,77,86,60,223,2021
2021_B11619,56,76,54,186,2021
2021_A11620,73,95,84,252,2019
2021_A11621,57,68,59,184,2022
2019_C11622,14,50,99,163,2021
2022_A11623,73,22,57,152,2021
2022_B11624,6,74,86,166,2021
2022_C11625,13,32,73,118,2019
2022_C11626,94,52,32,178,2021
2021_A11627,83,53,77,213,2022
2019_B11628,12,22,68,102,2021
2021_C11629,32,26,58,116,2021
2019_B11630,4,43,31,78,2019
2021_B11631,27,71,78,176,2022
2021_B11632,76,54,89,219,2022
2019_A11633,60,34,44,138,2019
2021_B11634,34,55,77,166,2021
2022_C11635,22,36,39,97,2019
2019_A11636,98,41,70,209,2019
2022_B11637,33,93,62,188,2021
2022_A11638,70,38,65,173,2022
2019_B11639,100,80,87,267,2022
2021_B11640,55,14,60,129,2022
2021_C11641,90,68,67,225,2022
2022_C11642,31,19,79,129,2021
2022_C11643,48,61,69,178,2019
2021_B11644,6,39,59,104,2022
2021_A11645,24,26,43,93,2021
2022_A11646,55,94,28,177,2021
2022_C11647,17,54,50,121,2021
2021_A11648,8,77,96,181,2022
2022_B11649,74,85,45,204,2022
2022_B11650,9,82,92,183,2022
2019_A11651,85,78,23,186,2021
2021_B11652,47,38,51,136,2022
2019_B11653,22,71,56,149,2022
2022_B11654,3,18,30,51,2021
2021_B11655,84,13,59,156,2021
2019_B11656,56,33,92,181,2019
2022_B11657,71,68,88,227,2022
2021_C11658,87,32,86,205,2021
2022_B11659,40,50,21,111,2021
2021_A11660,25,61,38,124,2022
2019_B11661,18,79,39,136,2021
2019_A11662,47,62,74,183,2019
2021_B11663,82,17,53,152,2021
2021_B11664,34,31,33,98,2019
2019_B11665,48,82,33,163,2019
2019_B11666,96,44,82,222,2021
2019_A11667,79,60,25,164,2019
2019_C11668,96,53,52,201,2022
2021_B11669,30,89,57,176,2019
2019_B11670,42,51,53,146,2022
2022_B11671,76,73,70,219,2022
2019_C11672,9,40,98,147,2022
2022_A11673,95,85,42,222,2019
2022_A11674,53,89,88,230,2022
2019_B11675,54,32,75,161,2022
2022_C11676,65,16,74,155,2022
2022_B11677,61,53,39,153,2022
2019_B11678,2,14,41,57,2019
2021_A11679,4,11,77,92,2022
2019_C11680,23,45,40,108,2019
2022_B11681,61,64,54,179,2019
2019_B11682,63,17,80,160,2019
2021_B11683,25,83,60,168,2022
2019_A11684,64,80,28,172,2021
2021_B11685,76,23,61,160,2021
2022_C11686,69,88,84,241,2021
2019_C11687,70,82,44,196,2019
2019_A11688,50,92,94,236,2019
2019_A11689,84,87,85,256,2022
2021_B11690,4,64,59,127,2022
2019_C11691,25,56,55,136,2022
2021_A11692,78,93,93,264,2022
2021_C11693,44,22,45,111,2022
2021_B11694,51,17,37,105,2021
2019_C11695,50,76,46,172,2021
2022_A11696,25,46,91,162,2022
2022_C11697,55,72,36,163,2019
2019_C11698,15,53,52,120,2021
2022_B11699,81,79,56,216,2021
2021_B11700,42,66,64,172,2021
2019_C11701,54,22,57,133,2021
2021_A11702,18,90,32,140,2021
2021_A11703,10,71,57,138,2022
2022_C11704,28,39,28,95,2021
2019_C11705,39,69,45,153,2021
2019_B11706,41,85,62,188,2022
2021_A11707,21,58,73,152,2021
2022_A11708,87,73,71,231,2019
2021_B11709,25,49,24,98,2019
2019_C11710,92,93,65,250,2019
2022_A11711,95,50,86,231,2019
2022_C11712,11,42,61,114,2022
2021_A11713,20,48,90,158,2021
2022_A11714,72,64,62,198,2022
2021_A11715,19,26,57,102,2019
2022_B11716,17,72,36,125,2022
2019_B11717,72,36,23,131,2022
2019_A11718,68,73,55,196,2022
2022_C11719,97,51,65,213,2021
2021_B11720,21,23,33,77,2019
2022_B11721,86,29,71,186,2022
2019_B11722,77,16,24,117,2022
2019_C11723,19,24,27,70,2021
2019_C11724,99,80,76,255,2021
2021_C11725,12,56,55,123,2022
2022_B11726,19,51,82,152,2022
2022_C11727,90,97,24,211,2021
2021_B11728,62,73,80,215,2019
2021_A11729,52,33,44,129,2021
2022_A11730,75,28,92,195,2021
2021_A11731,41,80,55,176,2021
2019_C11732,47,85,83,215,2021
2021_B11733,73,29,78,180,2022
2019_C11734,1,92,96,189,2019
2021_C11735,56,61,64,181,2021
2021_B11736,73,25,26,124,2021
2022_B11737,98,11,28,137,2022
2019_B11738,98,59,49,206,2021
2022_B11739,42,92,98,232,2019
2022_C11740,41,20,54,115,2019
2022_C11741,33,56,21,110,2021
2021_C11742,89,56,43,188,2022
2021_A11743,22,92,67,181,2019
2021_B11744,25,64,42,131,2022
2019_C11745,45,63,74,182,2021
2021_B11746,8,56,88,152,2019
2021_C11747,88,15,54,157,2022
2021_C11748,51,61,73,185,2022
2019_B11749,37,61,42,140,2019
2022_B11750,74,16,89,179,2022
2021_A11751,38,17,73,128,2019
2021_A11752,38,96,25,159,2021
2019_C11753,86,91,26,203,2022
2021_A11754,4,38,31,73,2021
2022_B11755,50,85,88,223,2022
2019_C11756,92,78,64,234,2021
2019_C11757,25,12,37,74,2019
2022_A11758,51,36,87,174,2019
2022_A11759,8,54,90,152,2021
2022_A11760,69,49,43,161,2021
2021_B11761,34,97,77,208,2021
2021_A11762,57,49,89,195,2021
2019_A11763,28,54,99,181,2019
2019_A11764,100,55,68,223,2019
2019_A11765,71,38,72,181,2021
2022_A11766,25,64,21,110,2021
2021_A11767,91,25,35,151,2022
2021_B11768,55,47,21,123,2019
2021_A11769,42,61,45,148,2019
2022_B11770,100,29,85,214,2019
2019_A11771,70,16,70,156,2022
2021_A11772,7,44,47,98,2022
2022_B11773,48,57,97,202,2019
2021_A11774,68,38,94,200,2021
2019_B11775,37,82,67,186,2021
2022_C11776,78,15,63,156,2022
2022_B11777,17,53,38,108,2022
2019_B11778,84,13,75,172,2019
2021_B11779,38,83,23,144,2021
2021_B11780,8,38,39,85,2022
2021_A11781,21,44,93,158,2021
2022_C11782,34,46,38,118,2022
2019_A11783,41,21,91,153,2019
2022_B11784,6,28,40,74,2019
2022_A11785,62,89,31,182,2021
2022_B11786,98,30,24,152,2022
2019_A11787,42,81,35,158,2021
2021_A11788,48,81,48,177,2019
2021_B11789,83,81,39,203,2022
2019_C11790,92,32,53,177,2021
2019_A11791,49,62,78,189,2022
2022_A11792,49,44,35,128,2021
2022_A11793,95,18,69,182,2019
2019_C11794,43,75,32,150,2019
2022_C11795,31,28,88,147,2021
2019_A11796,11,40,54,105,2021
2019_C11797,33,52,92,177,2022
2022_C11798,32,16,66,114,2021
2021_B11799,38,69,57,164,2021
2022_C11800,68,97,35,200,2019
2021_B11801,94,17,94,205,2022
2021_A11802,81,48,31,160,2021
2021_B11803,42,20,34,96,2019
2021_C11804,78,88,59,225,2019
2022_B11805,59,23,89,171,2022
2022_A11806,56,90,99,245,2021
2019_C11807,7,76,53,136,2019
2021_A11808,69,11,77,157,2022
2022_C11809,23,60,38,121,2021
2021_B11810,90,30,49,169,2022
2019_B11811,66,53,55,174,2021
2021_B11812,79,18,80,177,2021
2019_C11813,46,36,38,120,2021
2021_B11814,90,25,60,175,2019
2022_A11815,80,44,24,148,2019
2021_C11816,48,89,25,162,2019
2021_A11817,43,41,55,139,2019
2022_C11818,19,77,42,138,2019
2019_B11819,37,13,24,74,2021
2019_C11820,69,65,42,176,2019
2021_A11821,90,73,42,205,2021
2021_B11822,94,36,51,181,2021
2022_B11823,56,70,39,165,2022
2019_B11824,66,53,81,200,2021
2021_B11825,28,84,87,199,2021
2022_A11826,79,88,42,209,2019
2022_C11827,61,52,56,169,2019
2022_B11828,84,22,91,197,2019
2022_A11829,64,71,88,223,2021
2022_A11830,84,74,24,182,2019
2019_A11831,67,85,63,215,2021
2021_C11832,29,93,94,216,2022
2021_A11833,55,28,98,181,2022
2021_B11834,31,63,68,162,2019
2021_C11835,66,69,70,205,2021
2019_C11836,91,31,94,216,2021
2022_A11837,86,83,67,236,2019
2022_C11838,32,42,64,138,2022
2021_C11839,85,48,35,168,2019
2022_B11840,75,16,66,157,2022
2021_A11841,41,11,96,148,2021
2021_B11842,73,21,29,123,2022
2019_B11843,18,44,95,157,2019
2022_C11844,25,59,69,153,2021
2022_C11845,9,45,94,148,2021
2022_B11846,96,42,26,164,2019
2019_B11847,37,31,29,97,2019
2022_B11848,62,75,36,173,2021
2022_C11849,1,80,55,136,2019
2019_C11850,54,42,89,185,2021
2019_B11851,27,41,92,160,2019
2022_B11852,73,59,71,203,2019
2021_C11853,87,32,30,149,2019
2021_B11854,81,14,91,186,2021
2022_B11855,9,12,41,62,2019
2022_C11856,73,45,53,171,2021
2022_A11857,23,33,83,139,2022
2021_C11858,11,47,53,111,2019
2019_B11859,45,37,34,116,2022
2021_A11860,78,85,64,227,2021
2019_A11861,24,66,26,116,2022
2019_A11862,96,53,35,184,2021
2022_A11863,40,79,42,161,2021
2019_B11864,81,72,36,189,2021
2021_A11865,30,91,64,185,2021
2021_C11866,69,83,25,177,2021
2022_B11867,33,81,58,172,2022
2019_B11868,39,83,74,196,2022
2021_C11869,40,78,24,142,2022
2021_A11870,95,31,23,149,2019
2022_B11871,79,87,68,234,2021
2022_B11872,62,71,45,178,2019
2019_C11873,48,33,95,176,2019
2019_B11874,36,26,71,133,2019
2019_C11875,25,38,81,144,2022
2022_B11876,92,39,55,186,2022
2021_C11877,37,83,84,204,2019
2019_C11878,12,93,88,193,2019
2021_A11879,8,59,95,162,2022
2019_C11880,81,90,75,246,2022
2019_A11881,97,53,28,178,2021
2021_A11882,61,34,99,194,2022
2019_B11883,69,62,69,200,2022
2019_C11884,57,17,24,98,2022
2019_C11885,88,69,30,187,2022
2022_C11886,10,61,99,170,2022
2021_B11887,84,79,68,231,2019
2019_B11888,41,92,53,186,2021
2021_C11889,91,28,47,166,2021
2022_C11890,93,27,31,151,2021
2021_A11891,36,76,68,180,2022
2021_C11892,36,96,92,224,2021
2019_C11893,55,18,29,102,2019
2022_B11894,78,77,38,193,2019
2022_C11895,41,50,85,176,2019
2022_B11896,76,88,62,226,2019
2022_B11897,85,32,73,190,2022
2022_A11898,13,16,65,94,2019
2019_A11899,91,54,24,169,2019
2022_A11900,87,97,40,224,2022
2019_B11901,3,52,50,105,2022
2019_A11902,31,22,29,82,2019
2019_B11903,14,66,96,176,2022
2022_B11904,22,38,77,137,2022
2022_C11905,18,68,49,135,2019
2021_C11906,73,82,48,203,2022
2022_C11907,7,16,58,81,2022
2021_A11908,86,41,37,164,2022
2022_A11909,9,37,86,132,2019
2019_A11910,47,38,50,135,2022
2021_A11911,58,81,43,182,2019
2019_A11912,28,64,71,163,2022
2022_B11913,29,93,72,194,2022
2019_A11914,0,78,77,155,2019
2022_A11915,73,56,25,154,2021
2021_B11916,70,65,81,216,2021
2021_B11917,76,15,35,126,2019
2019_C11918,51,76,26,153,2022
2021_A11919,21,64,43,128,2022
2022_B11920,74,24,82,180,2022
2021_C11921,1,72,73,146,2019
2021_C11922,27,54,54,135,2019
2019_B11923,58,56,80,194,2022
2022_C11924,6,61,42,109,2021
2019_C11925,29,69,38,136,2022
2019_B11926,99,67,70,236,2019
2021_B11927,95,33,95,223,2021
2022_B11928,68,25,47,140,2021
2022_C11929,24,88,91,203,2022
2021_B11930,97,68,33,198,2019
2021_B11931,89,77,88,254,2021
2019_C11932,97,38,96,231,2019
2021_B11933,27,96,64,187,2021
2019_C11934,14,58,26,98,2019
2022_A11935,22,61,61,144,2022
2022_A11936,92,96,54,242,2021
2021_B11937,13,57,31,101,2021
2021_C11938,1,72,43,116,2019
2019_A11939,69,95,50,214,2019
2022_C11940,67,64,79,210,2019
2021_B11941,33,23,28,84,2021
2021_B11942,84,85,53,222,2019
2022_B11943,65,33,41,139,2021
2019_B11944,6,51,48,105,2021
2021_B11945,3,75,54,132,2019
2021_A11946,70,13,97,180,2019
2019_A11947,47,74,39,160,2019
2021_C11948,70,30,79,179,2021
2019_C11949,30,78,34,142,2022
2022_C11950,48,51,85,184,2021
2019_C11951,17,63,67,147,2021
2021_A11952,60,61,73,194,2022
2019_B11953,58,51,87,196,2022
2022_B11954,14,94,51,159,2021
2022_C11955,45,16,35,96,2022
2022_B11956,85,50,74,209,2019
2019_B11957,11,27,84,122,2021
2021_C11958,79,74,33,186,2021
2021_B11959,100,72,49,221,2021
2019_C11960,13,84,83,180,2022
2022_A11961,57,94,54,205,2021
2021_A11962,77,71,81,229,2022
2022_A11963,17,29,53,99,2022
2021_A11964,2,95,97,194,2019
2022_B11965,20,22,46,88,2019
2019_B11966,79,35,59,173,2021
2019_C11967,1,36,75,112,2022
2019_A11968,68,53,98,219,2022
2022_A11969,63,34,46,143,2022
2022_B11970,90,24,28,142,2021
2019_C11971,63,71,66,200,2022
2021_C11972,93,60,64,217,2022
2019_B11973,6,90,59,155,2021
2022_B11974,39,56,22,117,2019
2022_A11975,55,58,60,173,2019
2021_C11976,60,56,85,201,2019
2021_C11977,42,27,99,168,2021
2021_C11978,16,75,54,145,2022
2021_A11979,22,44,75,141,2022
2021_A11980,87,60,26,173,2021
2022_A11981,95,38,71,204,2021
2022_C11982,38,47,28,113,2019
2021_B11983,71,68,39,178,2022
2022_C11984,93,57,34,184,2022
2021_C11985,82,21,77,180,2019
2021_C11986,34,81,26,141,2021
2021_C11987,100,16,22,138,2022
2022_A11988,72,96,87,255,2022
2021_C11989,36,48,67,151,2019
2022_A11990,61,67,31,159,2019
2019_B11991,17,70,44,131,2022
2022_A11992,9,94,67,170,2021
2019_B11993,31,70,44,145,2021
2022_B11994,15,76,30,121,2021
2022_C11995,60,87,84,231,2021
2019_A11996,57,86,56,199,2019
2019_B11997,13,73,29,115,2021
2021_B11998,79,79,51,209,2022
2021_A11999,21,65,37,123,2019
2019_C12000,82,29,35,146,2021
2019_A12001,20,78,87,185,2019
2022_C12002,57,88,62,207,2022
2021_A12003,26,90,82,198,2022
2022_C12004,16,93,99,208,2022
2022_C12005,37,17,92,146,2021
2019_B12006,34,61,79,174,2022
2022_A12007,62,25,37,124,2022
2019_B12008,22,19,25,66,2019
2022_B12009,81,32,96,209,2019
2019_B12010,34,69,79,182,2022
2021_A12011,97,91,62,250,2022
2019_B12012,82,92,61,235,2019
2021_A12013,86,11,90,187,2021
2022_B12014,100,67,70,237,2022
2019_C12015,91,67,78,236,2022
2021_C12016,30,74,31,135,2022
2019_A12017,95,49,50,194,2022
2019_B12018,52,76,81,209,2022
2022_B12019,47,92,82,221,2019
2021_B12020,19,91,28,138,2021
2021_A12021,88,76,35,199,2021
2019_B12022,95,42,27,164,2019
2021_A12023,45,28,86,159,2022
2021_A12024,2,20,31,53,2019
2021_A12025,45,59,93,197,2019
2022_C12026,38,75,86,199,2019
2021_B12027,4,31,36,71,2019
2021_A12028,99,75,88,262,2019
2021_A12029,27,41,59,127,2021
2019_C12030,88,78,33,199,2021
2019_B12031,28,87,41,156,2019
2021_B12032,58,20,34,112,2019
2019_B12033,14,48,41,103,2022
2019_B12034,78,43,29,150,2022
2019_C12035,48,70,45,163,2021
2021_B12036,51,81,87,219,2021
2021_B12037,60,29,94,183,2021
2019_C12038,62,65,85,212,2021
2019_B12039,69,47,69,185,2022
2019_A12040,68,54,81,203,2021
2022_B12041,57,25,38,120,2022
2021_B12042,99,51,84,234,2019
2021_B12043,15,53,68,136,2019
2021_B12044,24,18,80,122,2022
2019_C12045,100,47,32,179,2022
2019_C12046,16,39,39,94,2019
2019_B12047,97,56,52,205,2022
2021_C12048,91,95,72,258,2019
2022_B12049,64,45,25,134,2022
2022_A12050,74,66,78,218,2021
2022_C12051,0,78,97,175,2021
2022_A12052,100,92,76,268,2021
2019_C12053,39,43,72,154,2022
2019_A12054,42,33,24,99,2021
2022_A12055,21,35,89,145,2019
2021_A12056,72,23,84,179,2022
2021_C12057,86,42,33,161,2021
2022_C12058,31,13,42,86,2022
2019_A12059,59,21,56,136,2021
2019_C12060,9,56,65,130,2022
2022_C12061,55,52,76,183,2019
2021_A12062,100,15,74,189,2021
2021_C12063,23,17,84,124,2022
2019_B12064,92,37,81,210,2019
2021_B12065,7,70,66,143,2019
2021_C12066,46,14,51,111,2021
2021_C12067,8,52,59,119,2021
2021_B12068,79,21,48,148,2021
2022_C12069,14,48,22,84,2022
2021_A12070,51,77,40,168,2021
2019_C12071,55,12,68,135,2022
2022_C12072,53,79,23,155,2022
2019_A12073,13,50,63,126,2019
2022_A12074,35,19,75,129,2019
2019_C12075,50,84,60,194,2022
2019_B12076,8,45,89,142,2022
2019_C12077,99,13,25,137,2019
2021_A12078,45,19,25,89,2022
2022_B12079,72,69,44,185,2019
2022_A12080,11,29,85,125,2021
2022_C12081,39,47,54,140,2021
2019_C12082,97,36,40,173,2021
2021_B12083,13,24,21,58,2022
2022_C12084,32,14,70,116,2021
2022_A12085,45,83,42,170,2021
2021_C12086,71,44,34,149,2021
2019_C12087,67,41,28,136,2022
2022_A12088,25,31,71,127,2021
2021_A12089,7,87,85,179,2021
2021_A12090,71,82,39,192,2019
2021_B12091,66,58,89,213,2022
2021_C12092,21,65,96,182,2021
2021_A12093,36,65,33,134,2019
2021_A12094,79,97,80,256,2019
2021_C12095,69,73,43,185,2021
2022_C12096,66,43,46,155,2021
2019_B12097,32,81,84,197,2022
2022_C12098,63,83,85,231,2022
2019_C12099,44,67,63,174,2021
2021_B12100,71,53,22,146,2019
2021_B12101,52,63,98,213,2019
2019_A12102,85,86,38,209,2019
2021_A12103,80,55,73,208,2019
2019_A12104,57,87,70,214,2022
2022_B12105,42,25,70,137,2022
2022_B12106,84,31,26,141,2021
2021_C12107,59,49,64,172,2022
2021_B12108,48,19,27,94,2019
2021_B12109,47,68,97,212,2021
2022_B12110,14,36,35,85,2022
2021_B12111,86,26,87,199,2019
2021_A12112,31,45,83,159,2021
2022_C12113,70,30,22,122,2022
2022_A12114,62,18,83,163,2022
2019_B12115,72,63,32,167,2021
2019_C12116,67,35,30,132,2022
2019_C12117,76,42,96,214,2022
2019_A12118,62,42,90,194,2019
2021_B12119,6,19,48,73,2019
2019_A12120,57,19,35,111,2021
2019_A12121,28,73,26,127,2019
2019_A12122,96,12,50,158,2021
2022_A12123,84,59,26,169,2019
2021_C12124,59,68,71,198,2022
2022_A12125,18,15,76,109,2022
2021_A12126,40,31,82,153,2022
2019_B12127,14,97,65,176,2019
2022_C12128,55,19,51,125,2022
2021_B12129,74,85,75,234,2022
2021_A12130,86,28,98,212,2019
2021_B12131,72,96,82,250,2022
2021_B12132,20,25,78,123,2019
2022_A12133,42,75,63,180,2022
2021_B12134,79,69,90,238,2022
2021_B12135,87,69,80,236,2022
2019_C12136,10,37,88,135,2019
2019_A12137,47,64,23,134,2022
2019_C12138,96,74,27,197,2021
2019_B12139,84,60,69,213,2022
2019_A12140,8,28,72,108,2019
2022_C12141,32,81,43,156,2022
2022_C12142,25,97,53,175,2021
2021_B12143,59,91,97,247,2019
2022_A12144,91,56,28,175,2021
2022_A12145,7,40,74,121,2021
2021_B12146,40,22,53,115,2019
2022_C12147,51,27,78,156,2021
2022_C12148,76,94,75,245,2019
2021_C12149,89,21,34,144,2022
2019_C12150,12,16,39,67,2019
2021_C12151,2,35,91,128,2019
2021_C12152,51,70,49,170,2021
2022_A12153,23,19,54,96,2021
2021_A12154,15,45,44,104,2022
2019_C12155,3,60,41,104,2019
2019_C12156,74,96,57,227,2022
2022_C12157,55,38,45,138,2021
2019_A12158,17,30,77,124,2022
2019_C12159,74,66,54,194,2022
2019_C12160,92,53,63,208,2021
2021_A12161,2,89,84,175,2021
2019_A12162,52,24,60,136,2021
2022_C12163,6,66,90,162,2022
2022_A12164,74,80,78,232,2019
2021_A12165,27,91,49,167,2019
2019_C12166,44,35,27,106,2021
2022_B12167,53,39,50,142,2019
2022_B12168,95,11,38,144,2021
2022_A12169,12,95,72,179,2019
2019_A12170,5,69,54,128,2021
2022_B12171,53,78,34,165,2019
2019_C12172,21,51,79,151,2022
2022_B12173,87,66,75,228,2021
2019_A12174,37,62,92,191,2019
2022_A12175,65,60,94,219,2022
2019_C12176,71,91,27,189,2022
2019_B12177,80,72,90,242,2021
2021_C12178,95,68,22,185,2019
2019_B12179,29,41,27,97,2021
2022_C12180,17,46,30,93,2021
2019_A12181,84,45,71,200,2019
2022_B12182,28,32,98,158,2019
2022_C12183,75,13,70,158,2021
2019_A12184,66,53,40,159,2022
2019_B12185,96,29,86,211,2019
2021_B12186,75,58,76,209,2019
2021_A12187,8,20,27,55,2021
2021_A12188,59,65,55,179,2019
2021_A12189,40,11,90,141,2022
2019_B12190,97,49,29,175,2021
2019_C12191,98,45,91,234,2022
2021_B12192,44,75,82,201,2019
2021_C12193,22,72,56,150,2021
2019_A12194,24,91,84,199,2022
2019_A12195,79,51,64,194,2022
2019_B12196,5,88,60,153,2021
2022_B12197,61,60,48,169,2019
2022_C12198,86,18,27,131,2021
2022_C12199,62,65,76,203,2022
2022_B12200,99,27,86,212,2022
2019_B12201,55,34,44,133,2019
2021_A12202,45,29,24,98,2022
2021_C12203,29,15,62,106,2019
2019_A12204,40,91,47,178,2019
2021_C12205,41,37,72,150,2021
2022_A12206,52,67,95,214,2019
2022_B12207,6,11,93,110,2019
2021_C12208,18,69,39,126,2021
2021_A12209,70,51,48,169,2021
2021_B12210,46,62,27,135,2021
2022_B12211,53,63,68,184,2019
2019_B12212,47,45,50,142,2022
2019_B12213,38,57,76,171,2019
2022_B12214,74,25,42,141,2019
2021_A12215,83,22,64,169,2021
2022_C12216,95,16,87,198,2022
2022_B12217,89,89,70,248,2021
2021_B12218,22,18,77,117,2021
2019_B12219,67,70,49,186,2019
2019_A12220,86,38,56,180,2021
2021_C12221,14,49,30,93,2022
2019_B12222,48,92,85,225,2021
2022_A12223,88,43,48,179,2021
2022_C12224,26,17,34,77,2021
2022_A12225,8,94,99,201,2021
2022_A12226,81,16,63,160,2019
2019_A12227,54,21,54,129,2021
2021_A12228,12,64,73,149,2019
2022_A12229,64,46,46,156,2022
2021_A12230,27,63,83,173,2019
2019_A12231,97,88,27,212,2022
2022_C12232,45,18,29,92,2019
2021_A12233,23,80,90,193,2021
2021_A12234,3,30,84,117,2022
2022_B12235,100,15,51,166,2019
2021_A12236,14,26,94,134,2019
2022_B12237,91,14,55,160,2022
2022_A12238,91,65,70,226,2019
2021_B12239,45,58,61,164,2021
2022_B12240,48,36,69,153,2022
2019_B12241,15,46,91,152,2019
2019_C12242,6,80,59,145,2021
2021_A12243,19,19,36,74,2021
2022_A12244,77,62,83,222,2022
2022_C12245,74,56,87,217,2021
2022_B12246,82,37,70,189,2019
2022_B12247,75,83,43,201,2022
2021_B12248,19,83,53,155,2022
2019_A12249,61,56,94,211,2022
2022_B12250,67,79,93,239,2021
2022_B12251,59,29,90,178,2021
2021_B12252,56,28,27,111,2019
2019_C12253,42,51,81,174,2021
2022_C12254,59,68,26,153,2021
2019_B12255,86,96,96,278,2019
2021_C12256,77,11,64,152,2019
2019_B12257,79,82,50,211,2019
2022_A12258,1,37,78,116,2022
2021_B12259,83,87,89,259,2021
2019_B12260,40,42,40,122,2022
2021_B12261,60,13,76,149,2021
2019_A12262,85,62,79,226,2019
2019_B12263,90,48,61,199,2021
2019_C12264,20,53,44,117,2022
2019_C12265,35,25,64,124,2022
2022_B12266,53,40,72,165,2019
2019_B12267,54,47,66,167,2021
2019_A12268,98,42,95,235,2019
2019_C12269,58,47,53,158,2021
2019_B12270,30,34,92,156,2021
2019_A12271,60,86,88,234,2022
2019_A12272,14,26,48,88,2022
2022_B12273,56,24,71,151,2019
2022_B12274,20,40,91,151,2019
2019_C12275,92,29,96,217,2019
2022_B12276,12,79,55,146,2019
2022_B12277,40,30,34,104,2022
2021_C12278,17,17,60,94,2021
2019_B12279,90,91,79,260,2021
2022_C12280,61,91,22,174,2021
2022_C12281,39,56,95,190,2019
2022_B12282,82,69,98,249,2022
2021_C12283,40,20,44,104,2019
2021_A12284,73,76,32,181,2021
2019_C12285,86,97,73,256,2022
2022_A12286,21,11,64,96,2019
2022_C12287,90,19,79,188,2019
2021_A12288,32,86,57,175,2019
2019_C12289,6,58,47,111,2021
2022_A12290,34,13,95,142,2022
2019_A12291,75,67,64,206,2019
2022_B12292,90,69,28,187,2021
2022_A12293,45,66,90,201,2021
2019_C12294,82,49,82,213,2021
2022_C12295,83,32,74,189,2019
2022_A12296,41,35,23,99,2022
2019_A12297,8,59,63,130,2021
2021_A12298,57,13,23,93,2019
2021_B12299,22,60,84,166,2022
2022_C12300,92,80,76,248,2021
2022_C12301,38,41,96,175,2022
2019_B12302,1,32,80,113,2022
2019_A12303,67,40,40,147,2022
2019_C12304,82,60,33,175,2019
2021_C12305,31,64,38,133,2021
2022_C12306,50,69,32,151,2019
2019_C12307,71,91,42,204,2019
2019_A12308,44,49,51,144,2019
2019_A12309,64,20,34,118,2021
2019_B12310,12,19,90,121,2021
2019_C12311,29,13,84,126,2019
2022_B12312,81,40,88,209,2019
2022_B12313,4,14,95,113,2019
2019_B12314,61,60,35,156,2021
2022_C12315,42,57,56,155,2021
2022_C12316,23,39,65,127,2022
2021_A12317,46,80,90,216,2022
2022_A12318,48,39,69,156,2021
2019_B12319,74,90,26,190,2022
2022_C12320,34,12,55,101,2021
2019_A12321,19,30,92,141,2022
2019_A12322,19,80,97,196,2022
2019_B12323,19,12,68,99,2022
2019_B12324,10,20,37,67,2022
2019_C12325,79,13,21,113,2022
2019_A12326,17,92,30,139,2021
2022_B12327,43,76,81,200,2021
2019_B12328,28,46,73,147,2022
2022_A12329,47,46,32,125,2019
2022_C12330,9,95,68,172,2022
2022_B12331,39,48,52,139,2022
2022_A12332,86,43,72,201,2021
2021_B12333,25,95,63,183,2019
2019_C12334,36,53,97,186,2021
2021_B12335,21,86,71,178,2022
2022_C12336,70,96,69,235,2019
2019_C12337,97,86,47,230,2022
2019_B12338,74,45,38,157,2022
2021_C12339,54,69,62,185,2019
2019_C12340,95,59,63,217,2022
2019_C12341,98,31,81,210,2019
2021_A12342,1,47,31,79,2021
2019_A12343,20,30,78,128,2022
2022_A12344,76,24,92,192,2022
2022_A12345,6,64,37,107,2021
2019_B12346,3,75,43,121,2022
2019_A12347,62,11,86,159,2019
2021_C12348,70,13,23,106,2022
2021_A12349,13,12,52,77,2022
2019_A12350,94,96,38,228,2021
2021_C12351,56,22,96,174,2019
2022_B12352,75,50,21,146,2021
2022_A12353,54,37,62,153,2021
2022_A12354,95,31,54,180,2021
2021_B12355,59,17,48,124,2022
2021_A12356,42,83,61,186,2021
2019_A12357,10,47,97,154,2021
2019_A12358,75,41,31,147,2021
2022_C12359,10,63,53,126,2021
2021_C12360,7,33,98,138,2021
2021_A12361,45,90,64,199,2019
2021_B12362,87,97,34,218,2022
2021_C12363,24,65,75,164,2022
2019_A12364,42,43,62,147,2021
2022_A12365,99,48,55,202,2019
2022_A12366,92,20,77,189,2022
2019_A12367,5,41,39,85,2022
2021_A12368,71,92,24,187,2019
2022_A12369,5,25,48,78,2021
2019_C12370,16,30,87,133,2021
2021_C12371,45,76,41,162,2021
2019_C12372,4,75,53,132,2022
2019_A12373,15,33,61,109,2019
2022_B12374,74,88,23,185,2019
2022_C12375,77,16,36,129,2019
2021_A12376,67,45,63,175,2021
2021_B12377,53,23,58,134,2021
2021_B12378,3,79,40,122,2021
2019_A12379,43,66,96,205,2019
2019_A12380,5,25,55,85,2021
2021_A12381,8,50,41,99,2019
2022_B12382,6,39,33,78,2022
2022_A12383,2,26,75,103,2022
2021_A12384,74,84,89,247,2022
2019_A12385,67,26,85,178,2019
2021_A12386,27,79,97,203,2021
2019_A12387,51,31,82,164,2021
2021_C12388,48,60,43,151,2021
2019_A12389,68,16,35,119,2019
2021_C12390,14,47,40,101,2021
2019_C12391,26,83,74,183,2021
2022_C12392,0,93,77,170,2019
2021_B12393,51,45,37,133,2019
2022_C12394,29,58,53,140,2021
2021_C12395,27,63,31,121,2021
2022_C12396,49,30,46,125,2022
2022_B12397,43,57,48,148,2021
2019_B12398,4,29,57,90,2021
2021_C12399,90,40,36,166,2022
2021_C12400,79,94,56,229,2019
2019_A12401,45,80,69,194,2021
2019_C12402,87,76,52,215,2019
2021_A12403,52,48,43,143,2021
2019_B12404,90,19,71,180,2019
2019_A12405,45,54,49,148,2019
2019_B12406,17,58,68,143,2021
2019_A12407,74,17,76,167,2022
2021_C12408,24,68,91,183,2021
2019_B12409,62,72,25,159,2019
2021_C12410,11,42,65,118,2019
2022_B12411,20,40,45,105,2022
2022_C12412,89,39,77,205,2021
2019_A12413,51,46,96,193,2022
2022_B12414,69,32,28,129,2022
2021_C12415,33,83,56,172,2021
2019_A12416,2,19,47,68,2021
2022_B12417,7,59,26,92,2021
2019_B12418,85,42,50,177,2022
2022_C12419,76,85,85,246,2022
2021_A12420,91,18,90,199,2019
2022_B12421,86,61,24,171,2019
2019_B12422,78,23,78,179,2019
2019_B12423,76,70,98,244,2022
2022_A12424,81,45,80,206,2021
2022_C12425,41,42,77,160,2021
2019_A12426,81,82,48,211,2021
2019_C12427,25,49,94,168,2022
2022_C12428,54,70,44,168,2019
2021_C12429,16,32,59,107,2022
2019_B12430,57,78,23,158,2019
2021_C12431,15,14,42,71,2022
2019_C12432,80,72,48,200,2022
2022_A12433,30,53,86,169,2022
2022_C12434,5,69,69,143,2022
2022_A12435,62,39,25,126,2021
2021_A12436,94,95,70,259,2022
2021_C12437,77,68,93,238,2021
2022_B12438,37,39,96,172,2021
2021_A12439,97,39,35,171,2021
2022_A12440,49,46,77,172,2021
2022_B12441,38,48,76,162,2019
2021_B12442,62,26,61,149,2019
2021_B12443,34,88,28,150,2022
2019_A12444,68,30,70,168,2019
2019_C12445,75,93,51,219,2022
2022_C12446,38,44,57,139,2021
2021_B12447,4,53,44,101,2021
2022_A12448,62,62,70,194,2019
2022_A12449,91,51,28,170,2019
2022_C12450,44,92,72,208,2021
2021_C12451,80,89,94,263,2019
2022_B12452,96,94,79,269,2019
2022_B12453,5,80,92,177,2022
2019_A12454,69,43,64,176,2022
2019_C12455,12,74,51,137,2021
2021_B12456,53,75,43,171,2021
2021_C12457,52,45,36,133,2021
2022_C12458,75,81,27,183,2022
2022_C12459,62,86,67,215,2022
2021_C12460,36,39,23,98,2021
2021_C12461,69,70,45,184,2022
2022_B12462,17,74,98,189,2021
2022_C12463,26,58,21,105,2022
2019_C12464,9,34,44,87,2022
2022_A12465,85,65,53,203,2021
2019_B12466,67,76,92,235,2022
2022_C12467,48,42,54,144,2019
2021_C12468,58,12,37,107,2022
2022_B12469,36,76,71,183,2021
2021_C12470,58,17,93,168,2019
2019_A12471,61,35,78,174,2019
2019_B12472,9,73,70,152,2022
2021_A12473,64,35,74,173,2019
2022_B12474,39,14,87,140,2019
2021_B12475,41,34,38,113,2021
2022_B12476,94,11,48,153,2021
2019_A12477,18,66,90,174,2021
2022_C12478,17,65,54,136,2019
2022_C12479,15,26,69,110,2019
2021_B12480,60,88,64,212,2019
2022_C12481,53,66,86,205,2022
2022_B12482,84,14,48,146,2019
2019_B12483,24,90,82,196,2021
2019_C12484,69,27,96,192,2022
2019_C12485,50,87,32,169,2021
2021_A12486,65,88,81,234,2019
2022_B12487,15,69,47,131,2021
2019_C12488,84,91,77,252,2019
2019_A12489,38,32,24,94,2021
2021_B12490,64,52,52,168,2021
2021_B12491,3,78,35,116,2022
2022_C12492,63,41,71,175,2021
2019_A12493,12,80,87,179,2022
2022_B12494,90,66,27,183,2022
2019_C12495,9,51,48,108,2019
2022_A12496,90,19,99,208,2019
2021_A12497,7,22,79,108,2019
2021_C12498,41,86,52,179,2022
2021_C12499,21,14,67,102,2019
2022_C12500,64,97,61,222,2019
2019_B12501,65,19,78,162,2019
2021_B12502,71,65,68,204,2022
2022_B12503,32,95,31,158,2021
2022_A12504,71,91,53,215,2022
2022_C12505,74,90,57,221,2019
2019_B12506,99,11,47,157,2021
2021_B12507,12,24,54,90,2019
2021_B12508,56,90,59,205,2021
2019_B12509,44,42,29,115,2022
2019_A12510,21,63,83,167,2021
2022_B12511,39,79,68,186,2022
2021_B12512,46,91,42,179,2021
2021_B12513,98,57,68,223,2022
2021_A12514,72,87,46,205,2019
2021_C12515,34,19,70,123,2022
2021_B12516,38,33,88,159,2022
2019_A12517,86,76,47,209,2022
2022_A12518,32,56,54,142,2019
2021_B12519,80,81,56,217,2022
2021_A12520,16,51,70,137,2019
2022_A12521,39,75,93,207,2019
2021_C12522,10,19,25,54,2021
2022_A12523,78,96,94,268,2019
2019_B12524,75,91,62,228,2019
2022_A12525,61,38,30,129,2021
2021_B12526,13,39,68,120,2019
2021_B12527,19,11,70,100,2022
2022_A12528,7,68,35,110,2022
2022_A12529,99,54,73,226,2022
2022_A12530,57,20,40,117,2019
2022_C12531,78,26,95,199,2019
2021_C12532,72,45,55,172,2019
2022_B12533,61,55,53,169,2021
2022_A12534,60,35,37,132,2021
2021_C12535,96,67,59,222,2021
2019_C12536,77,75,41,193,2022
2022_B12537,92,46,38,176,2019
2019_B12538,49,75,68,192,2019
2021_A12539,2,49,82,133,2019
2021_C12540,73,44,97,214,2019
2021_A12541,9,23,26,58,2021
2021_B12542,54,20,95,169,2022
2021_B12543,60,11,79,150,2019
2021_C12544,5,14,82,101,2019
2022_C12545,30,40,58,128,2022
2022_A12546,3,79,88,170,2019
2019_B12547,25,97,88,210,2022
2022_C12548,82,83,49,214,2021
2022_A12549,6,40,65,111,2019
2019_C12550,52,90,57,199,2021
2022_B12551,99,11,57,167,2019
2019_B12552,2,40,80,122,2021
2019_A12553,58,96,85,239,2019
2022_B12554,71,48,49,168,2021
2019_A12555,35,77,21,133,2022
2021_A12556,90,63,66,219,2019
2021_B12557,21,44,70,135,2019
2022_B12558,10,63,46,119,2019
2019_B12559,30,81,56,167,2022
2019_C12560,78,66,37,181,2022
2022_A12561,65,16,41,122,2019
2022_C12562,20,33,24,77,2021
2022_C12563,13,12,84,109,2022
2019_C12564,85,18,36,139,2019
2019_A12565,93,16,33,142,2019
2019_A12566,9,77,28,114,2022
2019_C12567,24,20,26,70,2021
2022_C12568,1,52,70,123,2019
2019_A12569,20,18,84,122,2021
2021_B12570,58,21,36,115,2021
2021_A12571,48,26,75,149,2021
2019_C12572,53,86,66,205,2022
2021_B12573,5,59,54,118,2019
2021_B12574,54,63,95,212,2022
2022_C12575,59,28,96,183,2019
2019_A12576,21,12,79,112,2022
2019_A12577,68,69,32,169,2022
2019_B12578,6,37,45,88,2019
2021_A12579,91,33,39,163,2019
2019_C12580,83,54,29,166,2022
2019_C12581,52,66,28,146,2021
2021_C12582,73,29,54,156,2021
2021_A12583,26,95,92,213,2022
2022_A12584,72,84,58,214,2019
2019_B12585,75,54,22,151,2019
2022_B12586,23,29,28,80,2019
2022_A12587,94,38,73,205,2022
2021_B12588,81,74,43,198,2019
2022_B12589,33,47,89,169,2019
2021_A12590,78,89,71,238,2022
2022_B12591,54,93,49,196,2019
2019_A12592,62,76,44,182,2021
2019_C12593,68,71,51,190,2022
2021_A12594,93,63,99,255,2019
2021_C12595,66,17,58,141,2021
2019_A12596,62,36,96,194,2022
2022_C12597,25,73,62,160,2022
2021_A12598,71,46,25,142,2021
2019_B12599,25,46,94,165,2019
2019_A12600,64,97,53,214,2022
2022_C12601,63,27,29,119,2022
2021_A12602,58,84,50,192,2021
2019_C12603,57,48,89,194,2019
2021_B12604,58,77,60,195,2022
2022_A12605,86,65,62,213,2021
2021_A12606,90,47,72,209,2022
2022_A12607,97,17,45,159,2019
2019_A12608,86,44,53,183,2022
2019_A12609,88,38,63,189,2019
2022_B12610,0,38,38,76,2021
2019_C12611,100,36,38,174,2019
2022_A12612,90,24,21,135,2022
2022_C12613,45,79,24,148,2021
2021_C12614,44,35,61,140,2021
2022_A12615,21,85,68,174,2021
2019_A12616,40,46,81,167,2019
2021_A12617,0,48,43,91,2021
2021_A12618,6,62,93,161,2021
2022_A12619,82,65,80,227,2019
2019_C12620,26,71,21,118,2021
2019_C12621,33,35,89,157,2019
2021_C12622,21,90,52,163,2019
2022_A12623,40,71,32,143,2022
2021_C12624,34,31,81,146,2022
2022_C12625,1,83,32,116,2019
2021_B12626,82,33,22,137,2022
2021_C12627,47,89,68,204,2019
2022_C12628,76,22,31,129,2021
2019_A12629,60,20,68,148,2019
2022_A12630,52,56,87,195,2019
2022_C12631,50,55,97,202,2021
2019_B12632,36,45,32,113,2021
2021_A12633,16,21,66,103,2022
2019_A12634,86,32,35,153,2019
2021_C12635,96,80,40,216,2021
2021_B12636,24,75,98,197,2019
2021_B12637,59,96,24,179,2021
2021_C12638,88,18,62,168,2021
2022_C12639,89,19,44,152,2022
2021_C12640,34,37,25,96,2022
2019_A12641,80,85,69,234,2019
2019_B12642,7,38,80,125,2022
2019_C12643,56,28,61,145,2021
2022_B12644,84,82,46,212,2021
2022_A12645,55,32,81,168,2022
2021_C12646,14,41,40,95,2019
2022_A12647,31,79,90,200,2019
2022_C12648,21,15,68,104,2021
2022_C12649,88,66,55,209,2022
2019_C12650,29,31,31,91,2021
2019_B12651,97,25,71,193,2022
2022_B12652,59,71,34,164,2021
2022_C12653,77,42,60,179,2021
2019_A12654,25,43,96,164,2022
2019_C12655,47,20,22,89,2021
2021_C12656,93,70,72,235,2021
2021_B12657,56,29,92,177,2022
2022_A12658,0,48,52,100,2019
2022_C12659,25,69,87,181,2022
2021_B12660,67,88,26,181,2022
2019_B12661,29,57,24,110,2021
2021_A12662,66,25,61,152,2022
2021_A12663,19,88,48,155,2022
2021_C12664,96,15,96,207,2019
2022_C12665,35,49,78,162,2021
2021_B12666,22,77,73,172,2022
2019_B12667,61,28,44,133,2021
2022_C12668,95,20,90,205,2022
2021_B12669,79,82,49,210,2019
2019_A12670,3,96,31,130,2019
2021_B12671,41,44,86,171,2019
2022_B12672,66,17,47,130,2022
2019_A12673,21,59,58,138,2021
2019_A12674,33,27,25,85,2021
2022_A12675,89,86,60,235,2022
2019_C12676,57,76,66,199,2021
2022_C12677,21,20,51,92,2021
2021_A12678,91,31,25,147,2021
2019_B12679,4,75,73,152,2021
2021_A12680,7,18,63,88,2022
2021_A12681,62,94,88,244,2019
2021_B12682,24,40,87,151,2021
2022_A12683,1,11,95,107,2021
2022_A12684,53,39,63,155,2021
2019_A12685,61,82,66,209,2021
2022_A12686,76,55,38,169,2022
2022_C12687,92,37,41,170,2022
2019_B12688,64,16,35,115,2019
2019_A12689,42,18,76,136,2019
2019_B12690,11,70,67,148,2019
2019_B12691,77,58,21,156,2022
2021_C12692,14,29,75,118,2021
2019_C12693,83,19,44,146,2019
2021_C12694,55,59,37,151,2022
2019_C12695,58,59,96,213,2021
2019_A12696,15,54,27,96,2022
2022_A12697,7,50,57,114,2022
2019_C12698,27,51,36,114,2019
2021_B12699,40,92,69,201,2021
2022_C12700,67,26,72,165,2021
2019_A12701,5,77,72,154,2022
2022_C12702,6,41,50,97,2019
2019_B12703,91,21,29,141,2022
2021_B12704,3,41,84,128,2021
2019_C12705,50,60,67,177,2019
2019_A12706,7,75,65,147,2022
2019_A12707,33,65,23,121,2021
2021_A12708,8,83,65,156,2022
2019_C12709,34,15,87,136,2019
2022_B12710,11,71,47,129,2021
2019_A12711,60,45,57,162,2019
2022_A12712,49,69,91,209,2022
2022_B12713,82,40,42,164,2022
2021_A12714,67,56,75,198,2022
2019_C12715,76,63,86,225,2021
2021_B12716,11,24,73,108,2021
2022_C12717,76,58,49,183,2019
2022_A12718,65,17,68,150,2022
2022_C12719,49,63,42,154,2022
2019_A12720,48,91,60,199,2019
2021_C12721,83,16,31,130,2021
2021_A12722,23,57,40,120,2021
2019_C12723,27,76,66,169,2019
2021_B12724,50,19,78,147,2021
2022_A12725,69,81,60,210,2022
2021_B12726,78,20,78,176,2021
2019_C12727,88,24,34,146,2022
2019_B12728,33,31,74,138,2021
2021_A12729,43,88,62,193,2022
2019_A12730,38,77,25,140,2019
2021_A12731,89,34,89,212,2021
2019_C12732,85,27,32,144,2019
2019_B12733,82,59,85,226,2021
2021_C12734,52,55,82,189,2021
2022_A12735,47,23,43,113,2019
2019_A12736,88,79,74,241,2021
2022_C12737,44,40,25,109,2019
2022_B12738,39,65,22,126,2019
2019_C12739,46,20,22,88,2019
2021_B12740,61,59,22,142,2022
2019_C12741,91,21,70,182,2022
2021_A12742,83,73,77,233,2021
2019_A12743,45,46,84,175,2019
2019_B12744,18,17,30,65,2021
2022_A12745,32,66,68,166,2022
2021_C12746,46,50,43,139,2022
2019_A12747,48,36,85,169,2021
2021_C12748,67,51,58,176,2021
2022_A12749,41,34,95,170,2022
2021_A12750,65,95,63,223,2022
2022_B12751,5,82,66,153,2021
2022_A12752,53,89,59,201,2021
2019_A12753,42,95,39,176,2022
2021_C12754,44,22,88,154,2021
2019_A12755,25,91,50,166,2019
2022_B12756,73,63,85,221,2021
2021_B12757,80,74,23,177,2021
2019_A12758,54,44,25,123,2019
2022_A12759,35,23,70,128,2019
2019_C12760,79,61,23,163,2022
2019_C12761,2,90,67,159,2021
2022_C12762,78,22,70,170,2019
2022_A12763,23,47,93,163,2019
2019_B12764,16,17,53,86,2021
2022_A12765,94,81,52,227,2019
2021_A12766,31,83,53,167,2022
2022_A12767,84,57,54,195,2021
2022_C12768,17,66,50,133,2021
2021_C12769,94,71,79,244,2019
2021_C12770,31,14,88,133,2022
2021_C12771,9,97,97,203,2021
2019_C12772,7,57,53,117,2019
2019_B12773,25,57,55,137,2019
2022_B12774,7,59,29,95,2021
2019_C12775,49,14,53,116,2019
2019_C12776,58,60,23,141,2022
2022_B12777,1,65,69,135,2022
2019_A12778,27,45,87,159,2021
2019_C12779,33,25,35,93,2019
2019_B12780,64,23,80,167,2019
2019_B12781,84,81,60,225,2019
2021_B12782,11,17,78,106,2022
2022_B12783,56,81,66,203,2021
2019_C12784,11,94,33,138,2021
2019_B12785,47,46,66,159,2019
2021_C12786,91,95,90,276,2022
2021_A12787,12,15,92,119,2021
2019_C12788,73,62,37,172,2022
2022_B12789,57,89,32,178,2019
2019_C12790,16,61,38,115,2022
2019_B12791,5,19,40,64,2019
2019_B12792,49,43,88,180,2022
2019_A12793,35,57,35,127,2021
2021_B12794,25,89,77,191,2022
2022_B12795,89,21,36,146,2022
2019_A12796,98,80,45,223,2021
2022_A12797,36,61,30,127,2019
2019_B12798,10,29,48,87,2019
2022_C12799,20,15,73,108,2021
2021_A12800,85,80,92,257,2022
2021_C12801,15,97,76,188,2021
2019_C12802,69,43,91,203,2021
2022_B12803,84,93,94,271,2019
2022_C12804,59,53,50,162,2021
2022_C12805,21,47,61,129,2021
2019_A12806,31,80,58,169,2019
2022_B12807,0,68,97,165,2022
2022_A12808,40,69,51,160,2021
2019_C12809,45,36,73,154,2019
2021_C12810,67,27,34,128,2022
2022_C12811,73,39,80,192,2022
2019_B12812,47,42,29,118,2022
2021_A12813,32,25,88,145,2022
2022_C12814,91,69,90,250,2022
2022_B12815,20,56,96,172,2021
2022_C12816,95,79,70,244,2022
2022_A12817,49,19,73,141,2021
2019_B12818,88,24,35,147,2022
2021_B12819,20,17,83,120,2019
2022_A12820,90,72,69,231,2022
2021_A12821,81,78,37,196,2019
2021_B12822,56,41,93,190,2022
2021_B12823,1,38,56,95,2022
2022_B12824,1,60,79,140,2021
2021_A12825,51,22,88,161,2022
2021_C12826,14,54,26,94,2021
2022_B12827,3,71,58,132,2021
2019_C12828,86,94,65,245,2022
2021_B12829,5,69,43,117,2019
2022_C12830,6,68,38,112,2019
2022_C12831,93,66,38,197,2021
2022_A12832,36,49,33,118,2022
2022_C12833,1,48,95,144,2022
2019_B12834,80,16,75,171,2021
2019_C12835,47,61,69,177,2019
2021_A12836,41,36,81,158,2021
2021_C12837,86,54,68,208,2019
2022_B12838,42,47,30,119,2019
2022_C12839,1,46,91,138,2022
2019_A12840,73,95,85,253,2019
2021_C12841,93,22,87,202,2022
2019_C12842,92,84,98,274,2021
2021_A12843,13,73,64,150,2022
2021_C12844,70,96,88,254,2019
2019_C12845,99,94,88,281,2019
2021_B12846,89,36,42,167,2021
2019_A12847,20,87,44,151,2021
2019_B12848,79,48,69,196,2022
2022_C12849,3,15,36,54,2019
2022_A12850,61,89,58,208,2022
2019_A12851,92,66,65,223,2019
2019_C12852,9,11,86,106,2022
2021_B12853,18,68,81,167,2019
2019_B12854,76,57,62,195,2019
2022_B12855,55,44,39,138,2021
2022_A12856,44,15,26,85,2021
2019_C12857,30,86,44,160,2021
2022_A12858,2,63,53,118,2021
2021_B12859,74,33,25,132,2022
2022_C12860,31,83,78,192,2019
2022_C12861,87,57,64,208,2019
2021_C12862,91,18,52,161,2021
2022_B12863,64,29,85,178,2019
2022_B12864,0,77,98,175,2019
2021_A12865,1,64,98,163,2019
2021_C12866,60,80,23,163,2022
2022_C12867,66,70,60,196,2021
2022_B12868,4,56,95,155,2022
2022_B12869,3,97,53,153,2021
2022_C12870,86,35,26,147,2022
2021_B12871,97,46,92,235,2019
2022_C12872,52,43,26,121,2022
2019_B12873,47,28,51,126,2019
2021_B12874,76,96,82,254,2022
2021_B12875,49,61,56,166,2021
2019_B12876,64,64,84,212,2019
2022_A12877,59,77,71,207,2021
2022_B12878,87,87,80,254,2022
2022_A12879,38,79,21,138,2019
2021_A12880,75,73,37,185,2019
2022_C12881,51,44,24,119,2022
2019_A12882,69,62,78,209,2022
2021_C12883,95,90,46,231,2021
2021_A12884,81,20,97,198,2022
2019_C12885,17,15,49,81,2021
2022_B12886,40,15,92,147,2019
2022_B12887,43,48,31,122,2019
2019_C12888,82,81,30,193,2019
2019_B12889,42,77,38,157,2022
2019_B12890,15,60,25,100,2022
2021_A12891,74,72,47,193,2021
2021_C12892,75,45,79,199,2019
2022_C12893,99,36,70,205,2019
2022_A12894,50,28,62,140,2021
2019_A12895,98,37,53,188,2019
2021_C12896,87,22,81,190,2019
2019_C12897,48,82,81,211,2022
2021_B12898,19,33,87,139,2022
2019_C12899,6,38,84,128,2019
2022_B12900,38,29,45,112,2021
2021_B12901,30,18,24,72,2021
2019_C12902,80,50,29,159,2022
2019_C12903,66,53,62,181,2022
2022_B12904,90,45,86,221,2022
2022_B12905,94,93,41,228,2021
2019_A12906,2,26,83,111,2022
2022_B12907,20,65,55,140,2019
2021_B12908,57,68,98,223,2022
2021_C12909,26,18,67,111,2021
2019_C12910,60,24,35,119,2019
2019_B12911,7,58,59,124,2022
2022_B12912,2,96,90,188,2022
2022_C12913,86,77,87,250,2021
2019_B12914,51,29,34,114,2021
2022_B12915,12,40,38,90,2021
2021_C12916,46,19,74,139,2019
2021_A12917,42,22,98,162,2021
2022_A12918,59,35,32,126,2019
2019_C12919,2,23,58,83,2022
2019_C12920,45,96,33,174,2022
2022_C12921,35,66,95,196,2019
2021_C12922,44,48,35,127,2022
2022_C12923,95,97,75,267,2021
2022_C12924,46,17,72,135,2021
2022_A12925,18,15,72,105,2022
2022_B12926,92,93,52,237,2021
2021_B12927,28,81,36,145,2021
2019_C12928,50,50,30,130,2019
2019_C12929,87,19,28,134,2021
2021_C12930,90,25,47,162,2021
2022_B12931,74,43,51,168,2022
2019_A12932,35,29,87,151,2021
2021_B12933,68,33,83,184,2021
2021_B12934,78,56,47,181,2019
2022_A12935,99,18,59,176,2021
2019_B12936,51,47,42,140,2021
2019_B12937,65,16,78,159,2021
2022_C12938,29,45,44,118,2021
2019_B12939,76,76,50,202,2022
2022_B12940,99,54,57,210,2019
2019_B12941,16,14,85,115,2021
2019_A12942,45,80,99,224,2019
2019_B12943,79,45,43,167,2019
2021_B12944,88,28,33,149,2019
2022_B12945,42,27,40,109,2022
2022_C12946,96,15,76,187,2021
2021_C12947,26,78,97,201,2021
2021_B12948,61,89,53,203,2021
2019_B12949,74,58,77,209,2021
2019_C12950,21,95,27,143,2022
2019_C12951,95,52,78,225,2019
2019_B12952,48,90,35,173,2022
2022_A12953,9,85,47,141,2021
2019_A12954,69,76,79,224,2019
2019_B12955,48,50,82,180,2019
2019_A12956,29,29,78,136,2019
2022_C12957,39,30,46,115,2019
2021_B12958,46,85,80,211,2022
2021_A12959,95,30,89,214,2019
2022_C12960,16,18,34,68,2021
2021_B12961,28,89,34,151,2022
2019_B12962,57,39,41,137,2022
2022_C12963,37,94,25,156,2022
2021_C12964,27,37,39,103,2019
2021_B12965,52,32,31,115,2022
2021_A12966,1,81,67,149,2019
2022_B12967,91,75,24,190,2022
2021_A12968,93,17,53,163,2022
2019_C12969,14,37,84,135,2021
2022_C12970,14,43,82,139,2019
2022_C12971,34,42,56,132,2019
2022_C12972,97,29,85,211,2022
2019_A12973,49,17,60,126,2019
2021_A12974,93,87,25,205,2019
2021_A12975,45,57,68,170,2022
2019_C12976,87,51,99,237,2021
2021_C12977,18,61,45,124,2022
2022_C12978,32,87,83,202,2019
2021_C12979,10,66,34,110,2022
2022_C12980,91,38,21,150,2021
2022_C12981,17,39,31,87,2022
2021_B12982,85,67,95,247,2019
2021_C12983,53,73,40,166,2021
2022_C12984,100,45,66,211,2021
2022_C12985,50,54,95,199,2019
2022_B12986,61,20,52,133,2021
2022_B12987,57,38,88,183,2019
2021_C12988,75,60,22,157,2022
2021_C12989,49,93,87,229,2021
2022_A12990,100,17,85,202,2019
2021_A12991,42,12,43,97,2019
2019_A12992,37,17,70,124,2021
2021_B12993,82,95,78,255,2021
2021_C12994,2,51,86,139,2022
2019_C12995,60,63,53,176,2021
2021_C12996,9,24,73,106,2022
2019_B12997,2,66,83,151,2021
2019_A12998,28,51,74,153,2021
2022_A12999,86,83,21,190,2021
2019_B13000,17,83,83,183,2019
2021_C13001,71,39,58,168,2022
2022_C13002,32,49,66,147,2022
2022_A13003,39,69,37,145,2021
2021_A13004,88,95,85,268,2022
2022_A13005,74,97,27,198,2021
2022_B13006,57,34,30,121,2021
2021_C13007,42,16,59,117,2021
2021_A13008,97,29,86,212,2022
2021_A13009,46,28,21,95,2022
2019_A13010,12,60,64,136,2022
2021_C13011,8,43,40,91,2019
2021_A13012,6,22,61,89,2021
2022_C13013,6,72,32,110,2019
2022_B13014,26,84,28,138,2022
2022_B13015,37,43,26,106,2021
2022_C13016,94,65,61,220,2021
2022_C13017,5,15,55,75,2021
2022_C13018,70,40,78,188,2021
2021_A13019,39,67,99,205,2022
2021_C13020,44,64,45,153,2021
2022_C13021,7,62,22,91,2022
2021_A13022,14,64,30,108,2021
2021_A13023,84,12,94,190,2022
2022_C13024,57,59,45,161,2019
2022_B13025,41,11,92,144,2019
2021_B13026,82,95,52,229,2021
2019_B13027,46,54,75,175,2022
2019_A13028,25,56,88,169,2022
2021_C13029,81,49,96,226,2019
2022_B13030,6,52,55,113,2019
2019_C13031,2,27,93,122,2021
2019_B13032,30,25,66,121,2021
2022_C13033,17,27,49,93,2022
2021_B13034,13,43,58,114,2021
2021_A13035,94,32,42,168,2019
2022_C13036,24,36,73,133,2022
2021_B13037,22,69,64,155,2019
2021_A13038,99,15,68,182,2021
2019_C13039,86,39,69,194,2019
2019_B13040,34,64,76,174,2022
2022_A13041,54,55,87,196,2022
2019_A13042,4,58,47,109,2022
2019_A13043,53,68,77,198,2019
2019_A13044,97,80,24,201,2021
2021_A13045,36,57,21,114,2019
2021_B13046,27,16,49,92,2019
2022_C13047,96,50,63,209,2019
2019_B13048,82,23,86,191,2021
2022_C13049,16,42,58,116,2022
2019_C13050,97,79,33,209,2019
2019_C13051,96,89,75,260,2022
2022_C13052,67,97,96,260,2021
2022_A13053,14,24,34,72,2022
2019_B13054,29,36,79,144,2021
2021_B13055,19,49,78,146,2021
2019_C13056,19,60,73,152,2019
2019_A13057,1,95,43,139,2019
2019_C13058,41,87,45,173,2019
2022_C13059,15,75,63,153,2019
2021_B13060,23,38,62,123,2019
2021_C13061,66,49,41,156,2021
2021_C13062,38,31,98,167,2022
2021_B13063,36,47,47,130,2022
2019_B13064,60,78,65,203,2022
2022_B13065,31,50,21,102,2021
2019_C13066,95,96,42,233,2022
2021_B13067,49,78,45,172,2019
2021_C13068,55,83,76,214,2022
2021_B13069,26,89,74,189,2019
2022_C13070,91,72,81,244,2022
2022_C13071,0,96,46,142,2022
2022_B13072,93,35,52,180,2021
2021_B13073,93,14,76,183,2022
2022_A13074,95,86,83,264,2022
2021_B13075,1,47,23,71,2019
2022_C13076,72,53,97,222,2021
2022_B13077,43,50,83,176,2021
2019_A13078,62,73,55,190,2022
2021_C13079,35,58,91,184,2021
2021_C13080,80,55,41,176,2021
2022_C13081,71,83,32,186,2019
2019_B13082,19,28,65,112,2021
2019_B13083,37,91,30,158,2022
2019_C13084,34,42,30,106,2021
2019_C13085,28,43,30,101,2019
2019_A13086,32,52,58,142,2019
2022_A13087,43,36,80,159,2019
2022_A13088,87,22,67,176,2022
2019_B13089,52,12,66,130,2021
2019_C13090,66,36,44,146,2019
2022_B13091,34,55,54,143,2022
2019_C13092,5,21,45,71,2019
2022_C13093,84,13,53,150,2019
2021_C13094,66,48,98,212,2021
2019_A13095,44,29,89,162,2022
2022_A13096,43,13,55,111,2019
2022_C13097,38,25,87,150,2019
2021_C13098,37,30,97,164,2022
2021_C13099,84,70,36,190,2019
2022_C13100,78,14,37,129,2022
2021_B13101,14,50,24,88,2022
2019_A13102,9,96,35,140,2022
2022_C13103,29,89,59,177,2022
2021_A13104,80,51,58,189,2021
2021_B13105,72,69,42,183,2021
2022_C13106,51,60,44,155,2019
2022_A13107,91,90,98,279,2021
2021_A13108,60,68,45,173,2022
2021_B13109,54,49,76,179,2022
2019_A13110,88,79,41,208,2021
2021_C13111,32,52,79,163,2022
2019_A13112,83,72,34,189,2019
2019_A13113,45,34,86,165,2021
2022_B13114,91,32,99,222,2019
2021_A13115,34,69,67,170,2019
2022_C13116,49,87,39,175,2019
2019_A13117,57,54,22,133,2021
2021_B13118,48,18,59,125,2019
2021_C13119,68,39,36,143,2022
2022_A13120,28,72,48,148,2021
2022_C13121,85,22,23,130,2021
2021_A13122,12,97,93,202,2019
2022_C13123,66,57,42,165,2019
2021_C13124,61,42,48,151,2022
2019_C13125,22,76,24,122,2022
2022_A13126,99,17,91,207,2022
2022_A13127,100,36,41,177,2019
2019_A13128,80,51,90,221,2019
2019_C13129,7,45,27,79,2022
2022_A13130,63,51,77,191,2019
2019_C13131,81,68,90,239,2019
2022_B13132,69,17,76,162,2021
2022_B13133,14,32,77,123,2019
2021_C13134,26,58,53,137,2019
2019_C13135,95,85,51,231,2021
2022_C13136,15,40,55,110,2019
2019_A13137,45,85,63,193,2022
2021_C13138,17,34,72,123,2019
2021_A13139,7,85,67,159,2022
2019_B13140,39,82,76,197,2019
2022_C13141,73,41,25,139,2022
2019_B13142,74,30,30,134,2021
2021_B13143,88,38,25,151,2022
2022_A13144,81,25,59,165,2022
2019_B13145,51,84,61,196,2019
2021_A13146,77,74,97,248,2019
2019_C13147,77,14,25,116,2021
2021_C13148,12,52,30,94,2019
2021_B13149,34,25,91,150,2021
2022_A13150,6,46,76,128,2022
2019_B13151,10,43,73,126,2021
2019_C13152,5,78,44,127,2021
2021_C13153,40,62,25,127,2021
2019_B13154,68,85,46,199,2021
2019_A13155,46,26,67,139,2022
2022_C13156,33,73,86,192,2022
2021_A13157,87,96,60,243,2019
2019_B13158,13,82,50,145,2021
2021_B13159,34,82,79,195,2022
2021_C13160,28,75,31,134,2021
2019_A13161,65,50,88,203,2021
2019_A13162,73,29,78,180,2019
2021_A13163,91,28,38,157,2019
2019_C13164,0,64,99,163,2019
2022_B13165,82,39,90,211,2019
2022_A13166,84,59,33,176,2021
2022_A13167,60,22,85,167,2021
2021_C13168,75,52,22,149,2019
2022_B13169,32,15,47,94,2022
2021_C13170,68,55,94,217,2022
2019_A13171,17,95,80,192,2021
2022_A13172,2,25,77,104,2022
2019_B13173,16,75,40,131,2019
2022_C13174,78,18,22,118,2021
2019_C13175,50,60,36,146,2021
2019_B13176,19,69,77,165,2022
2022_B13177,93,79,64,236,2019
2022_B13178,100,36,81,217,2019
2022_B13179,8,58,92,158,2021
2019_A13180,56,49,42,147,2019
2021_A13181,39,42,62,143,2019
2019_A13182,90,17,21,128,2021
2022_B13183,65,71,98,234,2021
2022_B13184,57,34,35,126,2019
2022_C13185,27,73,48,148,2021
2019_C13186,20,16,22,58,2019
2022_A13187,21,90,64,175,2021
2021_A13188,11,54,64,129,2019
2022_C13189,7,56,43,106,2019
2019_C13190,58,64,60,182,2021
2021_C13191,88,46,52,186,2022
2022_B13192,56,92,35,183,2022
2022_C13193,41,73,84,198,2021
2022_C13194,3,92,71,166,2019
2021_A13195,33,33,36,102,2019
2021_B13196,64,86,68,218,2022
2019_A13197,19,67,84,170,2022
2022_B13198,78,54,27,159,2019
2021_C13199,61,35,48,144,2021
2021_A13200,79,45,35,159,2021
2019_A13201,82,89,45,216,2021
2022_A13202,48,20,69,137,2022
2021_C13203,43,85,70,198,2021
2022_C13204,8,66,34,108,2022
2022_B13205,46,37,86,169,2019
2022_C13206,37,95,92,224,2019
2021_A13207,58,32,92,182,2019
2021_B13208,59,29,45,133,2022
2019_A13209,48,32,98,178,2022
2021_A13210,58,86,32,176,2021
2022_B13211,89,20,49,158,2022
2019_A13212,9,59,71,139,2021
2021_A13213,55,53,67,175,2022
2022_C13214,65,92,35,192,2021
2019_A13215,65,68,53,186,2021
2021_A13216,16,97,50,163,2021
2022_A13217,84,92,28,204,2019
2019_B13218,83,81,60,224,2022
2022_A13219,72,49,52,173,2022
2021_C13220,71,32,40,143,2022
2019_C13221,38,39,44,121,2021
2022_C13222,63,74,94,231,2021
2021_A13223,80,29,38,147,2021
2021_B13224,65,49,39,153,2021
2021_C13225,0,97,56,153,2019
2019_C13226,63,45,28,136,2022
2021_A13227,2,22,73,97,2022
2022_C13228,75,78,75,228,2021
2019_B13229,4,47,95,146,2019
2019_B13230,24,59,81,164,2019
2022_B13231,41,79,91,211,2021
2019_A13232,62,29,47,138,2019
2022_C13233,46,74,97,217,2022
2022_C13234,32,41,41,114,2021
2022_C13235,41,70,66,177,2021
2022_C13236,43,77,78,198,2021
2021_A13237,64,56,28,148,2022
2022_B13238,100,91,27,218,2021
2022_C13239,93,51,26,170,2019
2019_C13240,22,72,52,146,2021
2019_B13241,4,20,21,45,2022
2022_A13242,6,13,84,103,2019
2021_A13243,57,82,49,188,2019
2022_C13244,58,32,84,174,2022
2019_B13245,45,65,25,135,2021
2022_B13246,13,90,58,161,2022
2022_B13247,5,45,27,77,2022
2019_A13248,78,42,84,204,2021
2021_B13249,82,48,71,201,2022
2021_B13250,87,19,26,132,2019
2019_A13251,50,85,83,218,2022
2021_C13252,60,53,98,211,2019
2022_A13253,72,83,91,246,2019
2019_A13254,17,36,89,142,2022
2022_A13255,85,66,43,194,2019
2021_A13256,84,47,88,219,2019
2022_A13257,47,76,61,184,2022
2019_C13258,77,37,68,182,2019
2022_C13259,29,28,72,129,2021
2022_C13260,22,84,89,195,2022
2022_B13261,82,11,78,171,2019
2019_A13262,31,89,47,167,2021
2022_A13263,46,16,44,106,2022
2021_C13264,91,65,35,191,2022
2021_B13265,7,78,38,123,2021
2021_A13266,71,63,98,232,2022
2019_B13267,95,19,55,169,2021
2021_B13268,71,97,94,262,2021
2021_C13269,3,52,76,131,2022
2021_C13270,85,54,43,182,2021
2022_B13271,70,45,42,157,2022
2022_C13272,49,33,43,125,2021
2019_B13273,54,21,66,141,2019
2019_B13274,22,27,33,82,2019
2019_B13275,71,54,82,207,2022
2022_A13276,64,86,23,173,2022
2022_B13277,32,66,64,162,2019
2021_C13278,92,19,36,147,2021
2019_B13279,13,67,31,111,2022
2019_B13280,96,53,34,183,2022
2021_A13281,5,76,97,178,2019
2021_A13282,42,83,35,160,2022
2022_C13283,73,81,21,175,2021
2022_A13284,20,73,41,134,2021
2021_C13285,40,40,38,118,2019
2022_B13286,100,93,43,236,2022
2019_B13287,89,26,93,208,2019
2019_A13288,36,42,49,127,2021
2022_A13289,40,86,97,223,2021
2021_C13290,70,78,81,229,2022
2022_C13291,48,21,21,90,2019
2021_C13292,7,11,52,70,2022
2021_C13293,62,14,26,102,2019
2019_C13294,31,61,87,179,2019
2019_A13295,3,37,85,125,2021
2022_B13296,2,26,22,50,2021
2022_B13297,16,22,90,128,2021
2019_A13298,52,44,70,166,2022
2019_A13299,11,57,83,151,2021
2019_C13300,21,52,87,160,2021
2019_A13301,55,78,68,201,2022
2022_A13302,45,27,61,133,2021
2019_B13303,39,40,37,116,2021
2021_C13304,34,28,25,87,2022
2019_C13305,54,81,32,167,2019
2021_C13306,84,13,63,160,2022
2022_B13307,89,92,73,254,2019
2019_C13308,4,31,60,95,2022
2019_B13309,60,24,96,180,2021
2021_C13310,93,57,78,228,2021
2022_B13311,81,25,71,177,2022
2019_A13312,63,25,28,116,2021
2021_A13313,16,90,93,199,2021
2022_C13314,42,71,39,152,2021
2021_C13315,22,16,79,117,2021
2021_A13316,45,22,77,144,2022
2021_C13317,94,53,93,240,2019
2019_B13318,89,44,46,179,2021
2019_C13319,96,78,83,257,2022
2022_B13320,89,63,22,174,2021
2021_C13321,2,84,47,133,2022
2022_C13322,29,27,73,129,2021
2021_C13323,53,54,85,192,2022
2021_C13324,55,16,58,129,2021
2021_B13325,14,97,36,147,2019
2021_B13326,14,50,22,86,2021
2021_B13327,18,74,39,131,2022
2021_B13328,32,72,66,170,2022
2019_B13329,22,46,28,96,2022
2022_A13330,52,82,28,162,2021
2022_C13331,38,96,98,232,2019
2019_A13332,82,91,27,200,2019
2021_A13333,73,19,22,114,2019
2022_A13334,99,50,97,246,2019
2019_A13335,76,84,22,182,2022
2019_B13336,82,11,57,150,2021
2019_C13337,95,21,39,155,2019
2022_A13338,76,43,49,168,2019
2022_A13339,78,18,44,140,2022
2021_A13340,79,64,55,198,2019
2019_B13341,72,89,68,229,2022
2022_A13342,69,44,57,170,2022
2019_A13343,74,36,67,177,2022
2021_C13344,46,88,36,170,2021
2019_B13345,59,94,81,234,2021
2022_B13346,57,46,21,124,2019
2021_B13347,19,35,36,90,2019
2019_C13348,56,53,50,159,2019
2022_A13349,60,22,92,174,2021
2021_B13350,3,34,50,87,2021
2019_C13351,71,29,87,187,2021
2021_B13352,12,18,86,116,2019
2019_C13353,56,74,40,170,2019
2019_C13354,56,58,89,203,2021
2019_C13355,58,89,66,213,2019
2019_C13356,29,17,68,114,2019
2019_A13357,4,71,88,163,2019
2021_C13358,48,92,63,203,2019
2021_B13359,87,21,95,203,2022
2019_C13360,42,60,74,176,2022
2019_C13361,98,14,68,180,2019
2021_A13362,32,49,63,144,2021
2022_B13363,28,63,46,137,2019
2022_B13364,95,69,95,259,2022
2022_C13365,17,74,73,164,2021
2022_B13366,30,85,55,170,2021
2021_B13367,32,81,57,170,2022
2022_A13368,69,42,32,143,2019
2022_B13369,99,76,42,217,2022
2019_C13370,100,38,28,166,2021
2021_A13371,3,31,99,133,2019
2019_B13372,64,57,43,164,2019
2019_C13373,65,50,28,143,2019
2021_B13374,88,53,53,194,2019
2019_B13375,49,33,74,156,2021
2019_A13376,5,49,70,124,2022
2022_A13377,85,30,55,170,2019
2022_A13378,91,37,96,224,2019
2019_C13379,63,85,72,220,2019
2022_B13380,93,49,60,202,2022
2021_B13381,39,20,58,117,2019
2019_C13382,66,94,48,208,2021
2021_B13383,99,28,75,202,2022
2021_A13384,94,32,30,156,2022
2019_C13385,41,97,96,234,2019
2022_A13386,69,13,60,142,2021
2019_B13387,55,52,36,143,2019
2019_C13388,0,74,45,119,2022
2022_A13389,75,77,40,192,2019
2021_B13390,53,24,55,132,2019
2021_B13391,66,36,98,200,2021
2019_C13392,75,53,93,221,2022
2019_B13393,69,57,61,187,2021
2022_C13394,80,87,70,237,2019
2019_A13395,12,44,86,142,2022
2022_B13396,85,43,31,159,2021
2021_C13397,8,26,76,110,2021
2022_B13398,43,14,67,124,2019
2019_B13399,10,46,67,123,2022
2019_C13400,78,41,72,191,2021
2019_A13401,50,12,42,104,2019
2019_B13402,27,35,26,88,2021
2022_B13403,20,19,46,85,2021
2022_A13404,79,34,87,200,2021
2022_A13405,3,47,89,139,2021
2022_C13406,15,50,70,135,2019
2022_B13407,1,54,63,118,2021
2019_B13408,2,18,23,43,2019
2022_B13409,25,50,31,106,2021
2022_C13410,53,82,54,189,2022
2019_C13411,80,34,31,145,2019
2021_B13412,62,20,45,127,2021
2019_A13413,71,80,90,241,2022
2022_B13414,10,87,68,165,2021
2019_A13415,0,84,79,163,2022
2022_A13416,6,55,69,130,2022
2019_A13417,65,35,91,191,2019
2021_A13418,47,28,29,104,2021
2019_C13419,29,78,48,155,2022
2021_C13420,13,54,49,116,2019
2021_A13421,73,59,24,156,2019
2019_B13422,34,86,72,192,2019
2019_C13423,68,35,69,172,2022
2019_A13424,28,14,90,132,2022
2019_A13425,16,34,52,102,2022
2019_A13426,13,41,80,134,2019
2021_B13427,52,37,88,177,2019
2022_B13428,56,95,72,223,2021
2022_A13429,4,60,82,146,2021
2021_B13430,30,30,66,126,2019
2021_C13431,43,21,86,150,2021
2019_C13432,12,67,27,106,2019
2019_B13433,34,27,98,159,2022
2021_A13434,60,24,55,139,2022
2021_B13435,45,15,31,91,2021
2021_A13436,38,80,87,205,2022
2019_B13437,99,69,90,258,2021
2022_C13438,99,74,23,196,2019
2019_C13439,39,77,31,147,2021
2022_B13440,3,82,22,107,2021
2019_A13441,78,76,62,216,2022
2022_C13442,57,46,59,162,2021
2021_C13443,35,78,39,152,2021
2022_C13444,67,82,89,238,2019
2022_A13445,22,54,72,148,2021
2022_C13446,3,45,64,112,2021
2019_C13447,1,31,82,114,2022
2022_C13448,14,27,44,85,2022
2019_C13449,98,39,79,216,2022
2019_C13450,61,63,24,148,2022
2022_A13451,56,38,98,192,2021
2022_A13452,46,25,62,133,2019
2021_B13453,91,67,31,189,2022
2019_C13454,84,33,57,174,2019
2021_B13455,69,49,67,185,2022
2022_A13456,2,46,67,115,2022
2021_C13457,23,50,90,163,2021
2019_B13458,96,54,71,221,2021
2019_C13459,34,12,50,96,2021
2019_C13460,43,84,83,210,2019
2021_B13461,6,84,54,144,2019
2021_B13462,55,63,35,153,2021
2019_C13463,38,28,28,94,2022
2022_C13464,38,50,22,110,2021
2019_B13465,44,24,98,166,2021
2021_C13466,76,30,26,132,2019
2019_B13467,5,81,91,177,2019
2021_C13468,89,74,78,241,2022
2022_A13469,51,50,66,167,2022
2021_A13470,84,67,45,196,2019
2019_C13471,76,29,32,137,2021
2021_B13472,4,96,42,142,2021
2022_A13473,70,91,28,189,2022
2021_B13474,16,36,97,149,2022
2022_B13475,83,68,80,231,2019
2019_A13476,37,13,88,138,2019
2022_A13477,61,24,54,139,2022
2019_C13478,83,47,57,187,2021
2019_B13479,45,25,62,132,2022
2019_A13480,64,79,76,219,2022
2019_B13481,81,80,26,187,2019
2019_B13482,75,35,91,201,2019
2022_B13483,10,22,35,67,2021
2022_C13484,22,90,66,178,2021
2021_C13485,38,75,70,183,2021
2022_C13486,8,82,37,127,2022
2019_A13487,35,22,33,90,2021
2019_C13488,55,45,30,130,2021
2022_B13489,78,74,38,190,2022
2022_C13490,82,15,81,178,2021
2019_A13491,32,35,24,91,2019
2019_C13492,23,48,30,101,2022
2021_A13493,5,24,23,52,2022
2019_C13494,94,85,39,218,2021
2019_C13495,9,26,75,110,2021
2019_B13496,7,50,43,100,2022
2022_C13497,66,86,74,226,2019
2021_B13498,83,86,32,201,2021
2021_C13499,37,53,64,154,2022
2019_C13500,87,27,72,186,2019
2022_C13501,14,63,70,147,2021
2019_A13502,7,28,45,80,2022
2019_A13503,84,69,21,174,2021
2019_C13504,93,81,57,231,2019
2019_A13505,7,81,45,133,2022
2019_C13506,28,39,45,112,2019
2022_C13507,84,49,39,172,2019
2022_B13508,80,63,44,187,2022
2022_A13509,28,51,92,171,2021
2021_B13510,36,96,35,167,2022
2019_C13511,75,23,68,166,2019
2022_C13512,50,24,54,128,2022
2021_C13513,36,67,68,171,2019
2022_B13514,53,40,76,169,2019
2021_A13515,1,55,63,119,2019
2019_B13516,25,88,82,195,2021
2022_C13517,43,44,46,133,2022
2022_B13518,0,80,82,162,2019
2021_B13519,35,81,84,200,2019
2021_A13520,31,47,87,165,2022
2019_C13521,86,81,22,189,2022
2021_B13522,11,65,75,151,2019
2019_A13523,42,31,70,143,2022
2021_B13524,16,85,45,146,2019
2022_A13525,61,40,63,164,2022
2021_B13526,7,41,74,122,2019
2019_C13527,26,39,62,127,2021
2021_A13528,62,72,63,197,2019
2022_C13529,85,80,45,210,2022
2022_C13530,89,92,25,206,2022
2022_A13531,47,79,78,204,2021
2019_A13532,99,57,43,199,2021
2021_B13533,48,37,26,111,2022
2021_B13534,36,33,60,129,2022
2019_A13535,59,78,95,232,2022
2022_B13536,23,21,74,118,2019
2022_B13537,26,49,65,140,2021
2022_C13538,76,82,62,220,2022
2019_A13539,75,34,71,180,2022
2022_A13540,86,57,47,190,2019
2019_C13541,26,12,35,73,2022
2019_A13542,56,64,67,187,2022
2021_A13543,68,76,70,214,2019
2019_A13544,48,37,81,166,2022
2021_C13545,55,14,40,109,2022
2022_B13546,6,62,61,129,2022
2021_C13547,70,33,90,193,2019
2022_B13548,87,65,27,179,2022
2021_C13549,89,49,62,200,2022
2021_B13550,37,27,53,117,2022
2022_A13551,85,95,40,220,2019
2022_C13552,50,72,62,184,2019
2021_A13553,59,91,80,230,2019
2019_B13554,61,11,65,137,2021
2022_C13555,43,45,36,124,2022
2022_A13556,34,11,79,124,2022
2022_C13557,58,19,21,98,2021
2022_C13558,4,31,83,118,2022
2021_B13559,8,39,68,115,2019
2019_B13560,28,42,63,133,2021
2021_A13561,27,54,95,176,2022
2022_A13562,37,41,73,151,2022
2022_C13563,35,46,98,179,2019
2022_C13564,7,38,71,116,2019
2022_B13565,95,24,71,190,2019
2022_A13566,0,96,94,190,2019
2019_B13567,33,73,57,163,2021
2022_B13568,2,58,63,123,2021
2021_A13569,73,76,69,218,2022
2019_A13570,57,25,71,153,2021
2021_C13571,73,36,53,162,2022
2021_A13572,2,82,95,179,2019
2022_C13573,72,56,61,189,2021
2022_B13574,38,74,23,135,2019
2022_A13575,54,55,49,158,2019
2022_A13576,67,51,27,145,2021
2019_C13577,31,13,78,122,2021
2021_A13578,97,96,40,233,2019
2022_C13579,55,29,69,153,2019
2019_A13580,61,47,94,202,2022
2019_A13581,62,61,53,176,2019
2022_C13582,27,69,81,177,2019
2022_C13583,70,53,32,155,2021
2022_C13584,82,56,91,229,2019
2022_B13585,77,43,48,168,2021
2022_A13586,74,70,23,167,2021
2021_C13587,10,78,55,143,2021
2019_A13588,66,28,82,176,2019
2021_C13589,81,15,26,122,2021
2021_A13590,19,12,84,115,2019
2021_C13591,60,85,71,216,2021
2022_C13592,12,57,27,96,2021
2021_A13593,27,34,22,83,2022
2021_C13594,84,58,74,216,2019
2022_A13595,0,38,51,89,2022
2021_B13596,93,59,53,205,2021
2022_A13597,68,21,55,144,2019
2019_A13598,55,18,29,102,2021
2019_C13599,86,37,49,172,2019
2022_C13600,28,34,87,149,2022
2022_B13601,26,27,59,112,2019
2022_B13602,41,15,67,123,2021
2021_C13603,34,31,38,103,2022
2022_C13604,37,26,61,124,2019
2022_B13605,83,57,96,236,2019
2022_B13606,82,39,34,155,2022
2019_B13607,37,73,72,182,2022
2021_C13608,25,96,22,143,2021
2021_A13609,91,56,58,205,2021
2021_B13610,2,93,83,178,2021
2021_A13611,88,81,65,234,2019
2021_C13612,61,43,97,201,2022
2021_A13613,92,73,60,225,2022
2022_B13614,89,44,89,222,2021
2021_C13615,82,22,27,131,2021
2022_C13616,6,84,41,131,2022
2021_B13617,52,33,32,117,2019
2019_B13618,10,33,98,141,2019
2019_B13619,100,80,77,257,2022
2019_C13620,80,45,88,213,2021
2019_B13621,79,58,85,222,2021
2019_C13622,68,81,74,223,2021
2021_C13623,25,16,23,64,2021
2019_C13624,65,65,22,152,2021
2019_C13625,41,70,84,195,2019
2021_A13626,46,30,44,120,2019
2019_A13627,20,53,96,169,2019
2021_C13628,82,90,63,235,2022
2021_A13629,8,59,49,116,2021
2019_B13630,15,86,42,143,2019
2021_C13631,34,59,52,145,2022
2022_C13632,47,45,55,147,2021
2022_A13633,94,65,97,256,2021
2022_C13634,5,52,97,154,2021
2022_B13635,44,96,61,201,2022
2021_C13636,61,42,85,188,2019
2019_A13637,66,58,75,199,2022
2021_B13638,47,38,70,155,2022
2021_A13639,57,40,83,180,2021
2022_B13640,74,19,63,156,2022
2021_C13641,26,95,54,175,2022
2021_C13642,67,20,73,160,2021
2022_C13643,1,22,53,76,2022
2021_A13644,56,62,87,205,2019
2022_B13645,20,80,59,159,2021
2021_C13646,37,55,50,142,2019
2019_C13647,88,37,97,222,2021
2022_C13648,82,17,57,156,2022
2022_A13649,32,30,30,92,2021
2021_B13650,85,75,80,240,2022
2022_C13651,7,77,37,121,2021
2022_C13652,49,43,42,134,2021
2019_B13653,28,20,42,90,2021
2022_B13654,61,54,57,172,2022
2022_C13655,25,28,65,118,2021
2019_C13656,66,68,75,209,2019
2022_C13657,88,32,90,210,2019
2021_C13658,13,82,58,153,2019
2021_B13659,87,62,77,226,2021
2021_A13660,46,75,64,185,2019
2021_C13661,20,75,33,128,2019
2022_A13662,29,76,49,154,2022
2022_C13663,67,88,93,248,2021
2019_B13664,64,93,50,207,2021
2019_B13665,43,97,49,189,2021
2021_A13666,99,66,35,200,2022
2022_B13667,64,79,50,193,2021
2019_A13668,34,96,56,186,2019
2022_C13669,68,59,69,196,2019
2019_A13670,5,30,26,61,2021
2019_B13671,60,36,25,121,2019
2021_A13672,16,89,71,176,2019
2019_B13673,10,84,80,174,2021
2021_B13674,48,19,97,164,2021
2019_C13675,91,46,59,196,2022
2021_B13676,47,83,70,200,2021
2019_B13677,32,18,35,85,2019
2021_C13678,74,33,61,168,2021
2022_C13679,92,41,93,226,2021
2021_B13680,86,94,48,228,2021
2021_B13681,51,68,37,156,2021
2019_B13682,64,34,62,160,2021
2022_B13683,12,17,45,74,2022
2021_A13684,77,16,91,184,2021
2019_B13685,0,62,59,121,2022
2022_A13686,56,31,33,120,2021
2019_A13687,23,22,56,101,2019
2019_B13688,3,39,77,119,2022
2022_A13689,3,72,51,126,2021
2021_B13690,63,13,51,127,2021
2019_B13691,1,57,91,149,2021
2019_A13692,87,27,40,154,2019
2019_A13693,63,67,75,205,2019
2021_B13694,62,34,69,165,2021
2019_A13695,61,54,44,159,2021
2022_C13696,30,29,47,106,2021
2022_C13697,4,89,51,144,2021
2021_B13698,38,47,96,181,2022
2022_C13699,99,31,95,225,2021
2019_C13700,87,45,45,177,2021
2021_B13701,87,69,86,242,2022
2022_A13702,49,15,45,109,2022
2019_A13703,30,34,95,159,2021
2021_A13704,44,66,31,141,2019
2021_B13705,78,14,84,176,2022
2021_A13706,51,82,39,172,2019
2019_B13707,76,84,88,248,2022
2022_A13708,67,12,92,171,2019
2019_A13709,27,76,80,183,2019
2019_A13710,22,55,96,173,2022
2022_B13711,90,21,35,146,2022
2022_B13712,59,81,86,226,2022
2021_B13713,5,72,45,122,2021
2021_A13714,30,52,95,177,2021
2019_C13715,56,56,99,211,2022
2021_A13716,77,47,54,178,2022
2021_C13717,6,50,25,81,2019
2022_B13718,13,70,47,130,2019
2022_B13719,46,75,70,191,2019
2021_B13720,17,17,55,89,2021
2022_A13721,17,20,63,100,2021
2019_C13722,75,70,84,229,2022
2022_B13723,86,30,35,151,2019
2022_B13724,13,88,95,196,2021
2021_A13725,88,20,86,194,2021
2022_B13726,55,78,25,158,2021
2022_C13727,10,53,72,135,2019
2019_B13728,85,35,39,159,2022
2021_C13729,31,39,92,162,2021
2022_B13730,7,56,76,139,2021
2022_B13731,98,41,66,205,2021
2019_C13732,77,92,48,217,2019
2021_C13733,92,33,32,157,2022
2021_B13734,79,66,89,234,2022
2021_C13735,42,48,33,123,2021
2022_B13736,31,93,57,181,2021
2021_B13737,28,56,30,114,2021
2022_A13738,21,31,32,84,2019
2022_A13739,18,93,39,150,2021
2019_B13740,100,46,70,216,2019
2021_C13741,89,91,96,276,2022
2019_B13742,56,69,97,222,2021
2022_C13743,8,95,78,181,2019
2021_A13744,0,95,45,140,2022
2022_A13745,10,63,44,117,2021
2019_C13746,96,25,33,154,2022
2019_A13747,39,21,81,141,2019
2019_B13748,80,32,73,185,2021
2022_A13749,60,81,88,229,2021
2022_B13750,77,66,33,176,2021
2019_C13751,61,49,83,193,2019
2022_C13752,30,53,94,177,2021
2022_C13753,31,66,35,132,2021
2022_B13754,83,25,33,141,2019
2022_A13755,59,71,60,190,2019
2021_A13756,49,27,86,162,2019
2022_B13757,52,31,26,109,2019
2022_C13758,32,18,31,81,2022
2019_C13759,36,70,39,145,2019
2019_B13760,1,54,88,143,2019
2019_C13761,67,60,24,151,2021
2019_C13762,93,18,39,150,2019
2022_A13763,37,94,82,213,2022
2019_A13764,95,57,95,247,2021
2021_B13765,63,39,30,132,2021
2019_A13766,5,65,30,100,2022
2019_C13767,93,42,39,174,2022
2019_B13768,43,51,53,147,2019
2022_A13769,92,47,58,197,2019
2019_C13770,85,89,56,230,2019
2021_C13771,74,45,83,202,2019
2022_B13772,33,83,58,174,2021
2021_C13773,64,40,93,197,2021
2021_A13774,27,22,41,90,2019
2019_C13775,27,36,91,154,2019
2022_B13776,97,50,73,220,2022
2022_B13777,54,74,30,158,2019
2021_C13778,34,65,33,132,2019
2022_C13779,65,62,43,170,2022
2021_B13780,21,31,79,131,2019
2019_B13781,19,41,94,154,2019
2019_C13782,43,81,37,161,2019
2022_B13783,27,74,66,167,2021
2022_C13784,79,79,22,180,2019
2019_C13785,1,15,67,83,2019
2019_C13786,15,65,45,125,2021
2019_B13787,73,24,76,173,2021
2021_B13788,9,24,41,74,2019
2019_A13789,62,22,27,111,2021
2021_B13790,24,66,39,129,2022
2022_C13791,44,20,98,162,2022
2021_C13792,91,76,67,234,2021
2019_C13793,46,57,86,189,2022
2021_C13794,95,25,78,198,2019
2019_C13795,70,90,69,229,2021
2021_A13796,49,25,92,166,2021
2021_B13797,50,83,75,208,2022
2022_C13798,69,88,40,197,2019
2022_B13799,83,52,46,181,2021
2022_C13800,24,63,84,171,2022
2019_C13801,89,54,68,211,2022
2021_A13802,16,57,62,135,2019
2021_A13803,31,89,50,170,2019
2021_C13804,58,64,72,194,2021
2022_B13805,54,24,94,172,2019
2021_A13806,68,86,41,195,2021
2019_C13807,31,73,95,199,2019
2022_A13808,29,63,37,129,2022
2019_C13809,7,92,39,138,2022
2019_B13810,71,92,84,247,2022
2019_A13811,92,83,58,233,2019
2019_C13812,2,30,53,85,2022
2022_B13813,29,17,73,119,2022
2019_B13814,48,64,29,141,2019
2019_A13815,46,20,40,106,2019
2022_B13816,19,44,92,155,2021
2021_C13817,50,31,45,126,2022
2019_B13818,84,83,78,245,2022
2019_A13819,29,15,83,127,2021
2021_C13820,20,49,55,124,2022
2022_B13821,49,12,30,91,2019
2022_C13822,53,51,34,138,2019
2022_B13823,55,81,68,204,2019
2022_C13824,59,18,41,118,2021
2022_C13825,27,52,98,177,2019
2021_C13826,54,68,62,184,2022
2021_A13827,58,73,53,184,2022
2019_A13828,76,25,53,154,2021
2022_A13829,17,33,59,109,2021
2022_A13830,99,63,30,192,2021
2021_B13831,51,75,35,161,2022
2022_C13832,78,82,99,259,2021
2019_A13833,85,66,96,247,2021
2022_A13834,66,26,74,166,2021
2019_A13835,3,45,90,138,2022
2021_A13836,63,62,78,203,2022
2021_A13837,4,62,97,163,2019
2019_A13838,1,68,40,109,2021
2019_C13839,17,15,31,63,2022
2021_B13840,49,52,68,169,2022
2022_B13841,91,33,51,175,2022
2022_B13842,39,26,22,87,2019
2019_C13843,34,44,32,110,2022
2022_A13844,99,11,88,198,2019
2019_A13845,19,18,45,82,2022
2019_B13846,9,42,99,150,2022
2019_C13847,98,53,78,229,2021
2022_A13848,34,50,24,108,2021
2022_C13849,66,34,78,178,2022
2022_A13850,4,30,24,58,2019
2019_A13851,93,33,41,167,2021
2022_C13852,82,87,40,209,2022
2021_C13853,2,34,61,97,2019
2019_B13854,61,95,27,183,2019
2022_A13855,46,44,76,166,2022
2019_C13856,41,59,85,185,2021
2019_A13857,65,17,58,140,2021
2019_A13858,68,31,49,148,2022
2019_A13859,9,95,51,155,2021
2022_A13860,30,34,78,142,2022
2019_B13861,1,29,58,88,2019
2022_B13862,98,87,68,253,2021
2021_A13863,31,32,54,117,2021
2021_A13864,7,53,71,131,2021
2019_B13865,88,45,24,157,2019
2022_B13866,36,88,44,168,2022
2019_C13867,11,35,51,97,2021
2022_B13868,99,16,64,179,2019
2022_A13869,97,46,79,222,2021
2019_B13870,22,60,41,123,2019
2019_B13871,99,72,88,259,2022
2022_A13872,75,78,53,206,2019
2021_A13873,43,88,32,163,2022
2021_B13874,44,13,43,100,2022
2019_B13875,93,40,26,159,2021
2021_B13876,92,65,53,210,2019
2021_B13877,17,32,91,140,2022
2019_B13878,64,64,64,192,2019
2019_B13879,69,92,35,196,2019
2021_C13880,21,72,32,125,2019
2022_A13881,80,89,88,257,2021
2021_A13882,73,67,76,216,2022
2021_C13883,80,31,97,208,2019
2019_B13884,32,28,37,97,2021
2022_A13885,59,53,81,193,2022
2021_A13886,77,33,33,143,2021
2019_A13887,6,61,91,158,2019
2019_A13888,46,79,51,176,2022
2019_B13889,76,81,41,198,2019
2021_C13890,9,51,32,92,2021
2019_C13891,57,14,96,167,2021
2022_B13892,45,66,45,156,2019
2022_A13893,80,33,35,148,2019
2019_C13894,19,57,38,114,2022
2022_C13895,62,14,45,121,2021
2021_B13896,82,53,28,163,2022
2022_C13897,51,61,59,171,2019
2021_A13898,49,45,56,150,2019
2019_B13899,19,79,95,193,2019
2019_A13900,84,33,58,175,2021
2022_C13901,27,34,45,106,2021
2019_A13902,85,72,83,240,2021
2019_C13903,57,73,70,200,2021
2021_A13904,58,37,61,156,2019
2021_B13905,27,13,83,123,2019
2019_C13906,32,95,49,176,2019
2019_A13907,58,37,60,155,2019
2022_A13908,84,39,60,183,2021
2021_A13909,72,94,76,242,2021
2021_B13910,26,39,39,104,2022
2021_B13911,7,12,38,57,2021
2021_B13912,100,61,63,224,2022
2019_C13913,1,36,87,124,2022
2021_A13914,74,63,89,226,2021
2021_A13915,0,57,83,140,2019
2021_B13916,72,67,90,229,2019
2021_A13917,27,29,83,139,2022
2019_A13918,23,57,96,176,2019
2021_A13919,67,17,98,182,2021
2019_C13920,24,70,75,169,2022
2022_B13921,28,46,70,144,2021
2019_B13922,56,45,83,184,2019
2022_A13923,25,91,34,150,2022
2021_B13924,68,57,30,155,2022
2022_B13925,81,73,68,222,2019
2021_C13926,76,68,48,192,2019
2022_B13927,53,17,83,153,2022
2019_A13928,42,35,65,142,2021
2022_A13929,76,85,90,251,2019
2022_B13930,100,31,98,229,2021
2021_C13931,77,20,86,183,2021
2019_C13932,41,50,76,167,2019
2022_A13933,89,32,37,158,2019
2019_B13934,59,86,82,227,2019
2021_B13935,53,39,55,147,2019
2022_B13936,54,59,33,146,2021
2019_C13937,53,65,92,210,2019
2019_C13938,6,94,52,152,2022
2021_A13939,45,86,29,160,2022
2021_B13940,86,55,68,209,2019
2019_A13941,45,15,78,138,2021
2022_A13942,19,59,66,144,2022
2019_A13943,70,69,86,225,2019
2021_B13944,84,63,73,220,2021
2021_C13945,95,14,60,169,2022
2022_A13946,82,17,87,186,2022
2022_A13947,59,89,40,188,2022
2022_A13948,44,63,52,159,2022
2021_A13949,39,51,74,164,2019
2019_C13950,10,27,72,109,2021
2019_C13951,26,85,66,177,2019
2021_A13952,34,64,73,171,2021
2021_B13953,78,94,71,243,2022
2019_C13954,96,44,49,189,2022
2022_B13955,34,19,95,148,2019
2021_C13956,85,28,97,210,2022
2019_C13957,72,25,86,183,2019
2019_C13958,11,49,72,132,2021
2019_A13959,75,95,34,204,2019
2021_B13960,58,34,79,171,2022
2022_A13961,6,97,95,198,2019
2021_B13962,71,47,99,217,2021
2019_B13963,65,68,67,200,2021
2022_B13964,49,18,80,147,2021
2019_A13965,73,79,63,215,2021
2022_C13966,26,48,61,135,2021
2022_B13967,42,21,92,155,2022
2022_A13968,3,80,93,176,2022
2021_B13969,57,20,25,102,2021
2019_C13970,0,94,65,159,2022
2019_A13971,73,56,23,152,2022
2021_A13972,10,38,49,97,2019
2022_C13973,18,85,50,153,2019
2021_C13974,22,92,36,150,2022
2022_A13975,16,83,73,172,2019
2019_C13976,80,90,39,209,2022
2019_B13977,91,42,86,219,2021
2022_A13978,7,41,69,117,2022
2021_A13979,77,39,97,213,2019
2021_B13980,81,76,44,201,2021
2019_B13981,33,19,53,105,2019
2022_B13982,45,42,59,146,2022
2021_C13983,82,23,91,196,2021
2021_B13984,85,95,76,256,2019
2019_C13985,73,79,60,212,2019
2019_A13986,3,16,69,88,2019
2019_A13987,86,41,39,166,2022
2022_A13988,81,93,90,264,2022
2019_A13989,42,41,73,156,2021
2019_A13990,63,11,31,105,2022
2019_C13991,19,92,76,187,2021
2021_B13992,43,31,77,151,2022
2019_A13993,86,51,49,186,2022
2021_A13994,87,53,91,231,2022
2021_C13995,78,18,69,165,2019
2021_A13996,78,74,58,210,2021
2019_C13997,74,77,85,236,2019
2019_B13998,44,28,33,105,2019
2019_A13999,54,12,94,160,2019
2022_B14000,14,54,46,114,2021
2019_C14001,92,21,90,203,2021
2022_A14002,92,84,56,232,2021
2019_B14003,35,55,88,178,2022
2019_A14004,53,55,66,174,2019
2022_B14005,38,20,60,118,2022
2022_B14006,66,70,72,208,2019
2021_B14007,72,81,31,184,2021
2019_A14008,87,36,63,186,2021
2021_A14009,35,41,53,129,2022
2019_C14010,73,63,70,206,2021
2022_C14011,32,85,77,194,2022
2022_A14012,77,94,44,215,2021
2021_A14013,68,97,54,219,2019
2022_B14014,49,49,87,185,2019
2022_B14015,60,31,40,131,2021
2022_B14016,27,45,94,166,2019
2022_B14017,62,97,49,208,2021
2022_C14018,18,45,53,116,2019
2022_C14019,19,63,82,164,2022
2019_B14020,48,28,47,123,2021
2019_B14021,66,63,68,197,2021
2019_C14022,19,80,45,144,2021
2022_B14023,1,91,40,132,2021
2022_A14024,63,65,53,181,2022
2019_B14025,11,97,25,133,2021
2021_C14026,52,72,83,207,2022
2022_C14027,48,41,57,146,2022
2021_B14028,57,62,23,142,2019
2021_A14029,65,61,33,159,2021
2022_A14030,40,85,24,149,2021
2022_A14031,77,73,23,173,2019
2022_A14032,32,22,58,112,2021
2022_C14033,56,72,79,207,2021
2019_C14034,33,71,38,142,2021
2019_A14035,14,58,72,144,2019
2021_A14036,59,74,73,206,2019
2021_B14037,72,49,26,147,2022
2021_B14038,59,15,86,160,2019
2019_C14039,19,26,21,66,2021
2022_A14040,79,76,72,227,2021
2022_B14041,63,82,91,236,2019
2019_B14042,75,86,25,186,2019
2022_A14043,94,86,24,204,2022
2021_B14044,89,19,57,165,2022
2019_A14045,86,19,82,187,2021
2021_B14046,60,46,33,139,2021
2021_A14047,41,80,89,210,2019
2022_C14048,70,54,52,176,2022
2021_A14049,43,14,28,85,2022
2019_C14050,91,49,70,210,2021
2021_C14051,91,82,23,196,2022
2019_B14052,0,35,27,62,2021
2019_C14053,54,65,72,191,2022
2021_A14054,34,65,45,144,2022
2021_B14055,46,63,92,201,2021
2021_B14056,17,32,42,91,2019
2021_A14057,75,14,22,111,2021
2022_B14058,42,53,48,143,2019
2022_C14059,9,87,65,161,2022
2022_A14060,95,63,95,253,2021
2019_B14061,73,64,53,190,2022
2021_A14062,60,86,32,178,2021
2022_C14063,5,51,81,137,2022
2022_C14064,60,29,77,166,2019
2021_B14065,93,79,45,217,2019
2022_B14066,5,79,41,125,2022
2019_B14067,82,17,33,132,2021
2022_A14068,95,61,81,237,2022
2022_B14069,58,57,88,203,2021
2022_C14070,26,40,61,127,2022
2021_B14071,6,65,36,107,2022
2021_C14072,84,33,74,191,2019
2022_C14073,92,38,85,215,2021
2019_A14074,50,84,98,232,2022
2019_A14075,91,34,78,203,2021
2019_C14076,46,85,44,175,2019
2019_C14077,48,18,42,108,2019
2019_C14078,15,22,49,86,2019
2019_C14079,71,89,95,255,2019
2021_B14080,90,79,45,214,2021
2019_B14081,78,39,92,209,2021
2019_A14082,40,49,89,178,2021
2021_A14083,1,31,27,59,2019
2019_A14084,90,56,92,238,2019
2022_B14085,47,25,75,147,2019
2021_B14086,71,49,22,142,2022
2022_C14087,33,40,24,97,2022
2022_C14088,77,91,46,214,2019
2021_C14089,60,26,71,157,2019
2022_B14090,98,68,78,244,2021
2019_A14091,66,64,93,223,2021
2022_A14092,86,37,47,170,2019
2021_B14093,59,96,76,231,2019
2022_A14094,2,22,72,96,2022
2022_A14095,86,50,37,173,2021
2022_C14096,48,57,69,174,2022
2021_B14097,11,53,92,156,2022
2019_A14098,72,50,64,186,2022
2022_C14099,20,60,73,153,2019
2022_B14100,87,78,45,210,2021
2019_B14101,37,16,45,98,2022
2019_B14102,70,86,84,240,2021
2022_A14103,35,92,60,187,2019
2022_C14104,50,33,62,145,2019
2019_C14105,29,58,26,113,2022
2019_B14106,75,13,27,115,2022
2022_C14107,36,62,73,171,2019
2022_B14108,15,40,37,92,2022
2021_B14109,83,12,26,121,2022
2022_C14110,72,19,60,151,2021
2021_B14111,68,79,51,198,2021
2019_A14112,33,60,60,153,2021
2022_B14113,15,44,61,120,2022
2019_C14114,0,84,73,157,2021
2022_B14115,82,72,42,196,2022
2021_B14116,57,49,26,132,2022
2022_B14117,59,18,33,110,2019
2021_A14118,100,66,22,188,2019
2019_C14119,36,72,89,197,2019
2022_C14120,81,90,24,195,2021
2021_B14121,4,23,38,65,2021
2022_C14122,60,27,54,141,2022
2022_B14123,48,44,97,189,2021
2022_C14124,58,11,30,99,2021
2019_C14125,68,27,98,193,2022
2019_A14126,24,75,57,156,2021
2019_B14127,14,67,27,108,2021
2021_A14128,74,63,97,234,2022
2021_B14129,0,34,67,101,2022
2022_A14130,95,34,51,180,2019
2021_C14131,16,96,34,146,2021
2022_B14132,81,43,55,179,2019
2022_B14133,28,27,56,111,2021
2021_B14134,88,74,60,222,2019
2022_A14135,98,84,70,252,2022
2022_C14136,20,75,31,126,2019
2022_B14137,57,52,53,162,2019
2021_B14138,21,49,48,118,2022
2022_A14139,40,13,29,82,2021
2022_A14140,26,53,74,153,2019
2019_C14141,37,97,79,213,2021
2022_B14142,89,76,32,197,2019
2019_C14143,86,39,87,212,2022
2021_C14144,76,51,79,206,2019
2022_C14145,7,38,53,98,2021
2022_A14146,23,22,92,137,2019
2022_C14147,9,49,41,99,2021
2021_B14148,76,89,27,192,2022
2022_A14149,26,90,78,194,2022
2019_C14150,83,14,21,118,2022
2019_C14151,73,85,77,235,2021
2021_C14152,88,64,59,211,2019
2019_A14153,87,59,61,207,2021
2019_A14154,99,35,94,228,2022
2019_B14155,84,63,99,246,2019
2021_B14156,74,35,64,173,2021
2019_B14157,39,41,40,120,2021
2022_B14158,59,15,25,99,2019
2019_A14159,27,96,53,176,2019
2019_A14160,94,29,98,221,2022
2022_B14161,71,58,86,215,2019
2019_A14162,62,54,88,204,2019
2021_C14163,96,52,45,193,2021
2019_C14164,3,83,61,147,2022
2019_B14165,19,62,47,128,2022
2022_A14166,25,29,50,104,2021
2019_C14167,87,33,65,185,2021
2019_A14168,2,24,94,120,2019
2022_A14169,52,92,30,174,2021
2022_B14170,42,51,33,126,2022
2021_B14171,27,39,85,151,2022
2022_B14172,47,90,78,215,2021
2019_B14173,63,26,58,147,2019
2022_B14174,68,44,67,179,2019
2019_B14175,0,43,85,128,2019
2019_B14176,72,59,75,206,2019
2022_B14177,57,39,98,194,2019
2021_C14178,1,42,70,113,2022
2022_A14179,28,28,56,112,2021
2021_C14180,65,95,79,239,2019
2021_A14181,61,62,53,176,2021
2019_C14182,21,84,34,139,2021
2019_A14183,4,63,91,158,2021
2019_B14184,75,37,79,191,2022
2019_C14185,0,59,70,129,2021
2022_A14186,53,59,83,195,2021
2019_A14187,40,96,46,182,2022
2019_B14188,92,35,31,158,2022
2021_B14189,54,12,52,118,2022
2019_B14190,57,44,35,136,2019
2021_A14191,47,27,77,151,2019
2021_B14192,39,15,92,146,2021
2021_C14193,75,62,80,217,2019
2021_B14194,64,66,39,169,2019
2019_C14195,1,83,36,120,2022
2022_B14196,93,79,68,240,2022
2019_A14197,34,72,87,193,2019
2021_A14198,39,82,69,190,2022
2019_C14199,62,96,46,204,2022
2022_C14200,68,63,32,163,2022
2019_A14201,62,90,37,189,2019
2019_A14202,40,40,93,173,2021
2022_B14203,27,82,62,171,2019
2021_C14204,52,63,57,172,2022
2022_B14205,64,86,67,217,2022
2021_B14206,82,41,31,154,2019
2022_C14207,20,18,96,134,2022
2022_B14208,80,44,60,184,2021
2022_A14209,59,35,70,164,2021
2019_C14210,56,81,73,210,2022
2019_A14211,82,56,54,192,2021
2022_A14212,15,44,92,151,2022
2022_C14213,60,28,96,184,2021
2022_C14214,27,44,37,108,2022
2021_C14215,92,51,58,201,2019
2022_A14216,33,26,64,123,2022
2021_B14217,92,13,55,160,2019
2021_B14218,89,67,26,182,2022
2019_A14219,1,44,79,124,2022
2019_A14220,65,57,44,166,2021
2022_A14221,75,54,92,221,2019
2019_A14222,16,77,42,135,2021
2022_B14223,30,27,81,138,2022
2021_A14224,43,51,24,118,2019
2021_C14225,72,53,77,202,2022
2019_B14226,45,40,39,124,2019
2021_B14227,35,51,33,119,2022
2019_A14228,17,49,59,125,2022
2021_C14229,2,65,59,126,2021
2022_B14230,30,30,86,146,2019
2019_B14231,40,85,48,173,2022
2019_B14232,100,86,79,265,2022
2019_C14233,93,54,40,187,2019
2021_A14234,54,92,93,239,2022
2019_B14235,100,70,83,253,2022
2019_B14236,52,62,26,140,2019
2021_B14237,72,16,32,120,2021
2021_C14238,44,30,67,141,2019
2021_B14239,82,87,61,230,2022
2019_C14240,72,23,69,164,2022
2021_B14241,39,29,88,156,2022
2022_A14242,82,91,69,242,2019
2021_B14243,49,50,49,148,2021
2021_A14244,46,85,88,219,2021
2021_A14245,58,31,80,169,2019
2019_A14246,14,90,21,125,2019
2021_C14247,59,77,83,219,2022
2021_B14248,81,49,77,207,2022
2021_C14249,44,31,28,103,2019
2019_B14250,53,82,62,197,2019
2021_B14251,5,27,41,73,2022
2022_C14252,54,71,91,216,2021
2019_A14253,32,69,83,184,2019
2022_C14254,83,94,59,236,2021
2022_C14255,74,71,94,239,2022
2021_A14256,84,24,92,200,2019
2019_A14257,56,96,77,229,2019
2021_B14258,24,60,62,146,2019
2019_B14259,15,97,88,200,2021
2022_B14260,5,92,56,153,2022
2021_C14261,97,89,97,283,2022
2021_B14262,85,36,46,167,2019
2019_B14263,93,28,23,144,2021
2021_C14264,30,93,42,165,2019
2022_A14265,2,62,57,121,2019
2022_B14266,7,75,80,162,2021
2019_B14267,60,47,31,138,2019
2019_A14268,22,90,59,171,2022
2021_B14269,69,54,75,198,2019
2021_A14270,3,95,90,188,2021
2019_C14271,17,88,92,197,2021
2021_A14272,81,50,30,161,2022
2022_C14273,86,28,87,201,2019
2019_B14274,55,73,48,176,2022
2022_A14275,27,69,88,184,2019
2021_C14276,17,42,51,110,2021
2022_C14277,52,29,64,145,2019
2022_B14278,50,82,58,190,2019
2021_B14279,33,53,46,132,2021
2019_A14280,63,19,54,136,2021
2021_C14281,44,18,91,153,2021
2022_A14282,2,65,22,89,2022
2019_C14283,99,37,53,189,2021
2019_B14284,48,39,68,155,2019
2021_C14285,26,71,33,130,2022
2019_C14286,17,20,54,91,2022
2021_C14287,81,41,37,159,2019
2021_C14288,51,11,47,109,2019
2022_C14289,82,42,27,151,2021
2019_A14290,29,85,99,213,2021
2021_C14291,14,58,68,140,2021
2021_B14292,49,62,26,137,2022
2021_B14293,23,81,94,198,2022
2019_B14294,60,19,26,105,2019
2022_C14295,26,37,86,149,2019
2022_B14296,3,31,92,126,2019
2021_A14297,15,89,77,181,2019
2019_B14298,46,63,47,156,2021
2019_C14299,85,68,91,244,2022
2021_C14300,60,42,57,159,2021
2022_B14301,21,80,57,158,2021
2019_A14302,43,14,54,111,2022
2019_C14303,9,35,23,67,2022
2021_B14304,81,27,72,180,2022
2019_A14305,79,68,38,185,2021
2022_B14306,94,51,97,242,2019
2022_B14307,32,86,22,140,2022
2019_A14308,63,44,29,136,2021
2021_A14309,96,51,59,206,2019
2022_A14310,54,79,97,230,2021
2022_C14311,61,50,34,145,2021
2021_A14312,88,35,49,172,2021
2022_B14313,34,18,72,124,2022
2022_C14314,63,62,96,221,2019
2021_A14315,14,48,88,150,2021
2019_A14316,75,57,91,223,2022
2022_A14317,67,75,84,226,2019
2019_C14318,54,21,97,172,2022
2022_C14319,89,28,86,203,2021
2021_C14320,97,40,57,194,2019
2022_A14321,96,82,64,242,2022
2021_C14322,9,26,85,120,2021
2019_B14323,76,79,23,178,2021
2022_B14324,4,88,34,126,2019
2022_B14325,1,71,58,130,2021
2019_C14326,29,94,56,179,2022
2022_C14327,28,31,41,100,2019
2019_B14328,28,45,21,94,2022
2019_C14329,43,63,36,142,2019
2022_C14330,34,68,89,191,2021
2021_C14331,65,40,67,172,2019
2022_A14332,21,83,72,176,2022
2019_B14333,46,39,95,180,2019
2022_A14334,1,37,25,63,2021
2021_C14335,19,43,43,105,2019
2019_B14336,6,12,83,101,2019
2019_A14337,67,93,74,234,2021
2021_C14338,44,15,96,155,2022
2019_B14339,7,32,96,135,2021
2021_B14340,0,87,29,116,2021
2021_A14341,24,40,91,155,2022
2019_C14342,41,48,64,153,2019
2022_A14343,53,66,72,191,2021
2022_C14344,28,57,69,154,2022
2022_A14345,11,68,55,134,2022
2021_A14346,40,27,27,94,2019
2021_C14347,99,67,99,265,2019
2019_C14348,27,74,74,175,2019
2022_A14349,99,81,91,271,2019
2019_C14350,99,53,91,243,2021
2022_B14351,83,91,38,212,2022
2022_C14352,49,16,66,131,2022
2022_B14353,99,59,65,223,2019
2021_A14354,88,32,50,170,2022
2021_A14355,44,61,42,147,2022
2021_C14356,89,59,30,178,2022
2021_C14357,100,72,89,261,2022
2022_C14358,26,77,87,190,2019
2021_A14359,31,34,71,136,2022
2022_A14360,90,50,75,215,2022
2022_B14361,18,13,73,104,2021
2021_C14362,2,66,71,139,2022
2022_A14363,90,61,46,197,2019
2019_C14364,34,91,47,172,2022
2019_B14365,94,40,79,213,2019
2019_B14366,55,77,59,191,2022
2019_B14367,70,95,55,220,2019
2022_A14368,26,92,94,212,2022
2019_A14369,15,67,95,177,2022
2021_A14370,11,68,52,131,2021
2022_B14371,46,28,99,173,2022
2022_A14372,94,86,23,203,2019
2022_C14373,80,54,34,168,2022
2019_B14374,33,47,35,115,2019
2022_C14375,4,48,66,118,2022
2022_B14376,6,55,49,110,2019
2021_B14377,97,73,35,205,2021
2022_B14378,87,34,46,167,2022
2019_A14379,59,11,73,143,2021
2019_B14380,97,77,56,230,2022
2022_C14381,57,82,56,195,2022
2022_B14382,94,44,24,162,2022
2022_A14383,66,49,30,145,2019
2019_B14384,96,24,23,143,2019
2022_A14385,50,57,37,144,2021
2019_B14386,40,91,72,203,2019
2019_C14387,41,79,56,176,2022
2019_C14388,74,46,28,148,2021
2019_B14389,82,91,45,218,2022
2019_B14390,42,66,76,184,2021
2022_B14391,54,22,78,154,2021
2019_B14392,88,14,69,171,2021
2019_A14393,3,19,32,54,2019
2019_A14394,79,91,26,196,2021
2019_C14395,34,38,93,165,2021
2021_C14396,29,97,67,193,2022
2021_B14397,36,85,62,183,2021
2022_B14398,42,13,49,104,2021
2019_C14399,85,69,37,191,2019
2022_C14400,54,91,93,238,2022
2021_C14401,26,44,93,163,2019
2022_B14402,10,68,66,144,2019
2022_B14403,82,14,79,175,2019
2021_C14404,12,96,92,200,2022
2022_B14405,40,73,90,203,2021
2021_B14406,46,47,65,158,2021
2019_A14407,81,60,50,191,2021
2019_A14408,26,46,65,137,2019
2021_C14409,78,20,51,149,2021
2021_A14410,99,96,83,278,2022
2021_C14411,8,40,89,137,2022
2021_A14412,100,86,96,282,2021
2019_A14413,56,37,24,117,2019
2022_B14414,89,28,33,150,2021
2022_B14415,52,15,22,89,2021
2021_C14416,57,19,32,108,2019
2021_B14417,27,69,56,152,2022
2022_A14418,96,60,99,255,2021
2022_A14419,18,94,72,184,2022
2019_B14420,46,48,47,141,2019
2019_C14421,99,63,80,242,2021
2019_C14422,83,70,28,181,2022
2022_A14423,7,35,61,103,2019
2021_B14424,61,61,74,196,2022
2021_B14425,53,49,84,186,2021
2019_B14426,80,48,77,205,2021
2022_A14427,84,88,93,265,2021
2022_B14428,37,62,81,180,2019
2022_B14429,96,75,35,206,2019
2021_B14430,94,79,63,236,2022
2019_B14431,13,68,71,152,2019
2021_B14432,32,69,89,190,2021
2019_C14433,65,46,30,141,2021
2022_A14434,27,61,33,121,2022
2022_A14435,7,27,99,133,2019
2019_C14436,16,40,74,130,2022
2022_A14437,39,23,29,91,2021
2021_A14438,71,16,36,123,2022
2021_A14439,63,27,72,162,2021
2022_C14440,54,23,80,157,2022
2022_C14441,92,24,87,203,2022
2019_B14442,77,38,35,150,2021
2019_C14443,70,85,51,206,2021
2021_C14444,20,84,80,184,2022
2021_A14445,29,76,63,168,2022
2019_A14446,84,67,74,225,2019
2021_B14447,63,88,25,176,2019
2021_B14448,33,92,61,186,2022
2019_A14449,70,63,48,181,2022
2021_C14450,85,62,83,230,2021
2019_C14451,85,30,25,140,2019
2019_C14452,84,32,38,154,2021
2022_A14453,82,92,96,270,2019
2021_B14454,21,32,62,115,2021
2021_B14455,49,68,65,182,2019
2019_C14456,0,79,76,155,2022
2022_B14457,32,34,65,131,2022
2019_A14458,70,28,97,195,2021
2021_C14459,85,12,60,157,2021
2019_A14460,42,67,85,194,2021
2021_A14461,29,39,33,101,2019
2021_B14462,10,34,68,112,2022
2021_A14463,77,84,93,254,2021
2021_C14464,14,91,26,131,2022
2021_C14465,3,15,89,107,2021
2021_B14466,33,83,85,201,2021
2022_A14467,96,40,37,173,2021
2022_C14468,91,43,24,158,2019
2021_A14469,77,88,22,187,2019
2019_C14470,56,21,42,119,2019
2019_A14471,14,66,62,142,2022
2022_C14472,3,44,62,109,2021
2019_C14473,57,24,59,140,2021
2021_B14474,3,96,77,176,2019
2019_B14475,89,24,38,151,2019
2019_C14476,36,92,38,166,2019
2022_A14477,34,11,37,82,2019
2022_A14478,1,72,64,137,2022
2021_A14479,34,84,73,191,2021
2019_B14480,9,25,76,110,2021
2021_C14481,69,47,24,140,2019
2019_C14482,39,40,95,174,2022
2022_C14483,46,11,93,150,2021
2019_A14484,50,75,91,216,2019
2021_C14485,6,46,61,113,2021
2021_C14486,34,22,60,116,2019
2019_A14487,33,20,23,76,2019
2022_A14488,31,12,81,124,2022
2019_C14489,69,29,39,137,2022
2021_C14490,79,43,27,149,2019
2022_C14491,59,41,66,166,2019
2022_B14492,28,19,85,132,2021
2022_B14493,51,32,74,157,2019
2021_C14494,75,18,84,177,2021
2022_C14495,73,43,40,156,2022
2019_A14496,63,35,47,145,2021
2019_C14497,17,19,69,105,2022
2022_A14498,28,45,29,102,2019
2021_B14499,48,72,88,208,2022
2021_B14500,37,62,83,182,2021
2019_C14501,50,21,25,96,2019
2021_A14502,79,52,32,163,2022
2022_C14503,87,23,27,137,2021
2021_C14504,93,77,86,256,2019
2022_C14505,89,54,69,212,2021
2022_A14506,7,32,64,103,2019
2021_C14507,99,38,57,194,2019
2022_C14508,91,77,36,204,2022
2022_B14509,41,87,84,212,2019
2021_B14510,33,19,27,79,2021
2021_A14511,12,82,38,132,2019
2022_B14512,82,49,93,224,2021
2019_C14513,26,73,53,152,2022
2022_C14514,31,81,82,194,2019
2022_A14515,0,68,28,96,2019
2022_A14516,14,91,21,126,2019
2021_B14517,99,49,70,218,2021
2021_A14518,100,69,97,266,2019
2022_B14519,93,64,86,243,2019
2019_C14520,5,11,27,43,2021
2021_C14521,73,81,25,179,2021
2022_C14522,83,59,83,225,2019
2022_B14523,100,48,49,197,2021
2021_A14524,37,46,50,133,2019
2021_B14525,70,73,39,182,2022
2019_A14526,78,68,59,205,2019
2021_C14527,91,60,47,198,2022
2019_A14528,30,38,90,158,2022
2021_B14529,87,53,99,239,2022
2019_C14530,50,45,99,194,2019
2022_C14531,20,86,53,159,2022
2019_C14532,3,68,28,99,2021
2021_A14533,90,53,71,214,2022
2022_C14534,18,86,39,143,2019
2019_A14535,31,84,57,172,2022
2021_B14536,18,32,95,145,2022
2022_B14537,40,13,65,118,2019
2021_A14538,48,78,57,183,2021
2022_A14539,24,62,61,147,2019
2021_A14540,53,81,74,208,2022
2021_B14541,99,74,40,213,2022
2021_B14542,45,84,43,172,2021
2022_B14543,80,96,37,213,2022
2021_C14544,26,26,48,100,2021
2019_C14545,20,72,44,136,2021
2019_C14546,43,91,30,164,2021
2021_B14547,91,11,60,162,2022
2022_C14548,80,77,82,239,2021
2022_C14549,23,36,56,115,2019
2021_B14550,51,26,58,135,2021
2022_A14551,75,40,37,152,2022
2022_A14552,96,57,59,212,2021
2022_A14553,66,30,86,182,2022
2019_C14554,78,94,96,268,2019
2021_B14555,10,93,26,129,2019
2022_C14556,6,13,83,102,2021
2019_A14557,86,20,79,185,2022
2021_B14558,33,80,38,151,2022
2022_C14559,16,36,42,94,2021
2019_C14560,12,22,24,58,2022
2021_B14561,33,24,68,125,2022
2019_A14562,3,80,22,105,2019
2021_B14563,64,72,68,204,2021
2019_B14564,53,55,35,143,2022
2022_B14565,11,73,76,160,2019
2022_A14566,15,64,90,169,2021
2019_A14567,20,19,31,70,2019
2021_C14568,94,94,72,260,2022
2019_A14569,59,61,87,207,2019
2022_C14570,75,39,58,172,2021
2019_A14571,21,84,72,177,2022
2019_A14572,60,56,27,143,2019
2021_A14573,64,39,54,157,2022
2022_B14574,75,90,63,228,2019
2019_A14575,39,80,98,217,2021
2022_B14576,41,89,91,221,2019
2019_C14577,7,77,71,155,2021
2019_C14578,11,86,83,180,2022
2021_C14579,68,66,86,220,2022
2022_A14580,47,35,24,106,2021
2019_A14581,96,20,38,154,2019
2022_A14582,63,53,46,162,2022
2022_A14583,80,25,28,133,2021
2021_C14584,43,59,86,188,2022
2019_C14585,22,85,95,202,2021
2019_B14586,63,15,39,117,2019
2022_C14587,79,74,38,191,2021
2021_B14588,44,14,25,83,2021
2022_B14589,66,35,27,128,2019
2021_C14590,100,20,31,151,2022
2022_B14591,52,50,30,132,2021
2022_B14592,16,15,78,109,2021
2021_C14593,89,66,61,216,2021
2019_C14594,95,47,28,170,2021
2019_C14595,46,19,97,162,2022
2021_A14596,45,18,91,154,2021
2019_B14597,99,88,41,228,2021
2021_B14598,83,78,31,192,2021
2019_B14599,72,30,82,184,2021
2019_B14600,82,83,40,205,2022
2022_B14601,92,60,97,249,2021
2021_A14602,71,41,63,175,2021
2019_C14603,97,52,57,206,2019
2021_C14604,60,77,32,169,2019
2019_B14605,9,76,66,151,2022
2022_B14606,47,86,61,194,2021
2021_C14607,85,17,95,197,2022
2022_A14608,31,92,78,201,2021
2021_B14609,68,16,76,160,2019
2019_B14610,37,42,65,144,2021
2021_A14611,71,37,85,193,2022
2022_C14612,20,83,93,196,2019
2019_C14613,76,68,48,192,2022
2019_C14614,82,34,83,199,2022
2022_C14615,98,45,89,232,2022
2021_B14616,21,34,82,137,2022
2019_B14617,99,49,55,203,2021
2022_B14618,0,43,34,77,2019
2019_A14619,88,71,47,206,2021
2019_A14620,69,97,79,245,2019
2022_C14621,60,77,34,171,2021
2022_B14622,24,15,86,125,2019
2022_A14623,45,44,79,168,2021
2022_A14624,53,18,34,105,2019
2022_B14625,27,86,30,143,2022
2021_B14626,95,50,93,238,2022
2022_B14627,78,45,46,169,2019
2021_A14628,60,19,81,160,2021
2021_C14629,43,81,69,193,2019
2021_C14630,8,43,93,144,2022
2019_B14631,3,94,54,151,2021
2021_B14632,72,44,70,186,2021
2021_C14633,54,77,22,153,2019
2019_A14634,99,26,54,179,2019
2022_A14635,12,91,39,142,2021
2021_A14636,82,77,50,209,2019
2021_A14637,100,87,32,219,2019
2021_C14638,21,62,57,140,2019
2022_A14639,54,12,72,138,2021
2021_A14640,86,51,46,183,2022
2022_C14641,72,26,91,189,2021
2022_A14642,66,27,46,139,2022
2021_A14643,21,46,57,124,2021
2022_B14644,81,24,58,163,2019
2021_C14645,54,49,93,196,2021
2019_B14646,56,65,93,214,2019
2021_A14647,78,34,96,208,2022
2022_B14648,44,49,80,173,2021
2019_A14649,26,86,80,192,2019
2021_C14650,94,97,71,262,2021
2022_A14651,52,93,78,223,2019
2019_B14652,88,68,74,230,2021
2021_B14653,34,23,53,110,2021
2019_C14654,13,66,47,126,2019
2019_A14655,98,83,29,210,2021
2022_C14656,92,55,29,176,2019
2019_C14657,15,21,49,85,2022
2022_A14658,96,68,52,216,2021
2019_B14659,83,12,76,171,2021
2019_B14660,99,63,75,237,2019
2022_C14661,61,97,71,229,2019
2021_B14662,43,38,24,105,2022
2019_C14663,79,62,73,214,2022
2019_C14664,12,46,38,96,2022
2021_B14665,86,28,84,198,2022
2022_C14666,73,77,98,248,2022
2021_A14667,32,63,87,182,2019
2021_B14668,51,94,63,208,2021
2021_A14669,14,69,61,144,2022
2021_B14670,17,63,38,118,2021
2021_B14671,69,12,86,167,2022
2021_A14672,16,90,38,144,2021
2022_B14673,35,36,23,94,2021
2019_A14674,89,90,51,230,2021
2019_C14675,84,91,88,263,2022
2019_B14676,67,62,60,189,2021
2022_A14677,15,32,67,114,2021
2022_B14678,6,39,96,141,2019
2021_C14679,65,42,63,170,2022
2019_B14680,10,35,66,111,2021
2019_C14681,79,74,77,230,2021
2019_C14682,88,89,83,260,2021
2021_C14683,76,48,27,151,2019
2021_C14684,16,87,26,129,2019
2022_A14685,75,94,96,265,2021
2021_B14686,75,63,93,231,2019
2021_A14687,57,70,30,157,2021
2019_A14688,94,78,59,231,2022
2022_B14689,91,45,82,218,2022
2021_A14690,52,75,34,161,2019
2022_B14691,11,44,32,87,2019
2019_B14692,50,47,89,186,2022
2021_B14693,85,79,85,249,2022
2019_B14694,50,50,90,190,2022
2022_C14695,90,85,44,219,2021
2021_A14696,29,20,59,108,2019
2022_C14697,2,65,29,96,2019
2021_A14698,85,27,70,182,2022
2022_C14699,78,88,61,227,2021
2021_B14700,28,28,92,148,2022
2019_A14701,98,28,67,193,2022
2022_C14702,21,73,31,125,2019
2019_B14703,72,31,70,173,2022
2022_A14704,18,33,94,145,2019
2019_C14705,84,25,21,130,2019
2022_B14706,80,29,58,167,2021
2021_B14707,52,37,96,185,2019
2021_C14708,20,68,43,131,2022
2019_C14709,5,29,63,97,2019
2021_A14710,62,37,31,130,2021
2022_A14711,37,66,73,176,2019
2019_C14712,82,68,89,239,2021
2019_C14713,17,72,37,126,2022
2022_C14714,4,38,42,84,2019
2021_B14715,17,13,33,63,2021
2022_C14716,70,24,59,153,2019
2019_A14717,61,21,40,122,2021
2022_A14718,75,69,35,179,2022
2019_C14719,48,64,92,204,2022
2022_C14720,81,77,54,212,2021
2021_A14721,58,58,38,154,2019
2022_C14722,45,66,91,202,2019
2022_A14723,67,95,76,238,2021
2022_C14724,90,55,39,184,2019
2021_A14725,91,20,44,155,2021
2022_B14726,25,26,47,98,2022
2022_A14727,81,21,98,200,2019
2021_C14728,66,55,56,177,2019
2021_A14729,98,72,28,198,2019
2022_A14730,72,88,42,202,2021
2019_A14731,51,26,34,111,2019
2021_C14732,90,40,43,173,2021
2021_B14733,33,58,71,162,2021
2022_B14734,54,83,82,219,2021
2022_B14735,45,75,60,180,2021
2021_C14736,53,54,85,192,2019
2022_A14737,15,65,54,134,2022
2022_A14738,11,88,75,174,2021
2019_C14739,63,80,51,194,2022
2022_B14740,29,45,67,141,2021
2019_B14741,79,37,49,165,2019
2019_A14742,0,24,37,61,2019
2021_C14743,65,69,68,202,2021
2019_C14744,73,44,48,165,2019
2019_C14745,66,52,51,169,2022
2022_B14746,75,41,64,180,2022
2022_B14747,60,68,93,221,2021
2022_C14748,81,53,59,193,2021
2022_C14749,38,87,43,168,2019
2022_C14750,53,67,81,201,2021
2022_A14751,53,85,79,217,2022
2022_C14752,67,89,78,234,2022
2019_A14753,40,32,63,135,2019
2022_C14754,65,31,57,153,2019
2019_A14755,42,83,53,178,2022
2022_B14756,74,53,99,226,2021
2021_C14757,88,82,46,216,2019
2022_A14758,2,84,34,120,2022
2019_A14759,87,14,60,161,2022
2021_B14760,75,46,67,188,2019
2019_A14761,11,63,92,166,2021
2022_A14762,70,62,44,176,2019
2019_B14763,55,44,83,182,2021
2021_A14764,8,12,63,83,2019
2022_C14765,58,29,56,143,2019
2019_B14766,54,19,50,123,2021
2021_C14767,73,71,75,219,2019
2019_B14768,85,65,46,196,2021
2022_C14769,68,28,37,133,2022
2019_B14770,8,24,76,108,2021
2021_B14771,53,43,66,162,2019
2021_A14772,28,72,56,156,2021
2019_A14773,85,30,34,149,2022
2021_C14774,83,80,50,213,2022
2022_B14775,37,92,95,224,2019
2022_C14776,16,18,52,86,2019
2019_B14777,87,96,70,253,2021
2019_A14778,92,64,30,186,2019
2021_C14779,26,75,73,174,2019
2022_C14780,24,72,28,124,2022
2022_B14781,21,43,72,136,2022
2021_B14782,23,73,34,130,2022
2022_B14783,22,90,26,138,2022
2022_B14784,41,39,73,153,2019
2022_B14785,64,17,34,115,2019
2019_C14786,63,54,50,167,2021
2022_A14787,32,24,39,95,2021
2019_C14788,85,37,66,188,2022
2021_C14789,88,14,72,174,2019
2022_C14790,6,94,27,127,2022
2019_B14791,83,23,45,151,2021
2019_A14792,95,85,46,226,2021
2022_A14793,96,64,47,207,2021
2019_C14794,67,41,75,183,2022
2022_C14795,72,26,49,147,2022
2019_A14796,86,77,37,200,2021
2021_A14797,84,16,82,182,2022
2022_C14798,7,49,90,146,2021
2021_A14799,4,58,35,97,2021
2022_C14800,53,33,79,165,2022
2019_B14801,91,85,74,250,2021
2022_A14802,54,49,24,127,2022
2019_C14803,70,38,46,154,2019
2019_A14804,14,47,62,123,2022
2022_A14805,67,56,69,192,2019
2021_B14806,32,38,41,111,2019
2019_C14807,1,75,94,170,2019
2021_B14808,99,76,50,225,2022
2021_C14809,11,57,24,92,2019
2021_A14810,21,97,56,174,2022
2022_A14811,59,92,77,228,2021
2019_A14812,30,26,58,114,2021
2021_C14813,69,15,27,111,2022
2021_C14814,28,91,21,140,2019
2019_A14815,3,37,46,86,2019
2022_B14816,15,33,93,141,2019
2021_C14817,64,16,64,144,2022
2019_B14818,95,24,76,195,2021
2019_C14819,58,44,29,131,2021
2022_C14820,77,30,45,152,2022
2022_C14821,36,13,55,104,2022
2022_B14822,99,51,67,217,2022
2021_B14823,76,93,30,199,2022
2021_B14824,62,97,86,245,2021
2021_A14825,44,13,44,101,2019
2021_B14826,69,91,94,254,2022
2021_A14827,76,31,26,133,2021
2022_C14828,86,54,68,208,2019
2019_C14829,72,12,86,170,2022
2019_A14830,75,62,95,232,2022
2021_A14831,32,79,81,192,2021
2021_C14832,30,79,64,173,2021
2021_A14833,76,70,78,224,2021
2022_C14834,87,20,40,147,2021
2021_B14835,70,60,78,208,2019
2019_B14836,17,57,73,147,2022
2019_C14837,13,84,36,133,2019
2022_C14838,45,43,45,133,2019
2022_C14839,98,43,31,172,2022
2019_B14840,100,33,86,219,2022
2019_A14841,2,52,94,148,2021
2019_A14842,63,49,47,159,2019
2019_B14843,78,55,82,215,2021
2022_A14844,11,68,65,144,2019
2022_A14845,13,83,38,134,2021
2019_C14846,80,15,73,168,2022
2022_A14847,90,54,95,239,2019
2019_C14848,19,88,66,173,2022
2022_C14849,77,62,33,172,2019
2022_B14850,87,32,82,201,2019
2022_C14851,82,87,73,242,2019
2022_A14852,53,61,33,147,2021
2019_B14853,13,76,42,131,2019
2022_A14854,2,47,26,75,2022
2022_A14855,62,61,27,150,2021
2021_C14856,31,22,59,112,2022
2019_B14857,3,26,87,116,2019
2021_A14858,76,83,45,204,2022
2019_C14859,78,40,27,145,2022
2022_C14860,54,51,92,197,2022
2019_A14861,81,53,94,228,2021
2022_B14862,6,30,85,121,2022
2021_A14863,25,53,70,148,2022
2021_A14864,5,85,22,112,2019
2021_A14865,42,80,98,220,2022
2022_C14866,40,79,52,171,2021
2022_B14867,62,56,30,148,2022
2021_A14868,57,94,68,219,2019
2022_C14869,29,63,67,159,2019
2021_A14870,89,56,26,171,2019
2021_C14871,99,45,32,176,2022
2022_A14872,23,52,40,115,2019
2022_B14873,83,13,72,168,2019
2021_A14874,46,22,48,116,2019
2019_A14875,95,67,23,185,2019
2019_B14876,2,80,30,112,2019
2022_A14877,53,38,22,113,2022
2022_B14878,99,29,72,200,2021
2021_C14879,9,57,63,129,2022
2021_C14880,15,94,71,180,2019
2019_A14881,88,17,70,175,2022
2022_B14882,54,61,76,191,2022
2022_B14883,72,79,92,243,2019
2022_C14884,89,38,99,226,2019
2021_A14885,69,92,74,235,2019
2019_C14886,26,50,99,175,2022
2019_A14887,79,19,46,144,2021
2021_C14888,80,35,88,203,2022
2019_B14889,40,25,44,109,2021
2021_A14890,5,58,67,130,2022
2019_C14891,84,11,49,144,2022
2021_C14892,51,77,25,153,2019
2019_C14893,8,80,99,187,2019
2021_C14894,41,78,89,208,2022
2021_B14895,20,83,44,147,2019
2019_A14896,54,32,47,133,2022
2021_B14897,3,52,81,136,2019
2021_A14898,58,85,29,172,2021
2019_A14899,88,97,43,228,2022
2021_B14900,74,76,30,180,2022
2021_C14901,12,12,59,83,2021
2019_B14902,70,89,91,250,2019
2021_B14903,37,80,43,160,2022
2021_B14904,1,19,58,78,2021
2022_A14905,25,92,71,188,2019
2019_A14906,3,57,21,81,2021
2022_B14907,47,70,23,140,2021
2022_C14908,16,61,54,131,2019
2019_C14909,8,95,70,173,2022
2021_C14910,35,26,65,126,2019
2022_C14911,96,58,55,209,2021
2021_C14912,94,12,46,152,2021
2021_A14913,95,12,47,154,2019
2022_A14914,82,31,65,178,2019
2022_C14915,31,75,89,195,2021
2019_A14916,15,51,70,136,2021
2022_B14917,78,49,48,175,2021
2022_A14918,47,93,95,235,2019
2021_A14919,13,16,23,52,2019
2022_C14920,0,81,37,118,2022
2022_A14921,1,11,81,93,2019
2022_B14922,39,26,35,100,2022
2019_B14923,30,58,58,146,2021
2021_B14924,44,94,28,166,2021
2019_A14925,43,86,27,156,2021
2022_C14926,38,23,42,103,2021
2019_A14927,5,92,41,138,2022
2022_A14928,92,12,59,163,2021
2019_C14929,10,40,86,136,2019
2021_C14930,69,68,52,189,2022
2022_A14931,84,22,80,186,2019
2022_B14932,4,38,46,88,2021
2021_C14933,97,35,41,173,2022
2022_B14934,46,72,82,200,2021
2021_C14935,0,91,88,179,2019
2019_B14936,54,61,80,195,2019
2021_A14937,57,56,48,161,2021
2022_C14938,95,86,30,211,2022
2019_B14939,62,19,91,172,2022
2019_B14940,20,74,93,187,2019
2019_C14941,95,73,45,213,2021
2019_B14942,42,73,41,156,2019
2021_A14943,38,86,53,177,2021
2022_C14944,81,59,55,195,2019
2021_B14945,70,57,94,221,2019
2022_C14946,100,69,51,220,2019
2022_A14947,92,65,30,187,2021
2019_A14948,17,59,66,142,2019
2019_A14949,12,95,34,141,2022
2021_A14950,74,41,53,168,2021
2021_B14951,71,64,41,176,2019
2022_C14952,60,49,69,178,2019
2021_B14953,46,62,93,201,2021
2019_C14954,90,15,86,191,2022
2019_A14955,88,74,88,250,2019
2019_B14956,32,72,81,185,2019
2021_B14957,32,47,76,155,2019
2019_B14958,11,31,34,76,2019
2022_B14959,58,48,67,173,2019
2019_C14960,36,19,41,96,2021
2021_C14961,68,47,79,194,2019
2019_A14962,3,14,64,81,2019
2019_B14963,40,53,25,118,2022
2022_A14964,10,34,65,109,2021
2019_C14965,52,91,99,242,2021
2021_A14966,57,95,63,215,2019
2019_B14967,86,40,50,176,2019
2022_C14968,1,55,36,92,2019
2019_A14969,70,78,96,244,2021
2022_B14970,71,93,69,233,2022
2021_A14971,96,74,27,197,2019
2022_C14972,27,41,50,118,2019
2022_C14973,98,37,51,186,2022
2021_B14974,22,46,55,123,2019
2022_B14975,40,12,91,143,2019
2021_B14976,65,63,98,226,2021
2021_A14977,4,15,28,47,2021
2022_A14978,96,86,57,239,2021
2021_A14979,93,86,75,254,2019
2022_C14980,62,26,32,120,2021
2022_B14981,5,92,33,130,2019
2021_C14982,74,26,70,170,2022
2019_B14983,41,42,87,170,2022
2022_B14984,75,58,58,191,2021
2021_A14985,99,14,30,143,2022
2021_B14986,19,47,49,115,2021
2022_A14987,20,22,49,91,2021
2021_B14988,24,13,25,62,2022
2022_B14989,0,13,97,110,2019
2019_B14990,19,66,85,170,2019
2022_C14991,77,33,92,202,2021
2021_B14992,87,76,75,238,2019
2022_A14993,70,42,77,189,2019
2022_A14994,55,93,74,222,2022
2019_B14995,81,29,43,153,2022
2021_B14996,14,11,96,121,2019
2021_C14997,11,74,80,165,2022
2022_C14998,85,68,44,197,2019
2019_A14999,10,47,73,130,2021
2022_C15000,74,20,76,170,2021
2022_B15001,61,29,33,123,2022
2022_A15002,79,63,86,228,2021
2019_C15003,61,78,88,227,2019
2021_C15004,90,18,28,136,2019
2022_B15005,26,63,90,179,2022
2022_A15006,81,94,49,224,2021
2021_A15007,24,88,41,153,2019
2021_C15008,36,24,48,108,2022
2022_C15009,75,79,41,195,2022
2022_A15010,85,37,26,148,2021
2022_B15011,66,37,58,161,2019
2021_C15012,85,74,61,220,2019
2019_B15013,71,91,38,200,2019
2022_C15014,25,84,62,171,2021
2021_B15015,1,16,51,68,2022
2021_A15016,82,50,66,198,2022
2019_A15017,65,20,52,137,2021
2022_C15018,39,15,55,109,2019
2021_C15019,95,65,27,187,2019
2022_B15020,37,67,45,149,2022
2021_C15021,95,23,37,155,2021
2019_B15022,72,33,81,186,2019
2022_A15023,83,90,60,233,2022
2022_A15024,9,53,88,150,2022
2022_C15025,82,55,28,165,2019
2021_C15026,56,13,77,146,2022
2019_B15027,69,34,43,146,2021
2022_C15028,26,54,31,111,2021
2022_C15029,28,84,51,163,2022
2019_A15030,62,39,37,138,2022
2022_A15031,46,75,86,207,2019
2019_A15032,68,88,90,246,2021
2021_A15033,36,82,53,171,2019
2022_C15034,24,51,87,162,2019
2022_B15035,29,69,50,148,2022
2022_C15036,44,17,52,113,2022
2022_C15037,51,55,67,173,2022
2022_B15038,54,94,85,233,2021
2019_A15039,74,96,51,221,2022
2019_C15040,3,62,47,112,2021
2022_A15041,29,45,97,171,2019
2022_B15042,45,73,78,196,2022
2021_A15043,66,75,32,173,2019
2021_A15044,14,85,34,133,2019
2022_C15045,62,44,65,171,2022
2019_C15046,10,34,36,80,2019
2022_A15047,84,82,75,241,2022
2019_A15048,31,81,94,206,2019
2019_A15049,13,46,93,152,2019
2022_A15050,29,26,95,150,2021
2019_C15051,17,25,62,104,2022
2021_A15052,79,40,45,164,2021
2021_B15053,67,22,26,115,2021
2021_A15054,87,59,82,228,2021
2019_B15055,0,75,84,159,2021
2021_B15056,58,40,45,143,2022
2022_B15057,19,13,98,130,2022
2021_B15058,64,74,80,218,2019
2021_B15059,10,64,63,137,2021
2019_B15060,48,35,96,179,2019
2019_B15061,35,59,71,165,2019
2021_C15062,44,82,87,213,2019
2022_C15063,67,39,38,144,2022
2019_C15064,64,42,62,168,2019
2022_B15065,3,93,76,172,2022
2019_B15066,39,52,28,119,2019
2019_A15067,59,33,43,135,2022
2021_C15068,28,74,33,135,2021
2019_C15069,85,96,45,226,2019
2021_C15070,22,12,74,108,2022
2019_A15071,55,89,98,242,2019
2019_C15072,100,70,39,209,2022
2021_C15073,41,30,47,118,2022
2022_B15074,73,13,64,150,2022
2022_A15075,89,46,82,217,2022
2019_B15076,25,67,24,116,2019
2019_B15077,6,79,90,175,2022
2021_B15078,90,77,67,234,2022
2021_A15079,62,93,42,197,2019
2019_B15080,49,22,30,101,2019
2019_B15081,16,59,63,138,2019
2021_B15082,32,67,49,148,2021
2021_C15083,57,46,80,183,2021
2022_B15084,43,82,28,153,2021
2019_A15085,52,30,26,108,2019
2019_C15086,58,16,51,125,2019
2022_A15087,73,24,70,167,2019
2019_B15088,90,45,50,185,2021
2022_C15089,57,21,77,155,2019
2022_C15090,26,49,32,107,2022
2021_C15091,23,59,70,152,2022
2021_A15092,15,72,71,158,2019
2022_C15093,46,43,56,145,2022
2022_B15094,56,82,72,210,2021
2021_C15095,3,39,55,97,2019
2021_B15096,37,44,93,174,2019
2019_A15097,38,67,61,166,2021
2019_A15098,77,53,93,223,2019
2019_C15099,83,87,57,227,2022
2022_A15100,24,12,93,129,2021
2021_A15101,19,75,27,121,2022
2022_C15102,38,66,71,175,2022
2019_A15103,6,71,37,114,2022
2019_B15104,34,14,34,82,2022
2021_A15105,65,38,32,135,2022
2021_B15106,88,14,77,179,2022
2021_B15107,77,27,34,138,2021
2021_C15108,22,96,39,157,2021
2021_C15109,86,31,69,186,2019
2022_C15110,97,42,38,177,2022
2022_C15111,53,26,25,104,2019
2022_C15112,27,43,29,99,2022
2022_C15113,75,86,93,254,2022
2021_C15114,17,49,90,156,2022
2022_B15115,32,36,61,129,2021
2019_A15116,51,53,29,133,2021
2019_B15117,86,36,91,213,2022
2022_A15118,41,63,40,144,2022
2019_A15119,15,12,71,98,2021
2019_C15120,35,33,42,110,2019
2021_B15121,44,80,35,159,2021
2021_C15122,72,13,98,183,2022
2021_C15123,90,89,80,259,2021
2022_C15124,77,51,95,223,2019
2019_A15125,81,92,37,210,2021
2022_A15126,91,49,49,189,2022
2021_A15127,16,75,97,188,2021
2022_A15128,97,67,64,228,2022
2021_C15129,17,96,97,210,2022
2021_A15130,74,11,86,171,2019
2022_B15131,66,87,45,198,2021
2022_B15132,29,16,60,105,2022
2019_A15133,70,42,74,186,2022
2022_A15134,95,63,99,257,2021
2022_C15135,52,67,57,176,2019
2021_C15136,2,62,60,124,2021
2022_B15137,93,13,33,139,2022
2022_B15138,41,11,50,102,2021
2019_A15139,65,75,23,163,2021
2022_A15140,64,75,96,235,2019
2021_B15141,4,96,59,159,2022
2022_C15142,59,72,47,178,2022
2021_A15143,54,29,99,182,2021
2021_B15144,4,30,27,61,2021
2021_B15145,25,26,78,129,2022
2019_B15146,80,47,58,185,2021
2021_A15147,68,40,37,145,2022
2019_C15148,7,83,93,183,2019
2022_A15149,59,66,91,216,2022
2022_A15150,76,45,90,211,2021
2019_A15151,83,73,30,186,2022
2022_B15152,21,17,71,109,2022
2021_C15153,49,22,55,126,2022
2022_B15154,15,74,78,167,2022
2022_A15155,3,56,65,124,2022
2021_B15156,99,14,92,205,2021
2021_A15157,44,25,42,111,2019
2022_C15158,14,33,56,103,2022
2021_B15159,44,25,36,105,2022
2021_A15160,51,86,75,212,2019
2019_C15161,5,88,82,175,2019
2019_A15162,49,57,77,183,2022
2021_C15163,61,93,45,199,2022
2022_A15164,24,75,46,145,2019
2019_B15165,56,69,80,205,2022
2022_C15166,30,70,78,178,2021
2019_A15167,18,32,33,83,2021
2021_A15168,60,59,92,211,2022
2022_A15169,61,51,84,196,2022
2022_C15170,73,15,32,120,2021
2022_C15171,31,93,68,192,2021
2021_B15172,61,84,65,210,2022
2021_A15173,60,91,53,204,2022
2021_C15174,16,88,63,167,2019
2022_B15175,72,38,91,201,2022
2021_C15176,15,50,69,134,2019
2021_B15177,31,84,44,159,2019
2022_C15178,52,58,25,135,2022
2022_A15179,31,90,42,163,2022
2019_C15180,48,26,87,161,2021
2019_A15181,80,44,92,216,2019
2022_C15182,72,15,68,155,2022
2022_A15183,4,43,24,71,2019
2019_A15184,33,86,96,215,2022
2021_B15185,70,73,27,170,2019
2019_C15186,88,54,21,163,2022
2021_A15187,3,85,46,134,2021
2022_A15188,86,38,79,203,2019
2019_B15189,21,44,68,133,2019
2022_B15190,23,88,79,190,2021
2019_B15191,30,84,68,182,2021
2022_C15192,3,49,85,137,2022
2022_C15193,86,64,33,183,2019
2019_C15194,67,50,80,197,2021
2021_B15195,33,43,69,145,2021
2022_A15196,81,81,23,185,2021
2021_A15197,89,81,81,251,2022
2021_C15198,69,85,22,176,2021
2021_C15199,8,76,24,108,2022
2021_A15200,10,15,50,75,2022
2021_B15201,87,14,36,137,2021
2019_A15202,71,95,31,197,2022
2021_B15203,26,40,62,128,2019
2019_A15204,77,56,99,232,2022
2021_B15205,3,14,94,111,2022
2021_C15206,87,45,94,226,2019
2019_A15207,100,24,46,170,2021
2022_A15208,100,71,50,221,2021
2021_B15209,85,63,26,174,2019
2021_A15210,20,57,85,162,2022
2021_B15211,22,96,41,159,2021
2022_B15212,38,62,95,195,2021
2021_C15213,41,15,39,95,2022
2022_A15214,95,35,54,184,2019
2021_A15215,77,90,47,214,2019
2022_B15216,41,28,82,151,2021
2022_C15217,82,62,64,208,2019
2021_A15218,82,13,42,137,2022
2019_A15219,45,18,26,89,2021
2021_C15220,67,47,37,151,2021
2019_B15221,36,89,98,223,2022
2022_A15222,4,49,89,142,2021
2021_A15223,50,53,92,195,2022
2022_B15224,49,85,85,219,2019
2021_A15225,45,54,44,143,2019
2022_C15226,88,49,38,175,2021
2019_A15227,4,33,82,119,2022
2022_C15228,16,46,23,85,2022
2019_A15229,41,57,32,130,2021
2019_C15230,79,91,36,206,2019
2021_C15231,10,68,37,115,2022
2021_C15232,59,79,92,230,2019
2022_B15233,64,57,52,173,2021
2021_C15234,67,29,90,186,2021
2019_B15235,89,28,76,193,2022
2019_B15236,75,62,97,234,2019
2022_A15237,77,20,22,119,2021
2019_C15238,48,72,97,217,2019
2021_C15239,86,86,26,198,2019
2021_B15240,23,71,72,166,2019
2022_C15241,17,82,23,122,2022
2019_A15242,69,14,28,111,2019
2022_B15243,91,36,45,172,2022
2021_A15244,64,65,93,222,2019
2022_C15245,63,30,85,178,2022
2019_B15246,32,57,31,120,2021
2019_C15247,96,21,44,161,2021
2022_C15248,52,87,58,197,2021
2019_C15249,42,77,69,188,2022
2021_B15250,51,90,32,173,2021
2022_C15251,21,70,21,112,2021
2019_C15252,13,17,61,91,2021
2019_B15253,24,13,91,128,2022
2021_A15254,47,94,62,203,2022
2022_A15255,34,73,86,193,2021
2022_C15256,20,24,81,125,2021
2021_A15257,21,59,78,158,2022
2021_C15258,56,28,43,127,2022
2022_C15259,30,24,36,90,2019
2022_A15260,35,19,96,150,2021
2019_C15261,80,68,81,229,2021
2021_B15262,92,75,23,190,2022
2019_B15263,88,67,92,247,2022
2021_C15264,17,44,54,115,2019
2022_B15265,94,55,71,220,2019
2021_C15266,43,56,29,128,2021
2019_B15267,20,32,92,144,2021
2019_B15268,37,55,96,188,2022
2022_B15269,95,36,65,196,2021
2022_C15270,23,44,35,102,2019
2022_B15271,28,88,42,158,2019
2019_A15272,100,35,67,202,2021
2021_C15273,76,49,58,183,2021
2019_C15274,27,12,34,73,2022
2019_C15275,73,46,31,150,2022
2019_C15276,35,96,71,202,2022
2019_C15277,23,31,45,99,2022
2022_A15278,61,67,28,156,2019
2019_A15279,85,61,74,220,2019
2021_A15280,18,62,68,148,2019
2021_C15281,65,55,93,213,2021
2022_B15282,92,23,65,180,2022
2022_B15283,35,86,95,216,2022
2022_B15284,13,48,56,117,2019
2019_A15285,2,75,80,157,2022
2021_B15286,39,72,67,178,2021
2021_C15287,28,62,44,134,2019
2021_A15288,32,37,95,164,2021
2021_A15289,43,39,54,136,2019
2022_B15290,65,26,50,141,2022
2022_A15291,21,37,63,121,2022
2022_A15292,78,97,34,209,2022
2021_C15293,16,91,97,204,2019
2019_C15294,99,78,53,230,2019
2019_C15295,0,97,85,182,2022
2019_C15296,10,37,83,130,2019
2019_C15297,11,52,58,121,2022
2019_B15298,32,21,63,116,2021
2019_C15299,68,63,80,211,2019
2019_C15300,86,22,70,178,2019
2021_C15301,3,33,46,82,2022
2019_A15302,62,54,64,180,2021
2022_C15303,93,55,44,192,2022
2022_A15304,41,42,27,110,2019
2022_A15305,68,15,64,147,2022
2019_A15306,100,19,71,190,2022
2019_B15307,49,27,68,144,2021
2021_B15308,62,13,45,120,2021
2021_B15309,55,25,98,178,2021
2019_C15310,8,94,68,170,2019
2022_C15311,29,64,79,172,2022
2022_C15312,75,72,39,186,2019
2022_A15313,81,18,65,164,2021
2019_B15314,68,25,64,157,2022
2019_A15315,85,85,44,214,2022
2022_A15316,94,87,23,204,2021
2021_B15317,94,33,45,172,2021
2022_A15318,16,53,25,94,2019
2022_C15319,64,60,53,177,2021
2019_A15320,36,48,98,182,2021
2019_A15321,70,35,34,139,2022
2021_B15322,27,30,71,128,2022
2019_A15323,29,65,85,179,2022
2019_B15324,65,15,40,120,2021
2021_A15325,71,25,50,146,2022
2021_B15326,23,73,99,195,2021
2021_A15327,91,13,37,141,2021
2019_C15328,1,24,72,97,2022
2022_C15329,32,90,79,201,2021
2022_A15330,75,38,81,194,2021
2022_B15331,85,15,79,179,2019
2022_A15332,96,90,87,273,2021
2019_C15333,75,92,61,228,2022
2022_C15334,45,40,42,127,2021
2021_A15335,18,23,89,130,2019
2022_B15336,40,85,32,157,2019
2019_A15337,78,20,45,143,2019
2019_B15338,55,65,66,186,2021
2019_A15339,8,49,49,106,2019
2019_A15340,47,65,65,177,2022
2021_A15341,51,88,32,171,2019
2019_B15342,29,66,65,160,2021
2022_C15343,65,65,78,208,2022
2019_A15344,6,67,98,171,2022
2019_C15345,46,97,60,203,2021
2019_A15346,59,47,47,153,2022
2019_B15347,8,56,23,87,2019
2019_B15348,17,64,37,118,2022
2019_B15349,44,66,56,166,2022
2022_B15350,15,20,40,75,2019
2019_B15351,53,91,27,171,2022
2019_B15352,70,46,67,183,2022
2021_C15353,24,25,69,118,2021
2021_A15354,27,38,94,159,2022
2022_C15355,3,77,53,133,2019
2021_A15356,46,47,72,165,2022
2021_B15357,23,68,90,181,2019
2021_C15358,70,24,55,149,2021
2019_A15359,19,65,46,130,2019
2021_C15360,74,96,85,255,2021
2022_C15361,87,21,78,186,2019
2022_A15362,65,95,58,218,2021
2019_C15363,41,19,29,89,2021
2022_B15364,59,64,65,188,2021
2022_C15365,91,14,37,142,2021
2019_C15366,78,96,59,233,2019
2021_A15367,40,34,60,134,2022
2019_C15368,9,25,44,78,2022
2021_C15369,10,37,50,97,2019
2022_C15370,72,85,94,251,2021
2021_B15371,85,30,69,184,2021
2019_C15372,28,25,23,76,2019
2019_C15373,25,37,38,100,2021
2019_A15374,93,79,96,268,2019
2019_B15375,12,78,38,128,2022
2019_B15376,65,52,56,173,2022
2022_A15377,16,31,87,134,2021
2021_B15378,34,97,79,210,2022
2022_A15379,58,35,59,152,2019
2019_C15380,22,91,62,175,2019
2022_B15381,6,27,80,113,2021
2021_B15382,41,27,55,123,2021
2022_B15383,86,83,95,264,2019
2021_B15384,47,35,51,133,2022
2019_C15385,62,97,55,214,2019
2021_B15386,53,97,76,226,2019
2021_B15387,10,20,62,92,2021
2022_A15388,72,84,74,230,2022
2019_C15389,90,37,96,223,2019
2021_A15390,34,27,23,84,2022
2019_B15391,34,31,55,120,2022
2019_B15392,94,79,96,269,2019
2019_C15393,59,78,99,236,2022
2019_C15394,28,74,34,136,2021
2021_B15395,72,70,31,173,2021
2021_B15396,8,71,32,111,2022
2019_B15397,32,61,58,151,2022
2019_A15398,16,51,75,142,2019
2022_C15399,57,80,87,224,2021
2019_C15400,16,21,39,76,2021
2019_B15401,66,22,55,143,2019
2019_B15402,19,89,53,161,2021
2022_B15403,94,49,90,233,2022
2021_C15404,16,29,63,108,2022
2022_B15405,9,46,61,116,2019
2019_A15406,23,36,99,158,2021
2022_A15407,28,30,34,92,2021
2022_A15408,30,35,23,88,2019
2021_B15409,16,21,32,69,2021
2019_A15410,94,55,67,216,2021
2019_A15411,11,96,49,156,2021
2022_A15412,63,60,57,180,2022
2021_C15413,100,82,22,204,2021
2021_A15414,25,67,54,146,2021
2021_A15415,31,58,66,155,2022
2022_C15416,44,50,52,146,2019
2019_A15417,72,72,80,224,2022
2021_C15418,2,53,78,133,2021
2022_B15419,71,34,38,143,2022
2019_B15420,66,68,40,174,2022
2019_B15421,50,77,26,153,2019
2021_C15422,2,67,94,163,2019
2019_B15423,14,84,67,165,2022
2022_A15424,11,87,61,159,2022
2021_A15425,9,39,32,80,2022
2021_C15426,45,24,42,111,2021
2021_A15427,67,87,22,176,2019
2019_C15428,20,34,52,106,2021
2019_B15429,75,14,86,175,2019
2021_B15430,83,40,70,193,2019
2021_A15431,92,90,97,279,2019
2019_C15432,56,61,70,187,2021
2019_C15433,1,28,57,86,2019
2022_C15434,49,61,79,189,2019
2022_B15435,52,23,86,161,2021
2021_B15436,39,21,29,89,2019
2019_B15437,53,17,55,125,2022
2019_B15438,58,51,60,169,2021
2019_A15439,52,63,97,212,2019
2022_B15440,61,36,46,143,2019
2021_A15441,95,21,43,159,2022
2019_A15442,83,75,49,207,2021
2019_C15443,59,86,96,241,2022
2022_A15444,82,66,28,176,2021
2021_B15445,48,53,83,184,2021
2019_C15446,45,74,66,185,2022
2021_C15447,66,37,93,196,2019
2019_C15448,10,34,89,133,2022
2022_C15449,60,66,99,225,2021
2021_A15450,18,30,61,109,2019
2021_C15451,84,70,55,209,2021
2021_C15452,54,87,49,190,2019
2019_C15453,63,36,99,198,2022
2021_C15454,21,21,81,123,2022
2019_B15455,16,46,59,121,2021
2019_B15456,49,87,51,187,2022
2021_C15457,89,52,41,182,2021
2022_C15458,39,41,97,177,2021
2019_C15459,67,22,90,179,2019
2021_A15460,98,21,67,186,2022
2019_B15461,54,85,71,210,2019
2021_A15462,53,20,65,138,2021
2021_A15463,76,43,25,144,2021
2022_A15464,53,90,35,178,2022
2019_B15465,47,94,83,224,2019
2021_A15466,98,92,86,276,2019
2021_A15467,0,69,62,131,2022
2022_B15468,16,46,32,94,2019
2022_C15469,76,75,32,183,2022
2019_C15470,49,24,65,138,2021
2022_B15471,98,12,52,162,2019
2022_C15472,98,91,22,211,2019
2019_A15473,94,12,47,153,2019
2022_B15474,72,86,90,248,2021
2021_B15475,34,41,63,138,2019
2021_C15476,63,65,93,221,2019
2019_C15477,78,82,46,206,2019
2019_B15478,55,66,72,193,2022
2021_B15479,0,97,72,169,2019
2021_B15480,44,85,28,157,2019
2021_A15481,54,29,35,118,2021
2022_C15482,92,37,63,192,2021
2021_C15483,98,48,90,236,2021
2019_C15484,0,24,73,97,2019
2022_A15485,35,49,98,182,2022
2021_B15486,75,16,65,156,2021
2019_C15487,26,63,47,136,2022
2021_A15488,30,52,29,111,2019
2019_B15489,4,87,90,181,2021
2021_A15490,12,85,48,145,2022
2021_B15491,7,59,47,113,2022
2021_C15492,52,83,69,204,2019
2021_C15493,79,97,61,237,2022
2022_C15494,17,72,38,127,2021
2021_C15495,40,58,78,176,2022
2019_B15496,95,20,96,211,2021
2019_A15497,71,69,40,180,2019
2019_C15498,53,74,26,153,2022
2022_B15499,23,11,61,95,2019
2022_C15500,52,88,84,224,2021
2019_B15501,32,81,61,174,2021
2022_C15502,97,71,51,219,2019
2021_B15503,41,72,22,135,2021
2019_C15504,70,84,43,197,2019
2019_A15505,21,48,55,124,2022
2019_A15506,31,55,65,151,2022
2021_C15507,65,68,48,181,2021
2019_C15508,0,37,48,85,2019
2022_B15509,64,38,35,137,2019
2022_A15510,4,21,27,52,2019
2022_C15511,3,69,61,133,2022
2021_B15512,2,89,99,190,2021
2019_C15513,46,35,23,104,2021
2019_C15514,32,71,68,171,2021
2021_C15515,81,94,40,215,2022
2021_C15516,76,75,98,249,2019
2019_C15517,98,82,24,204,2021
2019_A15518,14,59,92,165,2019
2019_A15519,33,90,76,199,2021
2019_B15520,100,42,77,219,2022
2021_A15521,68,18,80,166,2021
2021_C15522,88,86,80,254,2022
2021_C15523,98,14,85,197,2021
2022_B15524,8,46,76,130,2022
2019_C15525,66,11,67,144,2019
2022_A15526,100,92,75,267,2022
2022_C15527,29,28,28,85,2022
2021_B15528,37,70,39,146,2019
2022_C15529,75,91,99,265,2022
2019_C15530,31,89,52,172,2019
2021_A15531,91,37,52,180,2021
2019_C15532,63,15,88,166,2021
2021_A15533,20,47,91,158,2022
2021_C15534,69,64,78,211,2022
2022_A15535,37,78,49,164,2022
2021_A15536,72,17,37,126,2019
2022_A15537,97,26,71,194,2021
2019_A15538,25,49,66,140,2022
2019_C15539,84,29,51,164,2019
2019_B15540,34,51,98,183,2021
2019_B15541,10,91,21,122,2021
2021_A15542,3,56,23,82,2021
2019_A15543,58,32,26,116,2019
2022_B15544,65,67,27,159,2022
2019_B15545,39,92,75,206,2021
2021_A15546,34,44,37,115,2021
2021_B15547,15,63,45,123,2022
2019_B15548,23,82,41,146,2021
2022_A15549,41,70,79,190,2022
2022_B15550,31,15,74,120,2022
2021_A15551,86,57,93,236,2022
2021_C15552,26,42,68,136,2022
2019_B15553,39,77,22,138,2019
2019_C15554,23,22,47,92,2022
2019_B15555,9,77,52,138,2019
2022_B15556,60,68,52,180,2019
2021_C15557,7,54,47,108,2019
2021_A15558,61,62,29,152,2019
2022_C15559,20,78,97,195,2022
2022_B15560,7,18,25,50,2021
2021_B15561,6,33,52,91,2021
2019_C15562,100,93,89,282,2021
2022_B15563,89,95,56,240,2021
2022_A15564,77,81,22,180,2021
2019_C15565,1,68,63,132,2019
2019_C15566,39,84,60,183,2021
2022_A15567,40,46,45,131,2021
2022_A15568,18,68,59,145,2022
2021_B15569,58,92,73,223,2021
2019_B15570,53,58,31,142,2021
2021_C15571,43,34,30,107,2021
2021_A15572,52,24,79,155,2021
2019_A15573,96,40,35,171,2022
2022_B15574,21,37,43,101,2019
2022_B15575,98,25,35,158,2021
2022_B15576,48,55,36,139,2022
2021_C15577,65,59,23,147,2022
2019_A15578,68,84,99,251,2019
2021_C15579,9,41,46,96,2021
2022_A15580,61,95,36,192,2021
2021_A15581,98,64,50,212,2022
2019_B15582,77,63,43,183,2021
2022_B15583,14,46,61,121,2021
2022_A15584,53,97,76,226,2022
2019_C15585,10,87,75,172,2019
2019_B15586,37,75,48,160,2019
2022_A15587,14,64,43,121,2021
2019_A15588,78,35,63,176,2019
2022_A15589,62,97,58,217,2021
2021_B15590,8,90,76,174,2019
2021_C15591,62,54,47,163,2022
2021_C15592,25,31,24,80,2019
2022_C15593,89,31,27,147,2021
2021_C15594,42,89,61,192,2019
2022_A15595,88,95,31,214,2022
2021_A15596,22,58,90,170,2022
2022_B15597,19,52,25,96,2022
2019_A15598,45,32,40,117,2021
2019_A15599,100,13,23,136,2021
2019_A15600,92,64,79,235,2022
2019_C15601,12,53,67,132,2021
2021_C15602,4,64,70,138,2019
2019_C15603,26,44,22,92,2021
2019_B15604,89,66,21,176,2022
2019_A15605,23,68,60,151,2019
2022_A15606,35,93,51,179,2019
2019_B15607,30,87,83,200,2022
2019_C15608,15,86,72,173,2022
2022_C15609,12,11,21,44,2021
2019_A15610,45,20,63,128,2021
2021_A15611,25,95,60,180,2022
2019_A15612,20,86,58,164,2021
2022_C15613,7,97,43,147,2021
2021_B15614,40,67,88,195,2021
2021_B15615,93,75,91,259,2022
2019_A15616,52,89,35,176,2019
2022_C15617,26,42,88,156,2022
2022_A15618,88,35,62,185,2021
2019_A15619,5,77,96,178,2019
2021_A15620,99,16,77,192,2021
2022_A15621,91,47,48,186,2019
2019_A15622,9,17,36,62,2022
2022_A15623,36,58,99,193,2022
2019_C15624,78,97,84,259,2022
2019_B15625,9,59,46,114,2021
2021_A15626,59,18,95,172,2022
2019_B15627,71,66,74,211,2022
2021_B15628,96,83,75,254,2019
2021_A15629,98,95,88,281,2021
2019_A15630,98,90,42,230,2021
2019_B15631,63,44,86,193,2021
2021_C15632,39,34,36,109,2021
2019_B15633,46,90,80,216,2021
2019_C15634,24,74,59,157,2021
2022_C15635,55,50,22,127,2019
2021_B15636,10,83,96,189,2021
2019_B15637,19,33,54,106,2022
2022_A15638,98,84,96,278,2022
2022_A15639,30,51,44,125,2021
2019_C15640,12,23,61,96,2021
2019_B15641,19,29,22,70,2021
2021_C15642,16,64,76,156,2021
2022_B15643,24,31,82,137,2022
2022_B15644,25,48,93,166,2019
2022_B15645,61,95,25,181,2019
2022_B15646,85,36,91,212,2022
2022_C15647,92,86,22,200,2021
2019_C15648,36,20,25,81,2022
2021_A15649,57,88,52,197,2021
2022_A15650,72,55,92,219,2021
2022_C15651,34,63,25,122,2019
2021_A15652,13,14,68,95,2019
2021_C15653,85,43,35,163,2019
2022_C15654,38,19,21,78,2021
2021_A15655,43,54,45,142,2022
2021_C15656,57,66,94,217,2019
2019_C15657,89,86,31,206,2022
2019_B15658,50,33,75,158,2019
2021_A15659,15,55,58,128,2019
2019_B15660,61,89,76,226,2019
2021_B15661,33,97,24,154,2021
2022_C15662,54,94,79,227,2021
2019_C15663,59,37,65,161,2021
2019_A15664,31,22,50,103,2019
2022_B15665,44,61,64,169,2019
2021_B15666,16,69,37,122,2021
2022_C15667,58,44,29,131,2021
2022_A15668,98,78,38,214,2021
2021_A15669,16,51,40,107,2021
2021_B15670,89,15,26,130,2019
2022_B15671,25,24,61,110,2022
2022_C15672,51,30,61,142,2022
2019_C15673,26,33,21,80,2021
2019_A15674,97,72,91,260,2022
2021_C15675,73,17,49,139,2021
2019_C15676,50,29,89,168,2021
2022_B15677,94,12,67,173,2019
2019_B15678,36,25,57,118,2021
2022_B15679,18,71,96,185,2019
2019_C15680,62,37,95,194,2019
2022_B15681,27,65,49,141,2022
2021_A15682,100,29,51,180,2022
2021_C15683,9,94,79,182,2019
2022_B15684,83,66,78,227,2022
2021_B15685,52,85,81,218,2022
2021_B15686,53,79,30,162,2019
2019_B15687,66,96,36,198,2021
2022_B15688,29,13,74,116,2019
2022_A15689,41,70,67,178,2019
2021_B15690,93,41,73,207,2021
2019_C15691,89,34,84,207,2019
2021_C15692,65,61,92,218,2019
2019_A15693,13,29,56,98,2019
2021_A15694,2,67,49,118,2021
2022_B15695,3,67,40,110,2019
2022_C15696,33,42,30,105,2019
2022_A15697,66,38,32,136,2022
2022_C15698,60,17,60,137,2021
2019_C15699,74,79,91,244,2019
2021_A15700,43,78,93,214,2022
2019_C15701,30,79,31,140,2019
2021_B15702,51,11,83,145,2021
2021_C15703,7,64,91,162,2021
2019_C15704,93,44,96,233,2022
2019_A15705,94,26,81,201,2021
2022_C15706,41,73,77,191,2021
2021_B15707,72,24,65,161,2021
2019_C15708,70,29,96,195,2022
2022_B15709,82,71,25,178,2021
2021_B15710,9,79,38,126,2021
2022_A15711,52,93,39,184,2019
2019_B15712,28,26,90,144,2021
2019_B15713,93,33,41,167,2021
2021_B15714,19,78,52,149,2022
2022_A15715,31,59,53,143,2021
2022_B15716,11,19,74,104,2021
2021_C15717,49,73,68,190,2021
2022_C15718,29,84,85,198,2022
2021_A15719,67,54,86,207,2019
2019_C15720,66,72,87,225,2019
2021_A15721,63,77,21,161,2021
2019_B15722,87,91,28,206,2022
2019_B15723,90,88,30,208,2021
2019_B15724,33,69,40,142,2019
2022_C15725,41,30,95,166,2022
2022_B15726,76,77,62,215,2021
2022_B15727,30,30,82,142,2022
2019_A15728,4,48,62,114,2021
2021_A15729,80,50,41,171,2019
2022_B15730,28,95,23,146,2021
2021_C15731,73,92,90,255,2019
2022_B15732,33,90,21,144,2021
2021_C15733,98,16,97,211,2022
2022_B15734,26,73,29,128,2022
2021_A15735,13,44,28,85,2022
2022_C15736,59,54,45,158,2022
2022_A15737,46,78,72,196,2022
2019_A15738,94,44,75,213,2019
2021_B15739,11,14,67,92,2021
2021_C15740,64,56,53,173,2022
2019_B15741,47,40,89,176,2022
2021_C15742,1,54,85,140,2021
2021_B15743,20,32,66,118,2022
2021_C15744,58,85,23,166,2021
2019_C15745,84,83,41,208,2021
2021_A15746,77,56,57,190,2019
2021_A15747,71,17,95,183,2019
2019_C15748,6,29,71,106,2022
2019_B15749,49,46,45,140,2022
2021_A15750,64,38,63,165,2021
2021_A15751,26,70,96,192,2022
2019_C15752,66,43,74,183,2021
2022_B15753,35,89,99,223,2019
2022_A15754,96,41,30,167,2022
2022_C15755,78,14,24,116,2021
2022_B15756,91,13,90,194,2019
2021_C15757,86,77,44,207,2021
2019_B15758,57,84,44,185,2021
2021_B15759,86,27,39,152,2022
2019_B15760,20,94,77,191,2021
2019_C15761,45,19,64,128,2022
2019_B15762,7,77,33,117,2019
2021_C15763,28,77,23,128,2022
2022_C15764,67,18,93,178,2019
2019_A15765,58,66,43,167,2019
2021_A15766,29,17,80,126,2021
2021_A15767,57,16,24,97,2022
2021_C15768,11,55,39,105,2022
2022_A15769,76,32,37,145,2022
2021_C15770,68,84,91,243,2021
2019_C15771,83,78,59,220,2019
2019_C15772,63,16,66,145,2022
2022_B15773,48,91,54,193,2021
2021_C15774,71,34,56,161,2022
2022_C15775,14,43,58,115,2022
2022_C15776,10,67,50,127,2022
2022_A15777,3,46,99,148,2022
2022_B15778,1,13,71,85,2021
2021_B15779,89,96,87,272,2019
2019_C15780,14,94,33,141,2019
2019_B15781,47,95,91,233,2019
2019_C15782,29,81,44,154,2022
2019_C15783,10,70,74,154,2019
2021_A15784,34,94,97,225,2021
2021_C15785,99,34,23,156,2019
2019_C15786,64,21,68,153,2021
2022_A15787,15,71,38,124,2022
2021_B15788,52,66,86,204,2022
2021_A15789,28,18,33,79,2022
2019_C15790,93,34,90,217,2022
2019_B15791,23,40,77,140,2022
2022_B15792,11,90,74,175,2022
2021_B15793,97,45,44,186,2022
2022_B15794,89,89,39,217,2022
2021_A15795,56,71,56,183,2019
2019_C15796,39,19,49,107,2021
2019_A15797,31,26,81,138,2022
2021_B15798,96,79,63,238,2021
2021_A15799,41,77,71,189,2022
2022_A15800,58,45,52,155,2021
2021_B15801,80,69,95,244,2019
2019_A15802,66,52,93,211,2019
2021_B15803,33,86,67,186,2019
2021_C15804,87,43,85,215,2021
2021_B15805,90,43,42,175,2021
2021_C15806,65,17,81,163,2019
2022_C15807,10,82,90,182,2019
2019_C15808,22,57,41,120,2019
2022_C15809,27,79,70,176,2021
2021_B15810,50,43,41,134,2021
2022_C15811,75,58,39,172,2022
2021_A15812,41,34,52,127,2022
2022_C15813,38,25,32,95,2019
2021_C15814,56,84,39,179,2019
2019_A15815,87,63,82,232,2021
2019_C15816,80,90,84,254,2019
2019_A15817,28,25,52,105,2022
2021_B15818,10,73,37,120,2019
2021_C15819,37,24,66,127,2019
2021_B15820,13,12,54,79,2021
2021_C15821,58,87,39,184,2021
2019_B15822,81,35,73,189,2021
2022_C15823,58,26,48,132,2019
2022_C15824,12,15,94,121,2022
2021_B15825,93,23,89,205,2022
2022_B15826,72,27,81,180,2022
2019_A15827,14,11,64,89,2019
2019_A15828,28,18,64,110,2022
2019_A15829,17,47,60,124,2021
2022_A15830,0,30,25,55,2021
2022_A15831,91,37,64,192,2022
2019_A15832,72,74,47,193,2019
2022_B15833,30,35,49,114,2019
2022_A15834,93,76,94,263,2021
2021_B15835,31,75,52,158,2019
2022_C15836,59,90,92,241,2021
2019_C15837,8,72,28,108,2022
2021_B15838,46,95,78,219,2019
2022_B15839,61,35,49,145,2021
2022_A15840,86,75,68,229,2022
2019_A15841,48,69,80,197,2022
2021_B15842,69,79,25,173,2021
2022_B15843,62,12,78,152,2021
2019_C15844,94,60,87,241,2022
2022_A15845,34,16,44,94,2019
2021_A15846,20,71,91,182,2021
2019_B15847,63,31,31,125,2021
2019_C15848,19,57,64,140,2021
2022_B15849,9,89,85,183,2019
2021_C15850,6,16,87,109,2022
2021_C15851,2,95,65,162,2021
2022_B15852,61,57,51,169,2022
2019_B15853,88,83,60,231,2019
2019_C15854,93,51,54,198,2022
2021_C15855,29,48,50,127,2019
2022_C15856,55,59,34,148,2021
2019_B15857,47,78,48,173,2019
2019_A15858,28,38,33,99,2019
2019_B15859,52,49,35,136,2021
2021_C15860,32,65,94,191,2022
2022_A15861,37,34,51,122,2019
2022_C15862,96,59,40,195,2021
2019_B15863,77,43,93,213,2021
2021_B15864,86,95,55,236,2019
2019_C15865,49,91,76,216,2022
2019_C15866,94,59,90,243,2021
2022_B15867,15,86,92,193,2021
2019_A15868,46,17,80,143,2021
2022_A15869,44,25,43,112,2019
2022_A15870,66,78,45,189,2022
2019_B15871,54,54,56,164,2019
2022_A15872,31,28,69,128,2021
2021_A15873,15,34,41,90,2019
2022_B15874,11,35,51,97,2021
2021_C15875,39,14,93,146,2022
2019_B15876,79,28,38,145,2022
2022_A15877,36,76,81,193,2019
2019_C15878,27,49,51,127,2019
2021_C15879,58,58,31,147,2021
2019_C15880,86,62,67,215,2022
2021_C15881,53,39,32,124,2022
2022_B15882,13,91,63,167,2021
2019_A15883,66,12,56,134,2022
2022_B15884,73,47,90,210,2021
2021_A15885,40,26,67,133,2022
2022_A15886,6,62,29,97,2021
2021_B15887,65,97,96,258,2021
2022_B15888,76,76,50,202,2021
2019_C15889,21,48,74,143,2019
2022_A15890,12,97,43,152,2019
2021_A15891,6,44,46,96,2022
2021_A15892,90,36,84,210,2019
2019_B15893,81,91,21,193,2019
2022_C15894,48,72,27,147,2021
2019_A15895,12,50,53,115,2019
2022_B15896,9,55,47,111,2021
2021_B15897,89,39,53,181,2019
2021_B15898,3,80,24,107,2022
2021_B15899,77,83,67,227,2022
2022_A15900,59,47,35,141,2019
2019_A15901,55,63,52,170,2022
2019_B15902,13,11,32,56,2022
2019_A15903,44,61,90,195,2022
2019_C15904,17,44,73,134,2021
2022_C15905,54,49,23,126,2021
2022_B15906,26,52,88,166,2019
2019_B15907,2,16,76,94,2022
2019_B15908,3,88,99,190,2022
2022_A15909,89,91,49,229,2021
2019_A15910,46,51,60,157,2022
2022_A15911,88,23,69,180,2021
2022_B15912,85,83,71,239,2021
2019_C15913,66,51,83,200,2021
2022_A15914,50,69,33,152,2019
2021_C15915,31,17,85,133,2019
2022_B15916,33,64,63,160,2022
2019_B15917,23,96,89,208,2022
2021_A15918,33,12,29,74,2022
2021_B15919,88,53,83,224,2019
2022_B15920,58,49,33,140,2021
2019_C15921,91,91,94,276,2021
2021_A15922,38,27,39,104,2021
2022_A15923,68,17,45,130,2022
2021_C15924,55,97,81,233,2022
2022_B15925,98,54,91,243,2022
2019_C15926,97,82,83,262,2021
2019_B15927,98,86,72,256,2021
2022_A15928,64,66,78,208,2019
2019_A15929,99,61,52,212,2022
2021_A15930,18,85,98,201,2019
2022_C15931,73,87,27,187,2019
2022_B15932,56,16,62,134,2022
2019_A15933,79,12,85,176,2021
2022_A15934,4,32,71,107,2019
2021_B15935,2,47,75,124,2021
2019_A15936,98,54,40,192,2022
2019_B15937,97,16,21,134,2021
2021_A15938,64,83,50,197,2019
2021_B15939,93,78,21,192,2019
2021_A15940,63,72,73,208,2019
2021_C15941,0,32,28,60,2019
2019_C15942,67,20,81,168,2022
2022_A15943,44,62,22,128,2022
2021_A15944,17,72,88,177,2019
2022_A15945,7,74,49,130,2021
2021_C15946,81,50,38,169,2019
2021_A15947,12,80,79,171,2021
2022_A15948,66,96,59,221,2021
2022_C15949,94,11,30,135,2022
2019_C15950,62,65,55,182,2019
2021_A15951,5,50,77,132,2021
2022_C15952,19,83,25,127,2021
2021_A15953,84,75,71,230,2022
2022_C15954,92,64,85,241,2022
2019_B15955,64,62,33,159,2022
2019_A15956,51,90,97,238,2021
2021_B15957,60,60,26,146,2022
2022_A15958,2,95,42,139,2021
2019_C15959,68,89,61,218,2021
2019_B15960,22,20,73,115,2022
2021_C15961,59,91,88,238,2019
2021_A15962,62,70,72,204,2019
2019_A15963,1,47,55,103,2019
2022_B15964,39,16,78,133,2019
2021_A15965,63,54,85,202,2021
2021_B15966,28,16,61,105,2021
2022_C15967,29,11,92,132,2022
2021_B15968,0,79,33,112,2021
2021_C15969,33,92,30,155,2022
2021_B15970,4,12,57,73,2019
2021_C15971,86,95,64,245,2021
2019_C15972,16,13,71,100,2019
2021_A15973,12,44,60,116,2021
2019_C15974,32,36,56,124,2021
2019_B15975,10,80,98,188,2021
2022_A15976,52,22,46,120,2019
2019_C15977,70,72,99,241,2021
2019_C15978,50,35,29,114,2019
2019_A15979,67,93,75,235,2022
2021_C15980,1,12,50,63,2022
2022_A15981,12,84,45,141,2019
2019_C15982,49,73,27,149,2022
2019_C15983,79,97,77,253,2022
2021_B15984,15,56,91,162,2021
2019_B15985,90,80,91,261,2021
2022_A15986,10,46,32,88,2021
2022_A15987,92,72,54,218,2022
2021_C15988,50,90,60,200,2019
2021_C15989,67,74,71,212,2022
2022_C15990,23,94,98,215,2021
2022_A15991,79,87,27,193,2022
2022_C15992,17,30,69,116,2021
2021_C15993,100,61,96,257,2022
2019_A15994,96,85,48,229,2019
2019_B15995,60,29,83,172,2019
2022_B15996,18,88,80,186,2019
2021_B15997,12,11,68,91,2019
2021_B15998,72,95,22,189,2019
2021_B15999,98,51,88,237,2019
2021_C16000,8,29,39,76,2022
2021_C16001,78,68,34,180,2021
2021_C16002,71,39,24,134,2019
2022_C16003,12,15,38,65,2021
2019_B16004,95,31,50,176,2019
2022_A16005,79,69,36,184,2019
2022_B16006,100,16,93,209,2019
2021_A16007,69,44,60,173,2021
2019_C16008,32,33,49,114,2021
2021_B16009,34,13,68,115,2022
2019_B16010,82,56,94,232,2022
2019_A16011,22,20,55,97,2021
2019_C16012,77,57,87,221,2021
2019_C16013,59,57,27,143,2021
2022_A16014,48,60,70,178,2019
2021_A16015,94,89,80,263,2022
2022_A16016,42,49,40,131,2022
2022_A16017,57,96,70,223,2019
2019_C16018,43,44,43,130,2021
2019_B16019,82,69,30,181,2021
2022_B16020,11,80,25,116,2019
2021_A16021,56,91,39,186,2019
2021_C16022,67,86,71,224,2021
2021_A16023,74,73,88,235,2019
2022_A16024,13,92,86,191,2019
2021_B16025,12,52,63,127,2021
2022_A16026,76,12,89,177,2019
2021_B16027,83,95,35,213,2022
2021_C16028,23,39,23,85,2019
2021_B16029,73,57,87,217,2022
2021_C16030,28,44,69,141,2019
2021_B16031,21,57,21,99,2019
2019_A16032,40,60,90,190,2019
2021_C16033,18,74,55,147,2021
2019_B16034,21,73,29,123,2019
2022_C16035,39,59,60,158,2022
2021_B16036,39,59,88,186,2021
2019_A16037,59,65,87,211,2021
2019_B16038,58,75,26,159,2021
2022_B16039,35,18,43,96,2019
2022_A16040,26,76,64,166,2021
2022_A16041,77,60,43,180,2019
2021_B16042,6,91,82,179,2019
2022_C16043,80,40,77,197,2019
2019_A16044,73,82,63,218,2019
2019_C16045,28,37,54,119,2021
2021_C16046,12,20,76,108,2022
2022_C16047,36,27,87,150,2019
2022_B16048,46,49,81,176,2021
2019_B16049,99,85,27,211,2019
2021_C16050,27,71,78,176,2022
2022_A16051,64,43,98,205,2021
2022_A16052,29,49,69,147,2022
2019_C16053,55,35,32,122,2021
2019_B16054,84,31,43,158,2019
2022_A16055,98,40,39,177,2022
2022_A16056,73,81,31,185,2021
2022_B16057,95,33,57,185,2021
2022_C16058,33,78,64,175,2019
2021_C16059,66,93,33,192,2019
2022_B16060,82,33,69,184,2022
2019_A16061,15,45,80,140,2021
2019_B16062,20,16,40,76,2019
2021_B16063,36,28,37,101,2019
2022_C16064,16,13,51,80,2019
2019_B16065,50,39,25,114,2019
2019_B16066,49,43,36,128,2022
2019_B16067,100,36,68,204,2022
2021_A16068,32,94,96,222,2022
2019_A16069,74,75,69,218,2022
2022_A16070,1,90,42,133,2021
2019_B16071,56,93,59,208,2022
2019_C16072,49,20,91,160,2021
2022_C16073,59,34,75,168,2021
2021_B16074,5,62,85,152,2019
2021_A16075,82,15,53,150,2021
2019_C16076,89,97,96,282,2022
2019_A16077,22,85,46,153,2019
2022_C16078,5,83,43,131,2022
2022_B16079,68,46,40,154,2022
2022_B16080,24,73,96,193,2022
2019_A16081,24,50,76,150,2019
2021_C16082,60,65,86,211,2021
2022_C16083,96,95,42,233,2019
2021_C16084,53,71,86,210,2019
2021_A16085,30,73,72,175,2022
2022_B16086,89,25,48,162,2021
2019_B16087,32,34,72,138,2021
2021_A16088,49,89,49,187,2019
2021_A16089,30,71,50,151,2019
2021_C16090,25,43,23,91,2021
2019_A16091,69,38,59,166,2021
2022_C16092,83,89,44,216,2022
2019_C16093,82,82,83,247,2022
2021_B16094,18,54,31,103,2019
2022_C16095,68,71,35,174,2022
2019_C16096,20,29,98,147,2021
2022_C16097,32,66,87,185,2021
2022_C16098,74,42,94,210,2019
2021_C16099,21,44,42,107,2022
2019_C16100,15,15,55,85,2019
2022_C16101,51,26,21,98,2021
2021_A16102,33,76,79,188,2022
2021_B16103,84,36,46,166,2022
2021_B16104,6,25,93,124,2019
2019_A16105,19,19,66,104,2022
2021_A16106,50,55,97,202,2021
2022_B16107,39,18,46,103,2021
2022_A16108,26,62,79,167,2021
2021_C16109,52,13,38,103,2019
2021_A16110,13,32,36,81,2019
2019_A16111,57,91,44,192,2022
2022_B16112,22,53,38,113,2021
2021_A16113,12,36,56,104,2022
2019_B16114,22,50,83,155,2022
2021_B16115,18,41,66,125,2019
2021_B16116,83,45,97,225,2019
2019_C16117,13,64,46,123,2019
2021_A16118,8,95,26,129,2022
2021_A16119,85,39,42,166,2021
2022_C16120,44,70,48,162,2019
2019_C16121,57,71,32,160,2022
2021_C16122,98,45,46,189,2022
2022_C16123,90,41,50,181,2021
2022_C16124,99,41,71,211,2022
2021_B16125,79,97,25,201,2021
2021_A16126,27,97,55,179,2019
2019_A16127,50,70,27,147,2022
2019_A16128,18,49,32,99,2019
2022_B16129,48,96,72,216,2021
2022_B16130,27,12,82,121,2022
2021_B16131,37,37,98,172,2019
2019_C16132,24,44,75,143,2022
2019_C16133,86,83,83,252,2019
2021_B16134,20,63,72,155,2022
2021_B16135,40,58,83,181,2019
2019_A16136,22,25,27,74,2022
2019_B16137,43,29,24,96,2019
2019_B16138,62,88,87,237,2022
2022_B16139,71,60,92,223,2021
2022_B16140,39,55,89,183,2021
2019_A16141,83,82,46,211,2022
2019_C16142,62,44,94,200,2021
2019_C16143,88,94,42,224,2019
2022_B16144,80,32,33,145,2021
2022_C16145,91,49,62,202,2019
2021_B16146,100,89,28,217,2021
2021_A16147,52,28,51,131,2019
2021_A16148,73,50,60,183,2019
2022_B16149,52,59,54,165,2022
2022_B16150,44,74,38,156,2019
2022_A16151,79,13,55,147,2021
2022_C16152,51,46,87,184,2022
2021_B16153,52,94,62,208,2022
2019_C16154,15,96,54,165,2022
2021_A16155,20,67,72,159,2021
2019_B16156,23,54,32,109,2021
2022_B16157,83,58,91,232,2019
2019_A16158,16,12,34,62,2021
2019_C16159,58,80,76,214,2021
2021_A16160,56,96,33,185,2021
2019_C16161,41,19,22,82,2021
2021_A16162,34,12,57,103,2021
2022_A16163,66,65,47,178,2022
2019_B16164,17,85,93,195,2021
2019_B16165,79,89,72,240,2022
2019_C16166,27,14,87,128,2022
2019_B16167,4,73,64,141,2021
2019_C16168,43,54,99,196,2021
2022_A16169,30,86,21,137,2019
2021_A16170,4,15,80,99,2022
2021_A16171,61,57,28,146,2021
2022_C16172,80,69,73,222,2022
2019_C16173,93,35,67,195,2019
2021_A16174,48,53,25,126,2019
2019_A16175,28,81,65,174,2021
2022_B16176,36,69,58,163,2019
2021_B16177,70,32,33,135,2019
2021_C16178,31,88,34,153,2019
2021_A16179,20,83,92,195,2019
2019_B16180,68,13,24,105,2019
2021_B16181,95,41,53,189,2021
2021_C16182,75,20,26,121,2022
2021_A16183,74,53,28,155,2019
2022_B16184,81,64,61,206,2022
2019_C16185,40,40,25,105,2022
2021_C16186,41,86,81,208,2022
2021_A16187,32,41,88,161,2021
2022_A16188,2,79,45,126,2019
2021_C16189,42,52,77,171,2019
2019_B16190,49,89,59,197,2019
2019_B16191,77,59,96,232,2019
2021_C16192,46,94,49,189,2019
2022_B16193,2,88,40,130,2019
2021_B16194,32,30,28,90,2022
2021_C16195,95,91,40,226,2021
2021_B16196,43,77,85,205,2022
2022_A16197,45,55,57,157,2021
2022_B16198,69,13,53,135,2022
2022_A16199,53,64,99,216,2022
2022_C16200,20,82,90,192,2019
2022_C16201,90,97,88,275,2021
2022_B16202,26,74,66,166,2019
2019_C16203,28,68,77,173,2022
2021_A16204,66,93,49,208,2019
2021_B16205,98,72,85,255,2019
2021_C16206,94,85,67,246,2019
2019_A16207,14,61,85,160,2022
2022_A16208,65,92,38,195,2019
2019_A16209,9,50,44,103,2022
2022_C16210,99,77,64,240,2022
2021_B16211,20,63,99,182,2019
2022_B16212,5,59,81,145,2021
2021_A16213,29,66,66,161,2019
2022_C16214,8,47,27,82,2022
2019_A16215,97,84,98,279,2022
2022_A16216,10,52,94,156,2022
2021_C16217,3,14,78,95,2022
2022_B16218,3,33,90,126,2019
2021_C16219,20,43,93,156,2021
2019_A16220,70,63,60,193,2019
2019_B16221,88,97,95,280,2022
2021_A16222,10,24,52,86,2021
2021_B16223,76,83,72,231,2019
2021_C16224,82,82,85,249,2022
2022_A16225,28,40,24,92,2021
2022_C16226,57,17,64,138,2022
2021_C16227,35,31,40,106,2019
2019_A16228,29,81,97,207,2021
2019_B16229,61,69,62,192,2021
2019_C16230,7,25,35,67,2022
2022_C16231,79,92,83,254,2021
2022_A16232,96,88,71,255,2022
2022_B16233,4,92,74,170,2019
2021_B16234,73,87,66,226,2019
2019_C16235,95,73,82,250,2019
2019_A16236,88,22,74,184,2019
2021_C16237,8,68,81,157,2021
2022_C16238,29,60,72,161,2021
2022_B16239,59,39,89,187,2019
2022_C16240,59,52,98,209,2019
2019_A16241,42,96,69,207,2022
2021_B16242,21,36,90,147,2021
2021_A16243,55,52,76,183,2019
2021_B16244,83,38,72,193,2021
2021_B16245,22,19,94,135,2022
2022_C16246,100,90,99,289,2022
2021_C16247,94,22,32,148,2019
2021_C16248,60,89,31,180,2019
2022_A16249,46,75,65,186,2022
2021_C16250,37,60,90,187,2021
2021_B16251,49,56,56,161,2021
2019_A11460,72,76,35,183,2021
2021_B11461,80,49,68,197,2022
2021_C11462,81,65,38,184,2021
2022_B11463,85,58,52,195,2019
2019_A11464,72,94,54,220,2022
2022_C11465,94,50,46,190,2021
2022_C11466,77,58,58,193,2022
2022_B11467,81,47,79,207,2022
2021_A11468,72,52,64,188,2019
2019_A11469,91,73,66,230,2021
2022_C11470,87,79,48,214,2019
2019_C11471,80,56,65,201,2021
2019_A11472,79,84,71,234,2022
2022_C11473,80,81,72,233,2019
2021_B11474,72,68,59,199,2021
2019_B11475,92,78,61,231,2019
2021_B11476,91,66,51,208,2022
2021_B11477,84,89,67,240,2021
2021_B11478,90,70,41,201,2019
2021_B11479,73,89,63,225,2019
2021_A11480,87,63,74,224,2022
2022_C11481,74,76,61,211,2019
2022_C11482,79,83,59,221,2019
2019_C11483,82,85,72,239,2019
2021_A11484,74,68,50,192,2019
2021_C11485,77,72,38,187,2021
2019_C11486,96,52,39,187,2019
2022_B11487,72,79,78,229,2022
2021_A11488,89,94,40,223,2019
2021_A11489,94,85,40,219,2022
2019_C11490,75,85,38,198,2022
2022_C11491,86,90,49,225,2019
2022_C11492,97,61,60,218,2022
2021_C11493,89,84,77,250,2021
2022_A11494,84,49,66,199,2019
2022_C11495,72,48,65,185,2021
2021_B11496,84,58,74,216,2021
2019_C11497,74,58,55,187,2021
2022_B11498,72,81,79,232,2022
2022_C11499,73,90,53,216,2021
2021_A11500,78,50,79,207,2019
2019_A11501,88,53,57,198,2022
2019_C11502,73,70,75,218,2021
2022_A11503,78,85,48,211,2022
2021_C11504,87,88,55,230,2019
2022_C11505,74,53,49,176,2022
2019_C11506,82,54,37,173,2021
2021_C11507,82,57,77,216,2021
2019_B11508,87,54,43,184,2019
2019_B11509,85,95,74,254,2019
2022_A11510,96,49,70,215,2019
2021_A11511,84,76,66,226,2019
2019_C11512,84,92,42,218,2022
2022_A11513,87,85,74,246,2022
2019_B11514,77,67,63,207,2021
2021_B11515,88,66,60,214,2021
2021_B11516,92,94,44,230,2019
2021_A11517,94,53,37,184,2021
2019_C11518,80,85,77,242,2022
2021_B11519,90,95,48,233,2021
2021_B11520,79,85,44,208,2022
2022_A11521,91,47,57,195,2021
2019_C11522,75,70,71,216,2022
2022_A11523,90,51,41,182,2022
2022_C11524,97,65,69,231,2021
2019_B11525,74,51,76,201,2019
2022_B11526,87,80,57,224,2019
2021_C11527,79,59,62,200,2022
2021_A11528,90,50,78,218,2019
2021_A11529,95,85,75,255,2022
2021_B11530,90,45,35,170,2021
2021_B11531,74,71,54,199,2022
2022_B11532,74,57,59,190,2021
2019_A11533,84,77,44,205,2022
2021_C11534,79,79,41,199,2021
2021_C11535,85,59,38,182,2021
2019_A11536,81,65,51,197,2019
2019_C11537,94,92,53,239,2021
2019_B11538,80,60,35,175,2021
2021_A11539,95,75,63,233,2022
2022_B11540,80,89,36,205,2019
2022_A11541,77,83,62,222,2021
2019_B11542,75,60,47,182,2021
2022_C11543,94,52,64,210,2019
2021_A11544,92,63,75,230,2021
2022_A11545,78,79,42,199,2021
2022_C11546,88,84,78,250,2019
2019_C11547,88,83,59,230,2019
2021_C11548,82,55,78,215,2022
2022_C11549,88,89,53,230,2021
2021_A11550,93,66,53,212,2021
2019_A11551,90,65,38,193,2021
2019_A11552,92,90,66,248,2022
2021_B11553,81,59,43,183,2021
2022_A11554,83,59,42,184,2021
2021_B11555,74,64,37,175,2022
2019_C11556,80,68,72,220,2021
2022_B11557,92,75,62,229,2022
2021_C11558,71,91,70,232,2019
2022_C11559,80,95,53,228,2019
2021_B11560,97,52,36,185,2021
2019_A11561,91,80,60,231,2021
2019_B11562,96,69,55,220,2021
2022_A11563,75,77,48,200,2019
2019_C11564,88,93,44,225,2022
2021_A11565,89,58,37,184,2021
2022_A11566,92,47,43,182,2019
2019_A11567,92,62,57,211,2019
2022_C11568,94,54,63,211,2021
2021_C11569,78,62,55,195,2019
2022_B11570,78,71,54,203,2019
2019_A11571,89,47,38,174,2021
2019_B11572,73,60,59,192,2022
2021_A11573,71,65,74,210,2022
2021_A11574,73,86,73,232,2019
2021_B11575,97,96,46,239,2022
2021_A11576,75,64,74,213,2022
2022_A11577,74,80,65,219,2019
2019_A11578,83,73,39,195,2019
2019_A11579,89,66,62,217,2019
2021_A11580,72,72,61,205,2021
2019_B11581,80,52,79,211,2022
2022_B11582,72,87,70,229,2021
2019_A11583,92,50,66,208,2021
2022_B11584,88,68,47,203,2022
2022_A11585,89,86,37,212,2019
2021_B11586,91,48,76,215,2022
2022_C11587,89,55,69,213,2021
2022_C11588,86,53,73,212,2022
2021_A11589,93,46,41,180,2022
2022_B11590,87,77,72,236,2022
2019_C11591,76,55,36,167,2022
2022_B11592,86,66,42,194,2021
2021_A11593,81,76,71,228,2022
2019_C11594,82,76,75,233,2019
2022_B11595,97,67,43,207,2019
2022_C11596,73,48,55,176,2022
2019_B11597,81,88,77,246,2021
2021_A11598,81,85,35,201,2022
2019_B11599,84,57,56,197,2019
2022_A11600,96,69,47,212,2022
2019_A11601,81,95,66,242,2019
2019_A11602,91,52,45,188,2019
2022_C11603,91,68,61,220,2019
2019_C11604,81,90,61,232,2021
2022_A11605,97,73,66,236,2019
2021_B11606,93,86,70,249,2019
2021_B11607,91,90,36,217,2021
2021_A11608,71,62,71,204,2022
2019_A11609,77,60,59,196,2021
2022_B11610,97,61,71,229,2022
2019_B11611,92,54,77,223,2021
2019_A11612,94,47,51,192,2019
2022_A11613,78,87,46,211,2021
2022_A11614,74,79,68,221,2019
2022_B11615,85,70,78,233,2019
2022_B11616,85,88,50,223,2022
2019_A11617,96,83,44,223,2019
2019_B11618,77,62,43,182,2021
2021_B11619,81,82,60,223,2022
2021_A11620,71,57,62,190,2019
2021_A11621,95,78,56,229,2022
2019_C11622,75,86,46,207,2022
2022_A11623,93,60,37,190,2022
2022_B11624,74,57,59,190,2019
2022_C11625,86,49,44,179,2021
2022_C11626,97,46,47,190,2021
2021_A11627,89,91,41,221,2019
2019_B11628,87,65,60,212,2022
2021_C11629,80,47,56,183,2021
2019_B11630,71,51,56,178,2022
2021_B11631,83,49,45,177,2021
2021_B11632,90,89,66,245,2022
2019_A11633,79,52,67,198,2019
2021_B11634,78,79,69,226,2019
2022_C11635,90,51,43,184,2021
2019_A11636,87,90,61,238,2021
2022_B11637,97,73,35,205,2021
2022_A11638,93,51,37,181,2021
2019_B11639,95,96,59,250,2019
2021_B11640,93,68,46,207,2019
2021_C11641,80,75,42,197,2021
2022_C11642,89,56,64,209,2019
2022_C11643,89,60,77,226,2019
2021_B11644,75,80,60,215,2021
2021_A11645,78,68,37,183,2021
2022_A11646,83,47,53,183,2019
2022_C11647,72,49,70,191,2022
2021_A11648,91,55,77,223,2022
2022_B11649,92,47,53,192,2022
2022_B11650,75,51,56,182,2022
2019_A11651,89,47,51,187,2022
2021_B11652,92,55,36,183,2021
2019_B11653,89,59,72,220,2021
2022_B11654,94,71,79,244,2022
2021_B11655,93,90,46,229,2021
2019_B11656,77,79,56,212,2022
2022_B11657,74,73,61,208,2019
2021_C11658,88,81,36,205,2019
2022_B11659,94,67,59,220,2022
2021_A11660,93,64,49,206,2019
2019_B11661,85,88,48,221,2021
2019_A11662,93,89,75,257,2019
2021_B11663,90,90,47,227,2019
2021_B11664,74,68,45,187,2021
2019_B11665,91,90,73,254,2019
2019_B11666,75,80,61,216,2022
2019_A11667,97,61,70,228,2022
2019_C11668,97,51,77,225,2019
2021_B11669,84,56,59,199,2022
2019_B11670,96,81,66,243,2022
2022_B11671,90,92,43,225,2019
2019_C11672,79,49,59,187,2022
2022_A11673,97,83,76,256,2022
2022_A11674,82,91,69,242,2022
2019_B11675,91,54,50,195,2019
2022_C11676,97,63,39,199,2022
2022_B11677,82,47,59,188,2019
2019_B11678,72,51,38,161,2021
2021_A11679,94,70,40,204,2019
2019_C11680,72,80,54,206,2019
2022_B11681,92,74,41,207,2021
2019_B11682,77,54,78,209,2021
2021_B11683,78,56,76,210,2021
2019_A11684,81,49,39,169,2021
2021_B11685,74,85,45,204,2019
2022_C11686,83,89,70,242,2021
2019_C11687,84,75,77,236,2019
2019_A11688,87,68,52,207,2022
2019_A11689,93,60,58,211,2019
2021_B11690,71,60,75,206,2019
2019_C11691,71,78,45,194,2021
2021_A11692,95,58,42,195,2022
2021_C11693,73,53,65,191,2021
2021_B11694,72,67,74,213,2021
2019_C11695,73,61,38,172,2021
2022_A11696,92,88,74,254,2019
2022_C11697,97,70,64,231,2019
2019_C11698,85,47,72,204,2021
2022_B11699,76,80,79,235,2022
2021_B11700,82,64,43,189,2022
2019_C11701,94,53,71,218,2019
2021_A11702,76,92,75,243,2021
2021_A11703,93,87,46,226,2019
2022_C11704,87,90,35,212,2021
2019_C11705,88,56,49,193,2021
2019_B11706,76,65,66,207,2022
2021_A11707,82,93,56,231,2022
2022_A11708,76,48,70,194,2022
2021_B11709,88,92,69,249,2019
2019_C11710,88,45,77,210,2022
2022_A11711,97,66,47,210,2019
2022_C11712,95,80,76,251,2021
2021_A11713,89,91,49,229,2021
2022_A11714,78,55,51,184,2022
2021_A11715,78,71,55,204,2019
2022_B11716,85,54,62,201,2021
2019_B11717,94,49,47,190,2022
2019_A11718,77,62,79,218,2021
2022_C11719,82,75,49,206,2021
2021_B11720,72,63,69,204,2022
2022_B11721,97,53,44,194,2019
2019_B11722,77,88,60,225,2021
2019_C11723,75,46,61,182,2019
2019_C11724,92,88,62,242,2019
2021_C11725,77,90,41,208,2021
2022_B11726,77,50,61,188,2022
2022_C11727,71,93,70,234,2019
2021_B11728,75,91,65,231,2019
2021_A11729,79,70,45,194,2022
2022_A11730,75,72,59,206,2021
2021_A11731,87,75,66,228,2019
2019_C11732,95,74,53,222,2021
2021_B11733,83,78,74,235,2021
2019_C11734,90,69,51,210,2022
2021_C11735,85,85,50,220,2022
2021_B11736,72,83,53,208,2022
2022_B11737,92,90,39,221,2021
2019_B11738,76,80,64,220,2021
2022_B11739,72,86,49,207,2021
2022_C11740,76,49,37,162,2022
2022_C11741,88,80,62,230,2021
2021_C11742,84,49,38,171,2019
2021_A11743,94,52,39,185,2021
2021_B11744,93,83,78,254,2022
2019_C11745,78,72,75,225,2022
2021_B11746,94,54,70,218,2021
2021_C11747,75,62,55,192,2022
2021_C11748,72,75,35,182,2022
2019_B11749,84,68,70,222,2019
2022_B11750,73,58,41,172,2021
2021_A11751,84,91,50,225,2019
2021_A11752,79,80,47,206,2019
2019_C11753,81,66,72,219,2019
2021_A11754,71,47,73,191,2021
2022_B11755,82,83,67,232,2022
2019_C11756,96,75,69,240,2022
2019_C11757,91,64,57,212,2022
2022_A11758,77,63,76,216,2021
2022_A11759,80,70,37,187,2022
2022_A11760,89,58,51,198,2019
2021_B11761,83,91,60,234,2019
2021_A11762,91,57,60,208,2022
2019_A11763,73,71,49,193,2022
2019_A11764,77,71,71,219,2022
2019_A11765,78,70,47,195,2021
2022_A11766,82,62,69,213,2019
2021_A11767,85,47,41,173,2019
2021_B11768,73,76,78,227,2022
2021_A11769,81,80,71,232,2021
2022_B11770,80,89,72,241,2019
2019_A11771,97,87,46,230,2022
2021_A11772,82,47,74,203,2022
2022_B11773,71,86,60,217,2022
2021_A11774,79,84,73,236,2019
2019_B11775,73,55,72,200,2022
2022_C11776,93,62,43,198,2022
2022_B11777,97,88,79,264,2021
2019_B11778,78,53,76,207,2021
2021_B11779,89,82,45,216,2019
2021_B11780,96,90,63,249,2019
2021_A11781,79,55,58,192,2021
2022_C11782,81,67,35,183,2022
2019_A11783,97,69,79,245,2022
2022_B11784,75,46,55,176,2019
2022_A11785,91,93,76,260,2022
2022_B11786,87,55,55,197,2022
2019_A11787,95,71,62,228,2021
2021_A11788,79,89,45,213,2021
2021_B11789,82,49,38,169,2019
2019_C11790,94,67,37,198,2019
2019_A11791,80,69,60,209,2021
2022_A11792,81,58,58,197,2022
2022_A11793,87,47,54,188,2021
2019_C11794,94,92,62,248,2021
2022_C11795,84,69,47,200,2022
2019_A11796,87,82,59,228,2019
2019_C11797,74,51,52,177,2019
2022_C11798,89,65,66,220,2019
2021_B11799,86,53,49,188,2021
2022_C11800,76,55,78,209,2022
2021_B11801,76,78,40,194,2021
2021_A11802,85,73,43,201,2021
2021_B11803,76,64,76,216,2019
2021_C11804,82,53,40,175,2022
2022_B11805,82,66,63,211,2022
2022_A11806,81,68,53,202,2022
2019_C11807,71,90,60,221,2019
2021_A11808,87,52,78,217,2022
2022_C11809,93,65,42,200,2021
2021_B11810,84,76,79,239,2021
2019_B11811,81,47,56,184,2021
2021_B11812,79,80,59,218,2019
2019_C11813,94,64,66,224,2021
2021_B11814,97,76,50,223,2021
2022_A11815,92,88,72,252,2019
2021_C11816,80,61,40,181,2021
2021_A11817,78,79,65,222,2019
2022_C11818,84,81,72,237,2022
2019_B11819,87,70,44,201,2019
2019_C11820,97,81,52,230,2021
2021_A11821,89,60,79,228,2019
2021_B11822,94,79,73,246,2019
2022_B11823,91,77,45,213,2021
2019_B11824,87,78,71,236,2022
2021_B11825,79,56,62,197,2021
2022_A11826,90,94,70,254,2022
2022_C11827,83,61,68,212,2019
2022_B11828,81,74,54,209,2019
2022_A11829,90,55,53,198,2021
2022_A11830,80,57,48,185,2022
2019_A11831,86,91,50,227,2022
2021_C11832,74,51,47,172,2021
2021_A11833,80,66,51,197,2021
2021_B11834,81,50,40,171,2019
2021_C11835,74,78,63,215,2021
2019_C11836,77,79,35,191,2021
2022_A11837,74,48,67,189,2019
2022_C11838,73,87,38,198,2021
2021_C11839,82,69,57,208,2019
2022_B11840,95,76,70,241,2022
2021_A11841,75,53,78,206,2022
2021_B11842,80,72,54,206,2021
2019_B11843,89,70,52,211,2021
2022_C11844,80,54,40,174,2019
2022_C11845,96,45,60,201,2021
2022_B11846,73,73,41,187,2019
2019_B11847,85,47,42,174,2022
2022_B11848,81,70,57,208,2022
2022_C11849,78,81,44,203,2021
2019_C11850,95,51,58,204,2022
2019_B11851,77,73,57,207,2022
2022_B11852,94,65,60,219,2021
2021_C11853,84,64,46,194,2022
2021_B11854,86,79,53,218,2021
2022_B11855,78,71,69,218,2019
2022_C11856,72,46,58,176,2019
2022_A11857,72,45,42,159,2021
2021_C11858,94,45,54,193,2022
2019_B11859,95,90,38,223,2021
2021_A11860,77,63,50,190,2019
2019_A11861,81,80,46,207,2021
2019_A11862,76,51,70,197,2019
2022_A11863,76,76,60,212,2019
2019_B11864,89,76,59,224,2021
2021_A11865,90,76,43,209,2019
2021_C11866,77,76,62,215,2022
2022_B11867,72,50,70,192,2019
2019_B11868,81,84,49,214,2021
2021_C11869,75,56,78,209,2019
2021_A11870,86,81,41,208,2021
2022_B11871,75,66,61,202,2022
2022_B11872,96,55,35,186,2022
2019_C11873,96,65,35,196,2021
2019_B11874,80,86,54,220,2022
2019_C11875,94,68,52,214,2021
2022_B11876,81,56,64,201,2022
2021_C11877,91,47,60,198,2021
2019_C11878,80,86,41,207,2021
2021_A11879,82,90,41,213,2022
2019_C11880,90,68,45,203,2021
2019_A11881,71,51,47,169,2019
2021_A11882,93,77,38,208,2021
2019_B11883,83,79,68,230,2022
2019_C11884,73,70,45,188,2022
2019_C11885,85,92,41,218,2022
2022_C11886,91,53,62,206,2021
2021_B11887,76,85,47,208,2019
2019_B11888,72,84,69,225,2019
2021_C11889,83,53,64,200,2022
2022_C11890,85,62,67,214,2019
2021_A11891,72,75,55,202,2021
2021_C11892,83,63,55,201,2022
2019_C11893,85,68,73,226,2022
2022_B11894,95,77,69,241,2021
2022_C11895,93,69,71,233,2019
2022_B11896,86,82,39,207,2019
2022_B11897,80,82,43,205,2022
2022_A11898,84,84,72,240,2022
2019_A11899,76,77,72,225,2019
2022_A11900,87,95,47,229,2022
2019_B11901,71,47,35,153,2019
2019_A11902,83,51,42,176,2021
2019_B11903,84,67,77,228,2019
2022_B11904,90,91,59,240,2021
2022_C11905,83,68,42,193,2021
2021_C11906,88,67,49,204,2022
2022_C11907,73,95,75,243,2019
2021_A11908,88,45,74,207,2019
2022_A11909,85,48,64,197,2019
2019_A11910,85,65,62,212,2022
2021_A11911,87,50,74,211,2022
2019_A11912,72,94,68,234,2021
2022_B11913,79,89,42,210,2021
2019_A11914,84,78,37,199,2021
2022_A11915,82,89,56,227,2019
2021_B11916,90,57,48,195,2022
2021_B11917,93,92,47,232,2019
2019_C11918,75,62,78,215,2021
2021_A11919,78,54,58,190,2022
2022_B11920,94,73,49,216,2022
2021_C11921,89,92,52,233,2019
2021_C11922,71,54,54,179,2019
2019_B11923,93,48,36,177,2022
2022_C11924,90,73,55,218,2021
2019_C11925,95,50,41,186,2021
2019_B11926,75,73,36,184,2021
2021_B11927,79,85,37,201,2021
2022_B11928,94,48,63,205,2019
2022_C11929,97,70,65,232,2019
2021_B11930,80,63,66,209,2022
2021_B11931,82,91,64,237,2022
2019_C11932,79,82,43,204,2021
2021_B11933,92,45,64,201,2022
2019_C11934,77,60,73,210,2021
2022_A11935,83,81,62,226,2022
2022_A11936,85,48,35,168,2021
2021_B11937,74,50,64,188,2022
2021_C11938,85,78,78,241,2019
2019_A11939,96,68,45,209,2021
2022_C11940,88,53,44,185,2019
2021_B11941,81,90,43,214,2021
2021_B11942,93,63,51,207,2019
2022_B11943,76,94,79,249,2022
2019_B11944,93,77,36,206,2021
2021_B11945,96,60,60,216,2021
2021_A11946,77,63,44,184,2021
2019_A11947,81,68,69,218,2021
2021_C11948,79,61,39,179,2019
2019_C11949,78,89,65,232,2022
2022_C11950,81,56,78,215,2022
2019_C11951,76,57,59,192,2022
2021_A11952,95,60,42,197,2021
2019_B11953,90,72,49,211,2019
2022_B11954,89,95,64,248,2021
2022_C11955,83,57,76,216,2019
2022_B11956,90,93,67,250,2019
2019_B11957,80,75,36,191,2019
2021_C11958,71,81,36,188,2019
2021_B11959,76,85,49,210,2022
2019_C11960,72,66,40,178,2019
2022_A11961,79,53,43,175,2022
2021_A11962,84,52,72,208,2019
2022_A11963,75,90,52,217,2021
2021_A11964,77,86,76,239,2021
2022_B11965,95,81,37,213,2019
2019_B11966,97,73,70,240,2022
2019_C11967,82,51,49,182,2019
2019_A11968,79,51,55,185,2019
2022_A11969,72,53,65,190,2021
2022_B11970,72,46,38,156,2021
2019_C11971,76,92,43,211,2022
2021_C11972,77,59,35,171,2022
2019_B11973,93,78,40,211,2022
2022_B11974,88,52,67,207,2019
2022_A11975,88,80,62,230,2022
2021_C11976,79,73,57,209,2021
2021_C11977,82,48,36,166,2019
2021_C11978,91,95,63,249,2019
2021_A11979,79,83,37,199,2022
2021_A11980,79,83,53,215,2022
2022_A11981,95,47,43,185,2022
2022_C11982,93,66,71,230,2019
2021_B11983,94,94,61,249,2019
2022_C11984,72,93,37,202,2022
2021_C11985,78,94,76,248,2021
2021_C11986,90,80,73,243,2021
2021_C11987,94,55,70,219,2021
2022_A11988,82,48,47,177,2021
2021_C11989,77,65,49,191,2022
2022_A11990,92,52,73,217,2022
2019_B11991,82,73,50,205,2019
2022_A11992,96,61,74,231,2022
2019_B11993,91,80,59,230,2021
2022_B11994,82,52,67,201,2019
2022_C11995,77,70,35,182,2019
2019_A11996,88,81,38,207,2019
2019_B11997,72,77,35,184,2021
2021_B11998,90,87,68,245,2022
2021_A11999,95,66,43,204,2022
2019_C12000,71,80,75,226,2022
2019_A12001,72,62,69,203,2021
2022_C12002,87,58,56,201,2022
2021_A12003,80,80,43,203,2021
2022_C12004,95,65,47,207,2019
2022_C12005,79,90,79,248,2021
2019_B12006,86,89,58,233,2022
2022_A12007,95,74,75,244,2019
2019_B12008,77,82,36,195,2021
2022_B12009,85,94,45,224,2022
2019_B12010,97,92,55,244,2022
2021_A12011,85,92,48,225,2022
2019_B12012,73,85,67,225,2021
2021_A12013,86,95,70,251,2022
2022_B12014,91,67,72,230,2019
2019_C12015,84,51,76,211,2022
2021_C12016,78,72,57,207,2019
2019_A12017,74,45,50,169,2019
2019_B12018,76,67,62,205,2019
2022_B12019,72,71,73,216,2022
2021_B12020,97,96,54,247,2022
2021_A12021,81,47,68,196,2019
2019_B12022,90,89,58,237,2021
2021_A12023,85,96,41,222,2021
2021_A12024,95,93,49,237,2022
2021_A12025,91,77,61,229,2019
2022_C12026,81,46,50,177,2022
2021_B12027,93,84,65,242,2021
2021_A12028,97,86,65,248,2021
2021_A12029,82,57,50,189,2021
2019_C12030,82,71,66,219,2019
2019_B12031,86,92,75,253,2019
2021_B12032,87,57,36,180,2021
2019_B12033,74,57,60,191,2021
2019_B12034,80,78,79,237,2021
2019_C12035,94,79,56,229,2019
2021_B12036,83,75,41,199,2019
2021_B12037,78,54,61,193,2019
2019_C12038,81,49,53,183,2019
2019_B12039,73,57,74,204,2021
2019_A12040,93,81,68,242,2019
2022_B12041,71,64,64,199,2022
2021_B12042,79,58,49,186,2019
2021_B12043,90,94,75,259,2019
2021_B12044,81,58,61,200,2021
2019_C12045,91,50,53,194,2022
2019_C12046,90,73,50,213,2019
2019_B12047,72,86,76,234,2021
2021_C12048,77,74,43,194,2022
2022_B12049,87,89,75,251,2021
2022_A12050,71,50,73,194,2022
2022_C12051,75,76,67,218,2019
2022_A12052,72,66,79,217,2019
2019_C12053,72,83,65,220,2021
2019_A12054,75,76,35,186,2022
2022_A12055,89,91,61,241,2021
2021_A12056,81,70,54,205,2022
2021_C12057,84,95,76,255,2019
2022_C12058,87,94,55,236,2021
2019_A12059,95,59,46,200,2021
2019_C12060,88,68,40,196,2021
2022_C12061,86,57,71,214,2022
2021_A12062,73,80,69,222,2021
2021_C12063,79,73,59,211,2021
2019_B12064,75,46,65,186,2021
2021_B12065,96,86,79,261,2021
2021_C12066,86,75,38,199,2022
2021_C12067,94,74,77,245,2022
2021_B12068,92,72,35,199,2021
2022_C12069,77,60,49,186,2021
2021_A12070,84,47,72,203,2019
2019_C12071,82,67,56,205,2021
2022_C12072,97,55,40,192,2019
2019_A12073,88,60,36,184,2019
2022_A12074,71,77,39,187,2019
2019_C12075,82,88,56,226,2021
2019_B12076,77,93,36,206,2022
2019_C12077,73,76,65,214,2021
2021_A12078,95,77,38,210,2021
2022_B12079,80,95,71,246,2022
2022_A12080,84,96,51,231,2021
2022_C12081,88,88,74,250,2022
2019_C12082,95,86,42,223,2019
2021_B12083,73,56,51,180,2022
2022_C12084,81,54,53,188,2021
2022_A12085,91,79,57,227,2022
2021_C12086,94,86,54,234,2021
2019_C12087,93,78,51,222,2022
2022_A12088,95,45,69,209,2019
2021_A12089,71,76,52,199,2022
2021_A12090,85,67,71,223,2019
2021_B12091,75,60,48,183,2021
2021_C12092,71,72,40,183,2022
2021_A12093,78,58,43,179,2021
2021_A12094,91,49,58,198,2019
2021_C12095,79,72,63,214,2021
2022_C12096,84,67,48,199,2019
2019_B12097,93,94,66,253,2022
2022_C12098,78,72,62,212,2022
2019_C12099,82,50,50,182,2022
2021_B12100,74,62,38,174,2021
2021_B12101,92,75,46,213,2022
2019_A12102,93,45,42,180,2021
2021_A12103,74,81,52,207,2019
2019_A12104,95,61,76,232,2022
2022_B12105,73,82,60,215,2021
2022_B12106,87,86,68,241,2022
2021_C12107,79,53,38,170,2019
2021_B12108,90,63,46,199,2019
2021_B12109,82,68,56,206,2019
2022_B12110,75,72,43,190,2019
2021_B12111,95,81,49,225,2022
2021_A12112,93,50,47,190,2022
2022_C12113,84,69,67,220,2021
2022_A12114,78,96,61,235,2021
2019_B12115,77,48,39,164,2019
2019_C12116,81,54,77,212,2021
2019_C12117,80,60,58,198,2021
2019_A12118,87,53,42,182,2021
2021_B12119,85,58,48,191,2019
2019_A12120,86,81,46,213,2019
2019_A12121,89,68,60,217,2022
2019_A12122,88,78,66,232,2019
2022_A12123,77,76,53,206,2022
2021_C12124,89,57,41,187,2021
2022_A12125,93,46,79,218,2019
2021_A12126,79,68,49,196,2021
2019_B12127,76,60,79,215,2021
2022_C12128,83,49,57,189,2019
2021_B12129,82,76,61,219,2022
2021_A12130,93,89,77,259,2021
2021_B12131,85,86,35,206,2019
2021_B12132,73,71,48,192,2021
2022_A12133,97,95,78,270,2022
2021_B12134,81,71,69,221,2021
2021_B12135,77,60,71,208,2019
2019_C12136,74,52,54,180,2022
2019_A12137,94,76,68,238,2022
2019_C12138,81,62,70,213,2021
2019_B12139,85,67,63,215,2022
2019_A12140,92,87,49,228,2022
2022_C12141,77,71,68,216,2019
2022_C12142,85,95,75,255,2022
2021_B12143,83,51,54,188,2022
2022_A12144,94,53,43,190,2021
2022_A12145,88,57,79,224,2019
2021_B12146,86,54,75,215,2021
2022_C12147,80,71,73,224,2022
2022_C12148,87,85,68,240,2021
2021_C12149,92,89,74,255,2022
2019_C12150,84,92,41,217,2019
2021_C12151,94,85,35,214,2019
2021_C12152,75,73,58,206,2022
2022_A12153,80,82,50,212,2021
2021_A12154,76,92,52,220,2019
2019_C12155,86,63,63,212,2021
2019_C12156,83,93,79,255,2022
2022_C12157,92,48,71,211,2021
2019_A12158,86,60,74,220,2019
2019_C12159,75,49,37,161,2022
2019_C12160,82,50,46,178,2022
2021_A12161,87,70,75,232,2019
2019_A12162,79,82,59,220,2022
2022_C12163,87,79,76,242,2019
2022_A12164,79,69,37,185,2021
2021_A12165,83,72,36,191,2022
2019_C12166,83,58,79,220,2021
2022_B12167,73,48,78,199,2022
2022_B12168,77,74,67,218,2022
2022_A12169,91,54,77,222,2021
2019_A12170,84,92,79,255,2021
2022_B12171,73,62,62,197,2019
2019_C12172,76,95,35,206,2021
2022_B12173,81,70,57,208,2021
2019_A12174,83,79,68,230,2019
2022_A12175,91,90,65,246,2022
2019_C12176,88,86,48,222,2021
2019_B12177,75,80,79,234,2021
2021_C12178,95,49,48,192,2021
2019_B12179,78,60,40,178,2021
2022_C12180,86,49,56,191,2021
2019_A12181,88,49,71,208,2021
2022_B12182,81,54,61,196,2019
2022_C12183,76,48,58,182,2019
2019_A12184,93,57,76,226,2021
2019_B12185,92,51,66,209,2019
2021_B12186,87,65,69,221,2021
2021_A12187,80,45,51,176,2019
2021_A12188,79,86,75,240,2019
2021_A12189,73,60,42,175,2019
2019_B12190,81,83,71,235,2022
2019_C12191,88,71,43,202,2019
2021_B12192,73,75,66,214,2021
2021_C12193,89,94,41,224,2019
2019_A12194,72,75,35,182,2022
2019_A12195,79,60,53,192,2022
2019_B12196,89,47,58,194,2022
2022_B12197,90,67,73,230,2022
2022_C12198,81,54,72,207,2022
2022_C12199,88,65,74,227,2022
2022_B12200,77,94,55,226,2021
2019_B12201,72,93,43,208,2022
2021_A12202,85,88,76,249,2021
2021_C12203,89,54,41,184,2019
2019_A12204,76,87,43,206,2021
2021_C12205,81,89,68,238,2022
2022_A12206,78,87,76,241,2021
2022_B12207,85,57,35,177,2022
2021_C12208,78,79,72,229,2021
2021_A12209,93,81,49,223,2021
2021_B12210,76,55,59,190,2022
2022_B12211,89,60,72,221,2021
2019_B12212,93,58,61,212,2019
2019_B12213,87,57,65,209,2022
2022_B12214,78,94,40,212,2019
2021_A12215,92,82,36,210,2021
2022_C12216,93,56,64,213,2019
2022_B12217,78,56,60,194,2021
2021_B12218,75,90,40,205,2019
2019_B12219,89,76,60,225,2022
2019_A12220,87,67,72,226,2021
2021_C12221,93,47,59,199,2021
2019_B12222,71,63,72,206,2019
2022_A12223,90,54,39,183,2019
2022_C12224,73,71,44,188,2022
2022_A12225,76,45,40,161,2021
2022_A12226,71,63,41,175,2019
2019_A12227,95,69,38,202,2022
2021_A12228,89,90,70,249,2019
2022_A12229,72,95,49,216,2019
2021_A12230,80,79,64,223,2022
2019_A12231,72,58,67,197,2021
2022_C12232,89,91,42,222,2021
2021_A12233,85,85,67,237,2021
2021_A12234,81,88,77,246,2022
2022_B12235,76,89,65,230,2019
2021_A12236,89,93,45,227,2019
2022_B12237,91,60,63,214,2019
2022_A12238,83,62,47,192,2019
2021_B12239,77,50,47,174,2022
2022_B12240,85,71,65,221,2021
2019_B12241,73,77,72,222,2022
2019_C12242,86,65,43,194,2021
2021_A12243,76,88,70,234,2019
2022_A12244,84,74,63,221,2021
2022_C12245,84,65,41,190,2019
2022_B12246,90,82,67,239,2019
2022_B12247,78,80,79,237,2022
2021_B12248,77,53,36,166,2021
2019_A12249,74,61,48,183,2022
2022_B12250,83,80,53,216,2019
2022_B12251,79,77,42,198,2021
2021_B12252,79,94,46,219,2021
2019_C12253,85,58,65,208,2022
2022_C12254,79,45,71,195,2019
2019_B12255,72,66,66,204,2022
2021_C12256,93,59,51,203,2021
2019_B12257,75,89,61,225,2021
2022_A12258,72,91,50,213,2019
2021_B12259,87,66,67,220,2022
2019_B12260,74,57,61,192,2021
2021_B12261,80,72,63,215,2022
2019_A12262,83,92,57,232,2022
2019_B12263,73,89,71,233,2021
2019_C12264,80,76,52,208,2019
2019_C12265,91,49,59,199,2019
2022_B12266,78,53,46,177,2021
2019_B12267,91,93,43,227,2022
2019_A12268,86,70,71,227,2022
2019_C12269,90,45,77,212,2019
2019_B12270,89,78,76,243,2022
2019_A12271,97,67,72,236,2019
2019_A12272,72,61,61,194,2021
2022_B12273,79,87,45,211,2022
2022_B12274,90,52,76,218,2022
2019_C12275,90,46,42,178,2021
2022_B12276,96,53,59,208,2022
2022_B12277,95,78,43,216,2019
2021_C12278,81,85,70,236,2019
2019_B12279,85,81,44,210,2021
2022_C12280,83,68,35,186,2021
2022_C12281,77,53,46,176,2019
2022_B12282,92,88,43,223,2022
2021_C12283,77,84,46,207,2019
2021_A12284,95,61,44,200,2019
2019_C12285,83,45,66,194,2019
2022_A12286,92,50,43,185,2021
2022_C12287,86,54,59,199,2021
2021_A12288,92,54,73,219,2019
2019_C12289,72,52,74,198,2019
2022_A12290,76,69,37,182,2019
2019_A12291,95,58,64,217,2019
2022_B12292,84,74,65,223,2022
2022_A12293,77,96,63,236,2022
2019_C12294,84,78,51,213,2021
2022_C12295,95,68,68,231,2019
2022_A12296,92,69,69,230,2019
2019_A12297,73,48,72,193,2019
2021_A12298,79,75,53,207,2021
2021_B12299,77,54,68,199,2019
2022_C12300,74,49,71,194,2019
2022_C12301,96,65,59,220,2019
2019_B12302,87,80,66,233,2022
2019_A12303,73,92,53,218,2019
2019_C12304,97,63,73,233,2022
2021_C12305,84,55,53,192,2019
2022_C12306,74,67,40,181,2021
2019_C12307,91,70,78,239,2021
2019_A12308,90,73,73,236,2021
2019_A12309,71,47,53,171,2019
2019_B12310,93,92,60,245,2021
2019_C12311,79,94,76,249,2019
2022_B12312,94,78,35,207,2019
2022_B12313,75,50,79,204,2022
2019_B12314,80,93,55,228,2019
2022_C12315,97,85,44,226,2022
2022_C12316,84,72,37,193,2021
2021_A12317,75,74,70,219,2019
2022_A12318,88,58,50,196,2019
2019_B12319,78,49,74,201,2019
2022_C12320,77,52,60,189,2021
2019_A12321,85,81,77,243,2022
2019_A12322,77,96,68,241,2022
2019_B12323,85,47,46,178,2022
2019_B12324,97,49,36,182,2019
2019_C12325,74,86,75,235,2021
2019_A12326,88,54,36,178,2021
2022_B12327,97,87,75,259,2021
2019_B12328,96,81,55,232,2019
2022_A12329,82,76,59,217,2019
2022_C12330,95,81,62,238,2019
2022_B12331,81,59,61,201,2022
2022_A12332,82,86,74,242,2022
2021_B12333,89,69,59,217,2019
2019_C12334,94,65,35,194,2019
2021_B12335,94,64,43,201,2021
2022_C12336,91,83,62,236,2022
2019_C12337,90,86,41,217,2022
2019_B12338,95,72,41,208,2019
2021_C12339,79,83,40,202,2022
2019_C12340,75,66,67,208,2021
2019_C12341,82,71,51,204,2022
2021_A12342,72,72,63,207,2019
2019_A12343,97,90,45,232,2021
2022_A12344,85,52,43,180,2022
2022_A12345,75,67,59,201,2021
2019_B12346,94,54,45,193,2021
2019_A12347,91,90,59,240,2022
2021_C12348,92,75,47,214,2019
2021_A12349,89,75,79,243,2019
2019_A12350,77,67,61,205,2019
2021_C12351,74,62,66,202,2021
2022_B12352,95,80,78,253,2021
2022_A12353,84,54,64,202,2021
2022_A12354,82,77,48,207,2022
2021_B12355,74,90,58,222,2019
2021_A12356,76,63,52,191,2021
2019_A12357,78,72,59,209,2022
2019_A12358,93,84,56,233,2019
2022_C12359,93,73,53,219,2019
2021_C12360,75,75,47,197,2021
2021_A12361,87,85,59,231,2019
2021_B12362,91,64,55,210,2022
2021_C12363,73,74,52,199,2021
2019_A12364,81,54,35,170,2019
2022_A12365,84,52,47,183,2019
2022_A12366,77,81,42,200,2019
2019_A12367,93,55,69,217,2019
2021_A12368,88,69,72,229,2021
2022_A12369,96,49,74,219,2019
2019_C12370,72,71,67,210,2022
2021_C12371,78,59,73,210,2022
2019_C12372,76,92,59,227,2021
2019_A12373,73,81,75,229,2021
2022_B12374,83,71,65,219,2021
2022_C12375,81,93,71,245,2019
2021_A12376,74,90,46,210,2019
2021_B12377,93,73,45,211,2019
2021_B12378,72,69,48,189,2022
2019_A12379,76,81,48,205,2022
2019_A12380,96,93,44,233,2021
2021_A12381,87,89,55,231,2021
2022_B12382,80,47,78,205,2021
2022_A12383,83,83,49,215,2022
2021_A12384,85,57,54,196,2019
2019_A12385,82,75,79,236,2021
2021_A12386,77,92,59,228,2022
2019_A12387,77,91,45,213,2022
2021_C12388,86,89,61,236,2021
2019_A12389,72,83,47,202,2019
2021_C12390,94,46,73,213,2019
2019_C12391,75,73,57,205,2022
2022_C12392,94,62,37,193,2022
2021_B12393,79,65,39,183,2021
2022_C12394,81,63,79,223,2019
2021_C12395,95,78,69,242,2019
2022_C12396,97,87,43,227,2019
2022_B12397,90,82,52,224,2022
2019_B12398,88,88,47,223,2019
2021_C12399,85,90,69,244,2019
2021_C12400,73,86,70,229,2021
2019_A12401,79,77,66,222,2019
2019_C12402,90,50,38,178,2022
2021_A12403,92,81,52,225,2022
2019_B12404,74,77,40,191,2019
2019_A12405,81,60,42,183,2022
2019_B12406,95,68,54,217,2021
2019_A12407,79,63,36,178,2019
2021_C12408,85,93,73,251,2022
2019_B12409,75,89,49,213,2022
2021_C12410,96,96,72,264,2021
2022_B12411,93,73,79,245,2022
2022_C12412,97,94,67,258,2022
2019_A12413,73,81,37,191,2019
2022_B12414,96,62,69,227,2021
2021_C12415,71,60,56,187,2019
2019_A12416,89,66,58,213,2021
2022_B12417,94,45,62,201,2022
2019_B12418,89,55,67,211,2021
2022_C12419,89,52,75,216,2019
2021_A12420,91,46,61,198,2021
2022_B12421,84,60,57,201,2022
2019_B12422,87,50,35,172,2021
2019_B12423,81,64,79,224,2019
2022_A12424,82,76,64,222,2022
2022_C12425,81,51,55,187,2021
2019_A12426,79,86,45,210,2019
2019_C12427,87,69,75,231,2022
2022_C12428,92,72,75,239,2022
2021_C12429,84,85,78,247,2019
2019_B12430,96,57,65,218,2019
2021_C12431,81,85,57,223,2019
2019_C12432,73,69,56,198,2019
2022_A12433,84,45,39,168,2021
2022_C12434,81,52,72,205,2019
2022_A12435,90,52,49,191,2019
2021_A12436,79,74,46,199,2019
2021_C12437,92,80,65,237,2021
2022_B12438,82,62,54,198,2021
2021_A12439,79,92,43,214,2019
2022_A12440,95,73,36,204,2022
2022_B12441,90,85,37,212,2022
2021_B12442,88,64,45,197,2021
2021_B12443,82,93,73,248,2021
2019_A12444,74,48,41,163,2021
2019_C12445,73,87,63,223,2021
2022_C12446,89,71,54,214,2019
2021_B12447,89,57,59,205,2022
2022_A12448,80,66,54,200,2022
2022_A12449,87,65,60,212,2021
2022_C12450,72,86,41,199,2022
2021_C12451,91,64,40,195,2021
2022_B12452,93,59,78,230,2019
2022_B12453,84,93,67,244,2022
2019_A12454,83,54,55,192,2019
2019_C12455,83,55,62,200,2022
2021_B12456,84,67,44,195,2019
2021_C12457,74,63,39,176,2021
2022_C12458,80,87,69,236,2022
2022_C12459,93,51,79,223,2022
2021_C12460,92,59,69,220,2022
2021_C12461,85,49,66,200,2021
2022_B12462,72,62,63,197,2019
2022_C12463,93,46,57,196,2019
2019_C12464,78,76,54,208,2022
2022_A12465,78,82,42,202,2022
2019_B12466,93,62,45,200,2019
2022_C12467,83,76,72,231,2021
2021_C12468,86,52,74,212,2019
2022_B12469,78,57,71,206,2019
2021_C12470,95,84,79,258,2019
2019_A12471,93,89,76,258,2022
2019_B12472,94,82,46,222,2021
2021_A12473,94,45,36,175,2021
2022_B12474,78,81,56,215,2021
2021_B12475,74,77,62,213,2019
2022_B12476,73,75,59,207,2019
2019_A12477,91,91,78,260,2021
2022_C12478,95,92,39,226,2019
2022_C12479,88,73,48,209,2022
2021_B12480,89,60,50,199,2022
2022_C12481,81,64,68,213,2019
2022_B12482,74,57,56,187,2019
2019_B12483,71,47,40,158,2021
2019_C12484,77,62,57,196,2019
2019_C12485,97,96,56,249,2019
2021_A12486,91,93,44,228,2022
2022_B12487,71,77,52,200,2022
2019_C12488,79,62,74,215,2019
2019_A12489,73,64,75,212,2019
2021_B12490,75,62,38,175,2021
2021_B12491,78,66,79,223,2019
2022_C12492,78,51,55,184,2021
2019_A12493,86,89,77,252,2022
2022_B12494,78,93,78,249,2021
2019_C12495,80,95,45,220,2019
2022_A12496,95,93,69,257,2021
2021_A12497,73,75,40,188,2022
2021_C12498,90,47,59,196,2019
2021_C12499,92,79,50,221,2021
2022_C12500,76,90,41,207,2021
2019_B12501,80,95,76,251,2019
2021_B12502,78,92,77,247,2022
2022_B12503,72,96,35,203,2021
2022_A12504,71,63,73,207,2021
2022_C12505,72,51,41,164,2021
2019_B12506,83,83,68,234,2022
2021_B12507,77,48,44,169,2021
2021_B12508,81,76,35,192,2019
2019_B12509,75,85,37,197,2022
2019_A12510,83,58,66,207,2019
2022_B12511,75,91,63,229,2022
2021_B12512,77,83,65,225,2022
2021_B12513,75,91,64,230,2019
2021_A12514,72,77,60,209,2022
2021_C12515,86,71,45,202,2021
2021_B12516,91,75,63,229,2022
2019_A12517,96,78,51,225,2021
2022_A12518,97,77,58,232,2021
2021_B12519,88,86,79,253,2022
2021_A12520,73,51,57,181,2022
2022_A12521,87,75,61,223,2021
2021_C12522,91,51,40,182,2021
2022_A12523,94,72,71,237,2019
2019_B12524,91,80,61,232,2019
2022_A12525,85,77,65,227,2022
2021_B12526,80,82,54,216,2022
2021_B12527,84,60,49,193,2021
2022_A12528,88,72,66,226,2022
2022_A12529,93,82,40,215,2019
2022_A12530,84,49,67,200,2019
2022_C12531,73,87,77,237,2022
2021_C12532,96,86,39,221,2021
2022_B12533,93,70,75,238,2019
2022_A12534,72,67,45,184,2022
2021_C12535,78,60,35,173,2022
2019_C12536,76,89,52,217,2019
2022_B12537,75,76,41,192,2021
2019_B12538,90,52,53,195,2019
2021_A12539,80,89,69,238,2021
2021_C12540,79,90,51,220,2021
2021_A12541,76,46,61,183,2021
2021_B12542,72,75,76,223,2019
2021_B12543,79,54,74,207,2022
2021_C12544,87,62,57,206,2021
2022_C12545,88,62,47,197,2022
2022_A12546,83,87,61,231,2019
2019_B12547,81,59,68,208,2019
2022_C12548,92,82,63,237,2019
2022_A12549,96,84,70,250,2021
2019_C12550,90,88,59,237,2019
2022_B12551,83,90,77,250,2019
2019_B12552,97,88,61,246,2021
2019_A12553,80,76,37,193,2022
2022_B12554,96,51,70,217,2021
2019_A12555,76,62,48,186,2022
2021_A12556,97,85,59,241,2022
2021_B12557,86,65,54,205,2021
2022_B12558,92,64,58,214,2022
2019_B12559,82,75,57,214,2022
2019_C12560,89,72,42,203,2021
2022_A12561,92,49,70,211,2021
2022_C12562,94,94,58,246,2022
2022_C12563,86,63,36,185,2021
2019_C12564,80,56,76,212,2021
2019_A12565,71,69,53,193,2022
2019_A12566,71,93,37,201,2022
2019_C12567,80,86,67,233,2022
2022_C12568,97,50,47,194,2021
2019_A12569,97,81,77,255,2021
2021_B12570,94,86,55,235,2021
2021_A12571,74,72,44,190,2019
2019_C12572,81,83,51,215,2021
2021_B12573,97,56,48,201,2021
2021_B12574,85,70,41,196,2022
2022_C12575,90,82,74,246,2022
2019_A12576,93,69,60,222,2022
2019_A12577,89,92,60,241,2022
2019_B12578,71,89,68,228,2019
2021_A12579,71,84,70,225,2021
2019_C12580,75,84,54,213,2022
2019_C12581,77,88,38,203,2019
2021_C12582,85,80,73,238,2022
2021_A12583,83,95,40,218,2019
2022_A12584,77,51,47,175,2022
2019_B12585,94,78,69,241,2022
2022_B12586,79,52,61,192,2022
2022_A12587,81,87,75,243,2021
2021_B12588,83,67,43,193,2022
2022_B12589,83,50,60,193,2022
2021_A12590,83,51,52,186,2022
2022_B12591,88,54,46,188,2021
2019_A12592,85,85,66,236,2022
2019_C12593,85,90,62,237,2021
2021_A12594,92,74,46,212,2019
2021_C12595,81,81,47,209,2021
2019_A12596,77,64,57,198,2019
2022_C12597,83,49,67,199,2021
2021_A12598,72,90,55,217,2021
2019_B12599,94,73,76,243,2019
2019_A12600,95,52,76,223,2021
2022_C12601,93,59,74,226,2019
2021_A12602,96,54,78,228,2019
2019_C12603,91,56,57,204,2021
2021_B12604,89,51,56,196,2021
2022_A12605,93,64,46,203,2021
2021_A12606,84,49,75,208,2022
2022_A12607,89,72,76,237,2022
2019_A12608,94,76,69,239,2019
2019_A12609,75,70,39,184,2019
2022_B12610,90,46,58,194,2022
2019_C12611,79,62,59,200,2021
2022_A12612,74,71,60,205,2021
2022_C12613,83,63,39,185,2019
2021_C12614,90,62,79,231,2019
2022_A12615,89,62,51,202,2022
2019_A12616,96,71,40,207,2021
2021_A12617,82,85,46,213,2019
2021_A12618,84,61,72,217,2022
2022_A12619,90,84,76,250,2021
2019_C12620,92,51,67,210,2021
2019_C12621,93,61,53,207,2021
2021_C12622,92,53,59,204,2019
2022_A12623,95,81,67,243,2022
2021_C12624,96,85,79,260,2021
2022_C12625,80,70,79,229,2019
2021_B12626,83,86,46,215,2022
2021_C12627,76,79,71,226,2021
2022_C12628,93,81,69,243,2022
2019_A12629,91,76,64,231,2019
2022_A12630,77,85,54,216,2022
2022_C12631,72,62,59,193,2019
2019_B12632,88,72,53,213,2022
2021_A12633,92,67,51,210,2019
2019_A12634,85,64,38,187,2019
2021_C12635,93,90,76,259,2022
2021_B12636,93,47,62,202,2019
2021_B12637,78,60,77,215,2019
2021_C12638,72,87,43,202,2022
2022_C12639,93,95,48,236,2019
2021_C12640,74,46,67,187,2022
2019_A12641,76,68,52,196,2021
2019_B12642,93,84,41,218,2022
2019_C12643,71,59,54,184,2019
2022_B12644,94,69,74,237,2022
2022_A12645,94,85,72,251,2021
2021_C12646,91,58,53,202,2022
2022_A12647,78,71,71,220,2019
2022_C12648,77,77,65,219,2022
2022_C12649,74,70,65,209,2021
2019_C12650,82,57,36,175,2019
2019_B12651,79,68,70,217,2022
2022_B12652,79,51,66,196,2022
2022_C12653,78,46,42,166,2019
2019_A12654,74,78,58,210,2022
2019_C12655,80,73,53,206,2022
2021_C12656,91,92,47,230,2021
2021_B12657,74,90,52,216,2021
2022_A12658,96,79,52,227,2021
2022_C12659,83,48,76,207,2019
2021_B12660,73,49,66,188,2019
2019_B12661,89,45,40,174,2019
2021_A12662,71,54,50,175,2019
2021_A12663,77,63,46,186,2021
2021_C12664,91,54,55,200,2021
2022_C12665,97,51,58,206,2019
2021_B12666,78,46,42,166,2021
2019_B12667,88,75,41,204,2019
2022_C12668,71,58,35,164,2021
2021_B12669,89,63,60,212,2019
2019_A12670,81,75,68,224,2019
2021_B12671,86,45,52,183,2019
2022_B12672,86,89,59,234,2019
2019_A12673,91,54,41,186,2019
2019_A12674,87,91,45,223,2022
2022_A12675,87,66,75,228,2022
2019_C12676,89,95,37,221,2019
2022_C12677,85,50,50,185,2021
2021_A12678,95,76,68,239,2019
2019_B12679,96,79,41,216,2022
2021_A12680,90,93,50,233,2021
2021_A12681,72,90,61,223,2019
2021_B12682,95,96,43,234,2022
2022_A12683,86,83,51,220,2019
2022_A12684,86,47,79,212,2019
2019_A12685,96,92,65,253,2022
2022_A12686,89,90,35,214,2021
2022_C12687,97,72,71,240,2021
2019_B12688,71,77,37,185,2019
2019_A12689,94,85,64,243,2022
2019_B12690,75,57,75,207,2022
2019_B12691,91,76,46,213,2021
2021_C12692,84,64,50,198,2022
2019_C12693,75,53,54,182,2019
2021_C12694,79,69,66,214,2021
2019_C12695,85,91,68,244,2022
2019_A12696,96,94,72,262,2021
2022_A12697,79,57,39,175,2019
2019_C12698,95,65,63,223,2021
2021_B12699,96,65,48,209,2022
2022_C12700,91,50,50,191,2019
2019_A12701,71,91,75,237,2019
2022_C12702,81,85,76,242,2021
2019_B12703,88,74,63,225,2019
2021_B12704,85,87,66,238,2019
2019_C12705,71,83,65,219,2019
2019_A12706,72,74,44,190,2019
2019_A12707,76,85,65,226,2022
2021_A12708,88,71,46,205,2019
2019_C12709,91,77,56,224,2021
2022_B12710,91,81,61,233,2019
2019_A12711,81,64,52,197,2019
2022_A12712,88,72,42,202,2021
2022_B12713,74,88,40,202,2022
2021_A12714,97,85,65,247,2022
2019_C12715,92,45,68,205,2022
2021_B12716,82,67,50,199,2022
2022_C12717,83,64,47,194,2019
2022_A12718,75,76,77,228,2021
2022_C12719,84,78,72,234,2022
2019_A12720,74,81,74,229,2019
2021_C12721,88,87,72,247,2021
2021_A12722,91,95,68,254,2022
2019_C12723,74,89,54,217,2021
2021_B12724,89,81,67,237,2022
2022_A12725,94,67,52,213,2021
2021_B12726,73,84,70,227,2021
2019_C12727,75,45,74,194,2019
2019_B12728,73,76,35,184,2022
2021_A12729,77,79,63,219,2022
2019_A12730,85,94,64,243,2021
2021_A12731,85,83,68,236,2019
2019_C12732,81,60,60,201,2021
2019_B12733,95,78,52,225,2019
2021_C12734,79,47,72,198,2022
2022_A12735,80,66,50,196,2021
2019_A12736,87,71,63,221,2022
2022_C12737,94,91,47,232,2021
2022_B12738,83,47,41,171,2022
2019_C12739,90,64,50,204,2021
2021_B12740,72,60,72,204,2019
2019_C12741,83,69,74,226,2022
2021_A12742,90,79,44,213,2019
2019_A12743,97,94,38,229,2021
2019_B12744,72,63,53,188,2019
2022_A12745,81,80,68,229,2021
2021_C12746,92,95,77,264,2019
2019_A12747,91,75,48,214,2021
2021_C12748,71,90,59,220,2021
2022_A12749,85,80,37,202,2019
2021_A12750,84,74,58,216,2019
2022_B12751,94,45,55,194,2019
2022_A12752,87,78,54,219,2022
2019_A12753,97,51,56,204,2019
2021_C12754,72,94,78,244,2022
2019_A12755,84,89,75,248,2022
2022_B12756,71,70,58,199,2022
2021_B12757,82,91,57,230,2019
2019_A12758,92,71,77,240,2022
2022_A12759,77,50,75,202,2019
2019_C12760,84,95,55,234,2021
2019_C12761,97,58,53,208,2021
2022_C12762,81,50,64,195,2022
2022_A12763,84,62,77,223,2019
2019_B12764,81,58,36,175,2021
2022_A12765,83,75,69,227,2021
2021_A12766,97,71,37,205,2022
2022_A12767,81,90,76,247,2022
2022_C12768,77,54,65,196,2022
2021_C12769,90,66,44,200,2021
2021_C12770,94,58,72,224,2022
2021_C12771,86,55,73,214,2019
2019_C12772,92,47,42,181,2021
2019_B12773,92,68,45,205,2022
2022_B12774,74,74,60,208,2022
2019_C12775,97,87,59,243,2021
2019_C12776,84,59,42,185,2021
2022_B12777,84,77,43,204,2022
2019_A12778,84,91,69,244,2022
2019_C12779,71,79,73,223,2019
2019_B12780,85,67,42,194,2022
2019_B12781,90,74,60,224,2021
2021_B12782,78,50,44,172,2022
2022_B12783,86,70,48,204,2021
2019_C12784,78,58,75,211,2022
2019_B12785,74,90,76,240,2019
2021_C12786,87,47,46,180,2019
2021_A12787,83,84,40,207,2021
2019_C12788,75,70,38,183,2021
2022_B12789,84,48,38,170,2022
2019_C12790,75,86,55,216,2019
2019_B12791,89,67,65,221,2019
2019_B12792,86,85,77,248,2019
2019_A12793,85,74,68,227,2019
2021_B12794,86,91,69,246,2021
2022_B12795,73,59,47,179,2021
2019_A12796,84,95,75,254,2019
2022_A12797,95,76,50,221,2022
2019_B12798,88,82,49,219,2022
2022_C12799,71,82,63,216,2022
2021_A12800,91,55,58,204,2022
2021_C12801,97,54,45,196,2019
2019_C12802,96,76,73,245,2019
2022_B12803,75,89,40,204,2021
2022_C12804,96,52,39,187,2022
2022_C12805,79,78,37,194,2021
2019_A12806,75,70,64,209,2022
2022_B12807,93,59,58,210,2022
2022_A12808,93,57,38,188,2021
2019_C12809,84,78,67,229,2019
2021_C12810,82,75,43,200,2022
2022_C12811,80,95,39,214,2021
2019_B12812,74,45,59,178,2022
2021_A12813,83,75,64,222,2019
2022_C12814,71,50,61,182,2021
2022_B12815,72,69,35,176,2019
2022_C12816,75,51,59,185,2019
2022_A12817,90,86,48,224,2019
2019_B12818,93,74,53,220,2022
2021_B12819,72,55,35,162,2021
2022_A12820,96,50,55,201,2022
2021_A12821,89,52,75,216,2022
2021_B12822,85,96,50,231,2022
2021_B12823,75,93,60,228,2019
2022_B12824,77,88,61,226,2019
2021_A12825,87,85,65,237,2021
2021_C12826,88,76,49,213,2022
2022_B12827,71,58,53,182,2019
2019_C12828,82,55,48,185,2022
2021_B12829,94,90,52,236,2021
2022_C12830,97,68,77,242,2022
2022_C12831,83,68,67,218,2022
2022_A12832,91,90,37,218,2019
2022_C12833,95,64,51,210,2019
2019_B12834,86,75,52,213,2021
2019_C12835,81,87,46,214,2022
2021_A12836,73,95,50,218,2022
2021_C12837,96,47,74,217,2022
2022_B12838,74,65,73,212,2019
2022_C12839,89,88,73,250,2021
2019_A12840,92,51,44,187,2019
2021_C12841,91,79,67,237,2022
2019_C12842,79,66,54,199,2021
2021_A12843,93,85,57,235,2022
2021_C12844,82,81,70,233,2022
2019_C12845,85,78,78,241,2019
2021_B12846,74,77,70,221,2021
2019_A12847,73,66,54,193,2019
2019_B12848,86,50,66,202,2021
2022_C12849,92,96,61,249,2021
2022_A12850,94,96,39,229,2022
2019_A12851,85,89,63,237,2019
2019_C12852,87,87,38,212,2019
2021_B12853,84,47,72,203,2019
2019_B12854,80,46,72,198,2022
2022_B12855,72,58,61,191,2022
2022_A12856,79,68,53,200,2021
2019_C12857,72,92,55,219,2021
2022_A12858,85,71,45,201,2019
2021_B12859,71,52,48,171,2021
2022_C12860,92,56,68,216,2019
2022_C12861,89,92,47,228,2021
2021_C12862,83,68,52,203,2019
2022_B12863,74,91,79,244,2022
2022_B12864,87,45,71,203,2022
2021_A12865,84,87,68,239,2021
2021_C12866,86,61,67,214,2022
2022_C12867,79,61,59,199,2021
2022_B12868,85,87,62,234,2021
2022_B12869,85,71,65,221,2021
2022_C12870,96,56,71,223,2022
2021_B12871,75,80,36,191,2022
2022_C12872,86,57,64,207,2022
2019_B12873,96,53,52,201,2019
2021_B12874,96,55,74,225,2021
2021_B12875,71,54,56,181,2022
2019_B12876,75,68,61,204,2021
2022_A12877,92,74,64,230,2019
2022_B12878,95,84,42,221,2019
2022_A12879,94,62,36,192,2019
2021_A12880,86,94,66,246,2019
2022_C12881,81,87,69,237,2022
2019_A12882,94,73,43,210,2021
2021_C12883,96,59,36,191,2019
2021_A12884,86,94,64,244,2019
2019_C12885,88,47,43,178,2019
2022_B12886,81,95,54,230,2021
2022_B12887,88,86,51,225,2022
2019_C12888,85,84,42,211,2021
2019_B12889,95,60,50,205,2021
2019_B12890,78,80,64,222,2019
2021_A12891,80,47,40,167,2022
2021_C12892,73,70,53,196,2022
2022_C12893,94,67,43,204,2021
2022_A12894,72,74,62,208,2021
2019_A12895,97,95,56,248,2021
2021_C12896,71,47,45,163,2021
2019_C12897,77,74,38,189,2019
2021_B12898,87,81,43,211,2019
2019_C12899,93,84,77,254,2022
2022_B12900,89,80,36,205,2019
2021_B12901,74,95,65,234,2022
2019_C12902,90,47,58,195,2021
2019_C12903,82,90,63,235,2022
2022_B12904,96,91,73,260,2022
2022_B12905,83,82,60,225,2019
2019_A12906,90,67,67,224,2022
2022_B12907,89,81,65,235,2021
2021_B12908,97,84,46,227,2019
2021_C12909,85,51,53,189,2021
2019_C12910,83,96,56,235,2021
2019_B12911,86,54,47,187,2022
2022_B12912,78,58,77,213,2022
2022_C12913,71,72,52,195,2019
2019_B12914,90,65,72,227,2019
2022_B12915,85,90,67,242,2019
2021_C12916,75,48,65,188,2022
2021_A12917,88,55,76,219,2022
2022_A12918,74,61,68,203,2022
2019_C12919,90,78,52,220,2022
2019_C12920,73,90,70,233,2022
2022_C12921,90,46,49,185,2019
2021_C12922,85,74,63,222,2022
2022_C12923,87,45,36,168,2022
2022_C12924,93,47,55,195,2021
2022_A12925,91,92,37,220,2021
2022_B12926,84,59,70,213,2021
2021_B12927,78,46,68,192,2022
2019_C12928,90,80,46,216,2021
2019_C12929,77,56,40,173,2021
2021_C12930,83,76,79,238,2019
2022_B12931,83,75,76,234,2019
2019_A12932,87,75,44,206,2021
2021_B12933,88,88,61,237,2022
2021_B12934,71,92,62,225,2019
2022_A12935,78,96,77,251,2021
2019_B12936,79,87,40,206,2022
2019_B12937,93,53,42,188,2019
2022_C12938,94,56,79,229,2021
2019_B12939,71,90,42,203,2021
2022_B12940,77,71,69,217,2022
2019_B12941,87,84,64,235,2022
2019_A12942,89,51,56,196,2021
2019_B12943,74,45,43,162,2019
2021_B12944,78,96,53,227,2019
2022_B12945,93,93,40,226,2021
2022_C12946,81,94,39,214,2022
2021_C12947,78,45,64,187,2021
2021_B12948,75,85,76,236,2021
2019_B12949,73,56,43,172,2021
2019_C12950,72,46,57,175,2022
2019_C12951,75,78,63,216,2021
2019_B12952,83,56,67,206,2022
2022_A12953,95,94,72,261,2021
2019_A12954,71,87,56,214,2021
2019_B12955,84,71,68,223,2022
2019_A12956,97,67,51,215,2022
2022_C12957,84,84,75,243,2019
2021_B12958,90,48,64,202,2019
2021_A12959,86,88,40,214,2019
2022_C12960,85,53,35,173,2019
2021_B12961,72,93,67,232,2022
2019_B12962,88,93,41,222,2022
2022_C12963,83,81,51,215,2019
2021_C12964,96,84,63,243,2021
2021_B12965,74,85,52,211,2022
2021_A12966,81,54,70,205,2021
2022_B12967,86,55,40,181,2021
2021_A12968,71,53,69,193,2019
2019_C12969,92,59,79,230,2021
2022_C12970,93,79,55,227,2021
2022_C12971,82,69,56,207,2021
2022_C12972,77,45,36,158,2019
2019_A12973,76,80,52,208,2019
2021_A12974,96,58,68,222,2021
2021_A12975,96,60,41,197,2022
2019_C12976,71,65,62,198,2022
2021_C12977,73,60,68,201,2021
2022_C12978,93,93,46,232,2019
2021_C12979,92,79,61,232,2021
2022_C12980,79,60,63,202,2022
2022_C12981,93,81,49,223,2019
2021_B12982,91,87,41,219,2021
2021_C12983,92,86,42,220,2022
2022_C12984,86,84,64,234,2019
2022_C12985,84,54,58,196,2019
2022_B12986,92,46,61,199,2021
2022_B12987,80,52,76,208,2021
2021_C12988,80,55,49,184,2021
2021_C12989,78,74,59,211,2021
2022_A12990,94,81,67,242,2021
2021_A12991,87,94,46,227,2021
2019_A12992,84,83,43,210,2021
2021_B12993,72,51,57,180,2021
2021_C12994,83,61,77,221,2021
2019_C12995,76,65,44,185,2019
2021_C12996,90,86,77,253,2021
2019_B12997,74,48,52,174,2021
2019_A12998,83,90,45,218,2021
2022_A12999,82,75,42,199,2022
2019_B13000,77,78,50,205,2022
2021_C13001,76,46,35,157,2019
2022_C13002,88,49,42,179,2019
2022_A13003,80,94,61,235,2021
2021_A13004,94,75,52,221,2019
2022_A13005,76,78,63,217,2021
2022_B13006,87,53,76,216,2019
2021_C13007,73,46,70,189,2019
2021_A13008,84,55,42,181,2021
2021_A13009,96,74,46,216,2021
2019_A13010,72,58,60,190,2019
2021_C13011,72,63,68,203,2022
2021_A13012,93,80,38,211,2021
2022_C13013,95,89,73,257,2022
2022_B13014,74,90,45,209,2019
2022_B13015,86,79,50,215,2022
2022_C13016,95,48,79,222,2019
2022_C13017,84,94,67,245,2022
2022_C13018,72,88,72,232,2021
2021_A13019,93,83,65,241,2019
2021_C13020,75,64,53,192,2022
2022_C13021,96,92,60,248,2021
2021_A13022,95,47,75,217,2019
2021_A13023,85,77,62,224,2022
2022_C13024,86,54,52,192,2021
2022_B13025,94,89,37,220,2022
2021_B13026,78,76,40,194,2022
2019_B13027,91,56,39,186,2022
2019_A13028,79,96,67,242,2021
2021_C13029,87,49,35,171,2021
2022_B13030,84,56,72,212,2022
2019_C13031,97,94,35,226,2019
2019_B13032,94,88,37,219,2022
2022_C13033,75,49,36,160,2022
2021_B13034,89,72,35,196,2022
2021_A13035,81,59,63,203,2021
2022_C13036,78,54,47,179,2022
2021_B13037,91,61,68,220,2019
2021_A13038,80,73,58,211,2021
2019_C13039,95,94,63,252,2019
2019_B13040,76,95,50,221,2019
2022_A13041,71,64,37,172,2022
2019_A13042,80,56,56,192,2019
2019_A13043,81,85,38,204,2021
2019_A13044,74,95,62,231,2021
2021_A13045,88,77,63,228,2021
2021_B13046,83,60,52,195,2022
2022_C13047,74,51,72,197,2019
2019_B13048,83,70,71,224,2019
2022_C13049,73,92,52,217,2021
2019_C13050,80,49,70,199,2021
2019_C13051,95,75,53,223,2019
2022_C13052,71,89,67,227,2022
2022_A13053,97,70,61,228,2022
2019_B13054,75,61,38,174,2019
2021_B13055,84,81,70,235,2022
2019_C13056,75,73,58,206,2019
2019_A13057,88,67,77,232,2019
2019_C13058,92,74,51,217,2019
2022_C13059,78,94,40,212,2022
2021_B13060,94,94,66,254,2022
2021_C13061,89,83,55,227,2021
2021_C13062,91,82,42,215,2019
2021_B13063,97,76,46,219,2021
2019_B13064,80,67,65,212,2022
2022_B13065,92,79,65,236,2021
2019_C13066,93,63,38,194,2022
2021_B13067,82,79,45,206,2019
2021_C13068,81,78,42,201,2019
2021_B13069,73,57,58,188,2019
2022_C13070,78,67,62,207,2022
2022_C13071,78,86,45,209,2021
2022_B13072,93,74,38,205,2022
2021_B13073,76,81,39,196,2019
2022_A13074,83,59,63,205,2019
2021_B13075,77,73,60,210,2021
2022_C13076,80,56,46,182,2022
2022_B13077,83,55,47,185,2019
2019_A13078,78,78,51,207,2021
2021_C13079,88,84,57,229,2019
2021_C13080,80,73,61,214,2022
2022_C13081,77,66,63,206,2021
2019_B13082,80,45,76,201,2019
2019_B13083,83,81,47,211,2019
2019_C13084,78,45,78,201,2021
2019_C13085,82,75,43,200,2019
2019_A13086,91,55,56,202,2021
2022_A13087,74,96,37,207,2019
2022_A13088,90,64,73,227,2019
2019_B13089,92,71,60,223,2019
2019_C13090,71,73,74,218,2019
2022_B13091,85,90,44,219,2022
2019_C13092,86,94,40,220,2021
2022_C13093,79,92,42,213,2021
2021_C13094,84,58,39,181,2021
2019_A13095,85,70,48,203,2022
2022_A13096,96,62,79,237,2021
2022_C13097,92,86,64,242,2019
2021_C13098,96,63,36,195,2019
2021_C13099,81,47,41,169,2022
2022_C13100,87,53,45,185,2022
2021_B13101,96,70,39,205,2021
2019_A13102,86,53,41,180,2021
2022_C13103,91,45,65,201,2021
2021_A13104,83,90,35,208,2022
2021_B13105,76,75,67,218,2021
2022_C13106,91,52,63,206,2021
2022_A13107,73,80,47,200,2021
2021_A13108,83,69,64,216,2021
2021_B13109,85,94,37,216,2022
2019_A13110,73,67,35,175,2021
2021_C13111,78,80,72,230,2022
2019_A13112,73,79,44,196,2021
2019_A13113,84,87,43,214,2021
2022_B13114,85,92,77,254,2021
2021_A13115,76,45,55,176,2019
2022_C13116,91,47,50,188,2019
2019_A13117,86,85,67,238,2021
2021_B13118,91,92,43,226,2022
2021_C13119,87,54,51,192,2021
2022_A13120,79,91,68,238,2022
2022_C13121,81,63,62,206,2021
2021_A13122,87,67,72,226,2021
2022_C13123,95,76,42,213,2021
2021_C13124,88,92,56,236,2019
2019_C13125,90,63,45,198,2019
2022_A13126,85,46,40,171,2021
2022_A13127,85,90,65,240,2022
2019_A13128,97,64,75,236,2021
2019_C13129,72,79,35,186,2021
2022_A13130,95,63,41,199,2022
2019_C13131,96,50,57,203,2021
2022_B13132,90,48,45,183,2021
2022_B13133,84,60,48,192,2019
2021_C13134,87,46,47,180,2019
2019_C13135,79,54,57,190,2022
2022_C13136,73,56,44,173,2022
2019_A13137,88,84,51,223,2019
2021_C13138,92,91,60,243,2021
2021_A13139,93,83,54,230,2019
2019_B13140,77,90,42,209,2022
2022_C13141,78,79,46,203,2021
2019_B13142,84,51,47,182,2022
2021_B13143,90,86,50,226,2021
2022_A13144,97,75,51,223,2019
2019_B13145,87,79,40,206,2021
2021_A13146,94,79,60,233,2021
2019_C13147,71,57,47,175,2021
2021_C13148,87,45,42,174,2019
2021_B13149,86,75,79,240,2021
2022_A13150,81,76,51,208,2021
2019_B13151,73,60,40,173,2022
2019_C13152,83,77,70,230,2022
2021_C13153,89,90,61,240,2022
2019_B13154,85,73,69,227,2021
2019_A13155,92,85,76,253,2021
2022_C13156,82,96,50,228,2021
2021_A13157,89,59,42,190,2019
2019_B13158,84,79,56,219,2022
2021_B13159,77,93,69,239,2021
2021_C13160,96,57,63,216,2022
2019_A13161,84,89,78,251,2022
2019_A13162,87,65,56,208,2019
2021_A13163,80,93,49,222,2021
2019_C13164,86,72,57,215,2019
2022_B13165,90,55,68,213,2019
2022_A13166,83,48,72,203,2021
2022_A13167,78,93,70,241,2021
2021_C13168,82,48,69,199,2019
2022_B13169,89,65,69,223,2019
2021_C13170,94,81,47,222,2021
2019_A13171,81,92,46,219,2021
2022_A13172,90,62,47,199,2019
2019_B13173,75,52,35,162,2019
2022_C13174,74,55,38,167,2022
2019_C13175,79,55,65,199,2022
2019_B13176,74,72,60,206,2019
2022_B13177,76,64,72,212,2019
2022_B13178,78,75,58,211,2019
2022_B13179,86,50,64,200,2019
2019_A13180,87,50,62,199,2019
2021_A13181,84,83,42,209,2021
2019_A13182,84,64,57,205,2019
2022_B13183,87,45,53,185,2019
2022_B13184,78,71,57,206,2022
2022_C13185,79,66,58,203,2021
2019_C13186,72,75,60,207,2021
2022_A13187,96,93,79,268,2019
2021_A13188,84,56,63,203,2022
2022_C13189,71,91,53,215,2022
2019_C13190,97,90,47,234,2019
2021_C13191,86,57,57,200,2019
2022_B13192,86,72,59,217,2019
2022_C13193,85,82,55,222,2021
2022_C13194,83,52,54,189,2019
2021_A13195,82,73,50,205,2022
2021_B13196,82,87,47,216,2021
2019_A13197,78,93,38,209,2021
2022_B13198,92,52,75,219,2021
2021_C13199,91,94,63,248,2022
2021_A13200,90,82,70,242,2021
2019_A13201,97,53,45,195,2019
2022_A13202,85,82,50,217,2021
2021_C13203,75,50,62,187,2019
2022_C13204,83,60,67,210,2019
2022_B13205,97,67,68,232,2019
2022_C13206,96,60,44,200,2019
2021_A13207,87,70,45,202,2021
2021_B13208,78,53,68,199,2019
2019_A13209,73,92,48,213,2019
2021_A13210,77,57,44,178,2022
2022_B13211,92,86,61,239,2019
2019_A13212,77,67,70,214,2021
2021_A13213,71,75,50,196,2019
2022_C13214,82,89,79,250,2021
2019_A13215,75,84,67,226,2022
2021_A13216,84,60,51,195,2021
2022_A13217,93,93,62,248,2022
2019_B13218,97,71,79,247,2022
2022_A13219,89,95,75,259,2021
2021_C13220,94,59,61,214,2019
2019_C13221,96,88,55,239,2022
2022_C13222,94,60,41,195,2022
2021_A13223,88,48,56,192,2021
2021_B13224,97,51,54,202,2019
2021_C13225,71,64,63,198,2019
2019_C13226,75,48,74,197,2021
2021_A13227,76,73,72,221,2019
2022_C13228,95,91,73,259,2022
2019_B13229,88,76,39,203,2022
2019_B13230,97,46,58,201,2022
2022_B13231,95,88,63,246,2019
2019_A13232,79,69,59,207,2022
2022_C13233,79,75,41,195,2022
2022_C13234,83,96,61,240,2019
2022_C13235,74,61,50,185,2022
2022_C13236,82,56,41,179,2019
2021_A13237,77,63,59,199,2019
2022_B13238,85,54,67,206,2019
2022_C13239,83,70,50,203,2022
2019_C13240,93,50,76,219,2021
2019_B13241,84,70,54,208,2021
2022_A13242,76,75,72,223,2021
2021_A13243,94,85,78,257,2019
2022_C13244,73,50,71,194,2022
2019_B13245,95,62,46,203,2019
2022_B13246,97,71,68,236,2021
2022_B13247,96,48,51,195,2021
2019_A13248,83,52,35,170,2019
2021_B13249,86,88,40,214,2022
2021_B13250,71,57,55,183,2019
2019_A13251,91,66,70,227,2022
2021_C13252,95,78,37,210,2019
2022_A13253,95,46,63,204,2019
2019_A13254,73,62,67,202,2021
2022_A13255,92,45,39,176,2019
2021_A13256,95,94,35,224,2019
2022_A13257,90,91,55,236,2022
2019_C13258,87,73,49,209,2021
2022_C13259,88,65,47,200,2019
2022_C13260,76,68,69,213,2019
2022_B13261,87,81,54,222,2022
2019_A13262,74,64,72,210,2022
2022_A13263,85,91,71,247,2021
2021_C13264,81,58,61,200,2019
2021_B13265,95,77,75,247,2019
2021_A13266,83,54,36,173,2022
2019_B13267,80,82,52,214,2022
2021_B13268,82,81,64,227,2019
2021_C13269,92,63,78,233,2019
2021_C13270,90,96,37,223,2019
2022_B13271,79,45,57,181,2019
2022_C13272,73,84,44,201,2019
2019_B13273,77,75,39,191,2019
2019_B13274,87,58,53,198,2022
2019_B13275,85,63,35,183,2019
2022_A13276,85,68,76,229,2022
2022_B13277,92,76,54,222,2021
2021_C13278,83,55,47,185,2022
2019_B13279,82,60,52,194,2019
2019_B13280,81,59,44,184,2019
2021_A13281,84,95,77,256,2021
2021_A13282,83,91,63,237,2019
2022_C13283,78,45,45,168,2019
2022_A13284,97,86,74,257,2022
2021_C13285,71,76,72,219,2019
2022_B13286,97,95,35,227,2021
2019_B13287,81,81,49,211,2021
2019_A13288,92,57,48,197,2021
2022_A13289,80,74,35,189,2022
2021_C13290,87,63,76,226,2022
2022_C13291,84,58,53,195,2022
2021_C13292,80,64,54,198,2019
2021_C13293,86,51,39,176,2021
2019_C13294,95,47,46,188,2019
2019_A13295,93,69,49,211,2022
2022_B13296,84,94,51,229,2019
2022_B13297,97,79,35,211,2019
2019_A13298,90,63,54,207,2021
2019_A13299,82,52,60,194,2022
2019_C13300,74,47,62,183,2019
2019_A13301,83,90,77,250,2022
2022_A13302,94,59,79,232,2021
2019_B13303,94,74,36,204,2019
2021_C13304,73,92,48,213,2022
2019_C13305,92,51,49,192,2019
2021_C13306,85,59,47,191,2019
2022_B13307,81,80,37,198,2022
2019_C13308,96,92,57,245,2022
2019_B13309,95,53,40,188,2021
2021_C13310,80,93,53,226,2019
2022_B13311,96,63,55,214,2021
2019_A13312,91,89,64,244,2019
2021_A13313,71,72,70,213,2019
2022_C13314,92,90,62,244,2019
2021_C13315,95,58,70,223,2021
2021_A13316,92,93,61,246,2019
2021_C13317,84,52,48,184,2022
2019_B13318,79,49,52,180,2022
2019_C13319,77,52,62,191,2019
2022_B13320,95,47,77,219,2021
2021_C13321,84,63,51,198,2021
2022_C13322,94,55,79,228,2021
2021_C13323,88,51,39,178,2022
2021_C13324,81,84,65,230,2021
2021_B13325,92,80,62,234,2021
2021_B13326,95,66,58,219,2021
2021_B13327,91,69,78,238,2022
2021_B13328,96,60,50,206,2019
2019_B13329,72,55,79,206,2021
2022_A13330,73,78,78,229,2019
2022_C13331,91,81,44,216,2021
2019_A13332,81,61,52,194,2019
2021_A13333,74,77,35,186,2019
2022_A13334,88,47,41,176,2019
2019_A13335,91,54,61,206,2022
2019_B13336,92,93,68,253,2021
2019_C13337,90,73,38,201,2022
2022_A13338,76,79,76,231,2019
2022_A13339,92,56,39,187,2021
2021_A13340,88,61,42,191,2021
2019_B13341,79,73,76,228,2019
2022_A13342,72,64,70,206,2019
2019_A13343,82,73,42,197,2022
2021_C13344,92,63,67,222,2022
2019_B13345,95,65,68,228,2021
2022_B13346,83,91,49,223,2022
2021_B13347,77,73,42,192,2019
2019_C13348,71,76,51,198,2019
2022_A13349,92,89,62,243,2019
2021_B13350,85,55,45,185,2019
2019_C13351,89,96,39,224,2022
2021_B13352,88,83,55,226,2021
2019_C13353,75,73,42,190,2021
2019_C13354,77,49,52,178,2021
2019_C13355,96,55,66,217,2021
2019_C13356,87,46,53,186,2021
2019_A13357,93,60,54,207,2021
2021_C13358,77,64,56,197,2021
2021_B13359,80,94,73,247,2021
2019_C13360,80,49,55,184,2019
2019_C13361,95,91,76,262,2021
2021_A13362,83,65,79,227,2019
2022_B13363,81,77,61,219,2021
2022_B13364,83,90,49,222,2022
2022_C13365,93,47,45,185,2021
2022_B13366,80,54,50,184,2019
2021_B13367,81,46,75,202,2021
2022_A13368,86,63,69,218,2019
2022_B13369,78,59,62,199,2021
2019_C13370,92,82,36,210,2021
2021_A13371,72,52,51,175,2019
2019_B13372,91,89,74,254,2022
2019_C13373,76,61,69,206,2019
2021_B13374,97,87,74,258,2021
2019_B13375,93,88,60,241,2021
2019_A13376,81,51,36,168,2022
2022_A13377,73,76,51,200,2019
2022_A13378,95,77,76,248,2019
2019_C13379,83,88,76,247,2022
2022_B13380,74,83,45,202,2022
2021_B13381,79,81,36,196,2019
2019_C13382,96,83,38,217,2022
2021_B13383,83,53,76,212,2022
2021_A13384,71,57,41,169,2019
2019_C13385,93,59,38,190,2021
2022_A13386,75,79,46,200,2021
2019_B13387,79,63,51,193,2019
2019_C13388,97,76,65,238,2021
2022_A13389,79,95,71,245,2019
2021_B13390,89,95,75,259,2022
2021_B13391,82,82,64,228,2022
2019_C13392,72,46,56,174,2022
2019_B13393,85,66,43,194,2021
2022_C13394,95,56,42,193,2019
2019_A13395,89,54,54,197,2019
2022_B13396,96,77,56,229,2019
2021_C13397,95,71,56,222,2021
2022_B13398,94,69,58,221,2022
2019_B13399,94,95,70,259,2021
2019_C13400,87,45,77,209,2022
2019_A13401,74,75,74,223,2021
2019_B13402,74,86,58,218,2019
2022_B13403,93,45,55,193,2022
2022_A13404,75,54,42,171,2019
2022_A13405,80,61,61,202,2021
2022_C13406,89,89,77,255,2022
2022_B13407,94,69,61,224,2021
2019_B13408,71,50,44,165,2019
2022_B13409,80,78,59,217,2022
2022_C13410,80,61,78,219,2021
2019_C13411,81,89,54,224,2019
2021_B13412,84,68,50,202,2021
2019_A13413,88,90,72,250,2022
2022_B13414,92,47,55,194,2021
2019_A13415,88,47,75,210,2022
2022_A13416,75,72,70,217,2022
2019_A13417,79,62,54,195,2022
2021_A13418,85,93,43,221,2019
2019_C13419,81,71,53,205,2021
2021_C13420,96,71,38,205,2022
2021_A13421,83,93,62,238,2022
2019_B13422,79,76,68,223,2019
2019_C13423,75,58,66,199,2022
2019_A13424,85,89,49,223,2019
2019_A13425,97,45,72,214,2019
2019_A13426,71,47,62,180,2022
2021_B13427,84,68,49,201,2022
2022_B13428,81,45,50,176,2022
2022_A13429,92,57,48,197,2022
2021_B13430,91,61,76,228,2021
2021_C13431,89,65,69,223,2019
2019_C13432,87,96,65,248,2022
2019_B13433,82,55,75,212,2019
2021_A13434,71,93,72,236,2019
2021_B13435,79,77,36,192,2021
2021_A13436,92,53,72,217,2019
2019_B13437,89,61,63,213,2021
2022_C13438,75,62,72,209,2021
2019_C13439,94,69,55,218,2019
2022_B13440,73,73,38,184,2021
2019_A13441,75,81,53,209,2021
2022_C13442,78,62,53,193,2021
2021_C13443,77,76,75,228,2021
2022_C13444,73,77,77,227,2021
2022_A13445,79,60,38,177,2019
2022_C13446,85,51,38,174,2022
2019_C13447,73,47,38,158,2021
2022_C13448,81,52,73,206,2019
2019_C13449,97,94,42,233,2021
2019_C13450,76,45,64,185,2022
2022_A13451,83,83,61,227,2021
2022_A13452,89,73,54,216,2019
2021_B13453,74,55,46,175,2022
2019_C13454,79,84,63,226,2021
2021_B13455,80,71,51,202,2021
2022_A13456,83,47,70,200,2019
2021_C13457,72,63,77,212,2022
2019_B13458,72,60,76,208,2022
2019_C13459,87,62,56,205,2022
2019_C13460,80,85,53,218,2019
2021_B13461,97,53,79,229,2019
2021_B13462,90,80,65,235,2022
2019_C13463,84,72,72,228,2022
2022_C13464,80,65,72,217,2019
2019_B13465,88,58,75,221,2022
2021_C13466,76,61,59,196,2022
2019_B13467,84,79,77,240,2019
2021_C13468,75,47,42,164,2019
2022_A13469,94,60,74,228,2022
2021_A13470,82,64,45,191,2021
2019_C13471,74,57,78,209,2019
2021_B13472,94,71,69,234,2019
2022_A13473,84,58,61,203,2022
2021_B13474,82,61,40,183,2022
2022_B13475,89,67,63,219,2019
2019_A13476,83,51,62,196,2021
2022_A13477,97,63,55,215,2021
2019_C13478,75,62,67,204,2022
2019_B13479,79,58,45,182,2022
2019_A13480,87,45,61,193,2021
2019_B13481,77,46,75,198,2022
2019_B13482,75,87,70,232,2022
2022_B13483,86,94,63,243,2022
2022_C13484,78,48,66,192,2021
2021_C13485,71,45,40,156,2019
2022_C13486,82,47,47,176,2022
2019_A13487,90,84,45,219,2019
2019_C13488,80,93,50,223,2021
2022_B13489,81,71,69,221,2022
2022_C13490,96,66,50,212,2022
2019_A13491,94,84,56,234,2019
2019_C13492,79,87,66,232,2021
2021_A13493,95,48,52,195,2019
2019_C13494,83,46,48,177,2022
2019_C13495,74,74,75,223,2019
2019_B13496,97,81,44,222,2019
2022_C13497,80,70,45,195,2022
2021_B13498,93,90,58,241,2022
2021_C13499,89,53,42,184,2021
2019_C13500,86,95,74,255,2021
2022_C13501,74,85,70,229,2021
2019_A13502,80,66,40,186,2022
2019_A13503,85,56,76,217,2021
2019_C13504,89,81,65,235,2022
2019_A13505,78,51,54,183,2021
2019_C13506,71,68,57,196,2021
2022_C13507,77,61,55,193,2019
2022_B13508,83,84,67,234,2022
2022_A13509,97,71,71,239,2022
2021_B13510,96,54,38,188,2022
2019_C13511,81,54,55,190,2021
2022_C13512,78,91,78,247,2022
2021_C13513,72,45,62,179,2022
2022_B13514,85,77,57,219,2022
2021_A13515,77,77,48,202,2022
2019_B13516,71,72,59,202,2022
2022_C13517,94,62,46,202,2022
2022_B13518,76,90,62,228,2021
2021_B13519,89,84,49,222,2019
2021_A13520,85,56,39,180,2021
2019_C13521,84,63,63,210,2019
2021_B13522,92,86,43,221,2019
2019_A13523,74,70,71,215,2022
2021_B13524,86,52,79,217,2021
2022_A13525,77,88,63,228,2019
2021_B13526,83,91,68,242,2019
2019_C13527,77,90,68,235,2022
2021_A13528,95,83,39,217,2019
2022_C13529,95,71,65,231,2022
2022_C13530,86,85,35,206,2019
2022_A13531,73,50,36,159,2021
2019_A13532,84,84,72,240,2022
2021_B13533,93,92,65,250,2019
2021_B13534,77,47,50,174,2022
2019_A13535,78,48,39,165,2021
2022_B13536,75,91,63,229,2021
2022_B13537,89,70,48,207,2021
2022_C13538,78,71,62,211,2022
2019_A13539,90,73,73,236,2022
2022_A13540,74,45,65,184,2019
2019_C13541,73,72,51,196,2021
2019_A13542,94,61,63,218,2022
2021_A13543,95,72,71,238,2019
2019_A13544,93,88,42,223,2022
2021_C13545,79,93,53,225,2019
2022_B13546,91,83,62,236,2019
2021_C13547,95,74,55,224,2019
2022_B13548,84,52,53,189,2019
2021_C13549,78,60,51,189,2021
2021_B13550,75,87,72,234,2021
2022_A13551,96,71,40,207,2022
2022_C13552,84,94,70,248,2022
2021_A13553,87,45,61,193,2022
2019_B13554,72,85,45,202,2021
2022_C13555,87,96,70,253,2021
2022_A13556,74,80,37,191,2021
2022_C13557,82,71,43,196,2019
2022_C13558,76,86,77,239,2021
2021_B13559,83,81,65,229,2019
2019_B13560,92,82,51,225,2022
2021_A13561,71,77,39,187,2021
2022_A13562,80,51,72,203,2019
2022_C13563,86,85,65,236,2019
2022_C13564,97,62,78,237,2019
2022_B13565,75,76,68,219,2019
2022_A13566,82,57,48,187,2022
2019_B13567,73,96,35,204,2021
2022_B13568,83,60,42,185,2021
2021_A13569,76,96,69,241,2022
2019_A13570,86,58,55,199,2021
2021_C13571,96,90,61,247,2022
2021_A13572,88,59,70,217,2022
2022_C13573,90,75,67,232,2022
2022_B13574,85,49,53,187,2021
2022_A13575,84,81,46,211,2022
2022_A13576,72,47,69,188,2022
2019_C13577,77,62,77,216,2019
2021_A13578,74,94,42,210,2019
2022_C13579,96,56,75,227,2019
2019_A13580,90,63,39,192,2021
2019_A13581,88,75,35,198,2022
2022_C13582,73,88,36,197,2022
2022_C13583,85,67,69,221,2019
2022_C13584,96,88,50,234,2019
2022_B13585,87,82,63,232,2022
2022_A13586,88,81,75,244,2019
2021_C13587,79,46,79,204,2022
2019_A13588,93,72,43,208,2019
2021_C13589,76,83,73,232,2021
2021_A13590,96,46,60,202,2022
2021_C13591,76,81,56,213,2021
2022_C13592,71,94,69,234,2022
2021_A13593,91,56,52,199,2019
2021_C13594,72,72,37,181,2019
2022_A13595,79,91,42,212,2022
2021_B13596,87,69,67,223,2021
2022_A13597,92,63,53,208,2019
2019_A13598,78,86,63,227,2019
2019_C13599,83,87,58,228,2021
2022_C13600,90,73,38,201,2022
2022_B13601,82,53,45,180,2021
2022_B13602,80,65,40,185,2019
2021_C13603,90,86,36,212,2019
2022_C13604,76,96,53,225,2019
2022_B13605,80,49,78,207,2021
2022_B13606,96,45,62,203,2021
2019_B13607,87,54,41,182,2019
2021_C13608,93,79,58,230,2022
2021_A13609,96,52,78,226,2019
2021_B13610,79,77,64,220,2021
2021_A13611,96,62,39,197,2021
2021_C13612,85,47,48,180,2022
2021_A13613,92,91,64,247,2019
2022_B13614,79,58,37,174,2021
2021_C13615,91,53,42,186,2021
2022_C13616,94,69,45,208,2021
2021_B13617,75,87,68,230,2022
2019_B13618,97,96,77,270,2021
2019_B13619,88,91,53,232,2022
2019_C13620,81,66,55,202,2021
2019_B13621,77,48,71,196,2021
2019_C13622,85,77,39,201,2022
2021_C13623,86,68,36,190,2021
2019_C13624,96,93,45,234,2021
2019_C13625,96,51,47,194,2019
2021_A13626,76,63,66,205,2019
2019_A13627,91,45,40,176,2021
2021_C13628,92,95,49,236,2019
2021_A13629,89,79,54,222,2019
2019_B13630,87,49,77,213,2022
2021_C13631,88,50,39,177,2021
2022_C13632,71,67,64,202,2021
2022_A13633,79,68,69,216,2021
2022_C13634,96,93,62,251,2022
2022_B13635,91,56,73,220,2022
2021_C13636,90,56,54,200,2019
2019_A13637,77,70,44,191,2022
2021_B13638,78,79,78,235,2022
2021_A13639,78,92,66,236,2022
2022_B13640,81,81,72,234,2021
2021_C13641,92,94,45,231,2022
2021_C13642,86,48,55,189,2021
2022_C13643,81,61,78,220,2021
2021_A13644,91,86,48,225,2021
2022_B13645,73,61,62,196,2022
2021_C13646,82,89,58,229,2019
2019_C13647,96,84,35,215,2021
2022_C13648,86,94,40,220,2021
2022_A13649,81,89,73,243,2022
2021_B13650,74,87,54,215,2022
2022_C13651,87,64,76,227,2019
2022_C13652,85,89,75,249,2022
2019_B13653,84,48,61,193,2022
2022_B13654,97,90,77,264,2019
2022_C13655,95,51,35,181,2022
2019_C13656,87,95,74,256,2019
2022_C13657,71,79,72,222,2021
2021_C13658,78,59,62,199,2019
2021_B13659,73,74,60,207,2021
2021_A13660,97,77,50,224,2022
2021_C13661,89,89,35,213,2019
2022_A13662,71,82,72,225,2022
2022_C13663,97,83,39,219,2021
2019_B13664,82,47,44,173,2021
2019_B13665,77,62,59,198,2019
2021_A13666,86,83,64,233,2019
2022_B13667,95,48,41,184,2021
2019_A13668,87,93,48,228,2021
2022_C13669,80,91,56,227,2021
2019_A13670,92,57,49,198,2019
2019_B13671,93,68,42,203,2021
2021_A13672,87,92,63,242,2019
2019_B13673,93,72,44,209,2021
2021_B13674,80,72,62,214,2021
2019_C13675,89,96,67,252,2021
2021_B13676,80,96,55,231,2022
2019_B13677,80,49,43,172,2022
2021_C13678,80,66,72,218,2019
2022_C13679,85,71,46,202,2022
2021_B13680,93,70,35,198,2021
2021_B13681,77,88,75,240,2021
2019_B13682,72,85,43,200,2019
2022_B13683,91,68,43,202,2021
2021_A13684,94,82,37,213,2021
2019_B13685,85,46,63,194,2019
2022_A13686,71,76,66,213,2019
2019_A13687,80,78,39,197,2019
2019_B13688,88,51,70,209,2022
2022_A13689,88,73,48,209,2022
2021_B13690,96,46,41,183,2019
2019_B13691,84,48,46,178,2022
2019_A13692,73,82,51,206,2019
2019_A13693,89,87,55,231,2021
2021_B13694,82,74,50,206,2019
2019_A13695,71,95,38,204,2019
2022_C13696,90,70,74,234,2021
2022_C13697,76,79,53,208,2021
2021_B13698,80,72,77,229,2021
2022_C13699,76,77,49,202,2021
2019_C13700,97,82,54,233,2022
2021_B13701,87,53,79,219,2022
2022_A13702,73,94,71,238,2021
2019_A13703,83,46,63,192,2021
2021_A13704,83,90,65,238,2021
2021_B13705,77,77,49,203,2021
2021_A13706,87,64,74,225,2022
2019_B13707,80,64,61,205,2019
2022_A13708,89,74,50,213,2019
2019_A13709,72,90,36,198,2022
2019_A13710,71,85,54,210,2022
2022_B13711,82,66,64,212,2022
2022_B13712,81,47,52,180,2021
2021_B13713,96,70,57,223,2019
2021_A13714,73,58,38,169,2021
2019_C13715,81,93,76,250,2019
2021_A13716,97,60,37,194,2021
2021_C13717,85,83,37,205,2021
2022_B13718,86,64,46,196,2021
2022_B13719,79,63,68,210,2019
2021_B13720,86,63,38,187,2021
2022_A13721,97,64,62,223,2021
2019_C13722,75,55,58,188,2022
2022_B13723,82,54,37,173,2019
2022_B13724,84,46,45,175,2021
2021_A13725,73,74,35,182,2021
2022_B13726,91,48,66,205,2021
2022_C13727,96,55,76,227,2021
2019_B13728,79,64,37,180,2022
2021_C13729,85,59,44,188,2019
2022_B13730,89,62,53,204,2022
2022_B13731,76,90,40,206,2019
2019_C13732,71,79,37,187,2022
2021_C13733,93,60,79,232,2021
2021_B13734,91,78,53,222,2021
2021_C13735,83,68,56,207,2021
2022_B13736,73,81,51,205,2022
2021_B13737,80,62,37,179,2021
2022_A13738,89,73,71,233,2021
2022_A13739,94,88,37,219,2019
2019_B13740,84,72,40,196,2019
2021_C13741,90,83,48,221,2019
2019_B13742,72,94,39,205,2019
2022_C13743,97,87,47,231,2022
2021_A13744,82,66,63,211,2019
2022_A13745,88,64,47,199,2019
2019_C13746,83,71,66,220,2019
2019_A13747,87,78,62,227,2019
2019_B13748,97,73,47,217,2019
2022_A13749,83,70,77,230,2022
2022_B13750,95,85,70,250,2021
2019_C13751,75,58,39,172,2022
2022_C13752,73,89,43,205,2019
2022_C13753,97,50,40,187,2021
2022_B13754,91,84,78,253,2022
2022_A13755,78,54,49,181,2022
2021_A13756,94,90,38,222,2022
2022_B13757,81,63,59,203,2021
2022_C13758,89,47,69,205,2022
2019_C13759,77,66,67,210,2019
2019_B13760,88,96,37,221,2019
2019_C13761,87,92,71,250,2022
2019_C13762,97,73,70,240,2019
2022_A13763,81,69,54,204,2019
2019_A13764,89,85,58,232,2022
2021_B13765,75,80,76,231,2021
2019_A13766,84,89,46,219,2022
2019_C13767,79,53,58,190,2019
2019_B13768,89,52,73,214,2022
2022_A13769,73,75,75,223,2019
2019_C13770,73,53,41,167,2019
2021_C13771,87,59,75,221,2019
2022_B13772,96,96,66,258,2021
2021_C13773,80,60,55,195,2022
2021_A13774,81,54,50,185,2021
2019_C13775,81,80,49,210,2021
2022_B13776,81,79,63,223,2019
2022_B13777,90,90,40,220,2019
2021_C13778,77,88,36,201,2021
2022_C13779,92,61,77,230,2022
2021_B13780,83,96,40,219,2021
2019_B13781,92,63,71,226,2022
2019_C13782,84,78,62,224,2022
2022_B13783,76,81,68,225,2021
2022_C13784,85,49,39,173,2019
2019_C13785,78,56,49,183,2022
2019_C13786,84,96,44,224,2019
2019_B13787,76,69,55,200,2021
2021_B13788,78,84,44,206,2021
2019_A13789,78,78,63,219,2022
2021_B13790,78,77,78,233,2022
2022_C13791,79,51,42,172,2022
2021_C13792,72,63,42,177,2019
2019_C13793,81,46,65,192,2021
2021_C13794,96,47,57,200,2022
2019_C13795,91,67,37,195,2019
2021_A13796,73,56,70,199,2019
2021_B13797,73,62,39,174,2022
2022_C13798,85,83,41,209,2021
2022_B13799,79,53,40,172,2021
2022_C13800,93,69,52,214,2019
2019_C13801,79,83,58,220,2021
2021_A13802,76,93,44,213,2019
2021_A13803,78,51,46,175,2022
2021_C13804,94,89,46,229,2021
2022_B13805,80,95,50,225,2022
2021_A13806,97,86,48,231,2021
2019_C13807,91,60,49,200,2019
2022_A13808,72,75,57,204,2019
2019_C13809,74,69,48,191,2022
2019_B13810,72,47,39,158,2022
2019_A13811,88,65,63,216,2021
2019_C13812,96,84,60,240,2019
2022_B13813,81,57,45,183,2019
2019_B13814,72,63,50,185,2021
2019_A13815,91,84,38,213,2019
2022_B13816,75,80,64,219,2019
2021_C13817,97,62,36,195,2019
2019_B13818,84,80,40,204,2021
2019_A13819,95,46,61,202,2021
2021_C13820,78,49,78,205,2021
2022_B13821,94,88,64,246,2021
2022_C13822,83,96,69,248,2019
2022_B13823,71,55,52,178,2019
2022_C13824,83,77,50,210,2019
2022_C13825,92,79,72,243,2022
2021_C13826,81,74,59,214,2021
2021_A13827,93,58,54,205,2022
2019_A13828,71,85,63,219,2022
2022_A13829,77,70,43,190,2021
2022_A13830,93,78,72,243,2022
2021_B13831,72,65,51,188,2019
2022_C13832,87,47,60,194,2019
2019_A13833,72,80,37,189,2022
2022_A13834,82,67,36,185,2019
2019_A13835,90,81,46,217,2022
2021_A13836,81,84,58,223,2022
2021_A13837,85,75,74,234,2022
2019_A13838,77,53,39,169,2019
2019_C13839,75,93,73,241,2022
2021_B13840,96,91,56,243,2021
2022_B13841,92,68,47,207,2021
2022_B13842,88,70,77,235,2019
2019_C13843,83,78,69,230,2021
2022_A13844,83,89,66,238,2022
2019_A13845,91,64,64,219,2019
2019_B13846,82,91,52,225,2022
2019_C13847,93,66,50,209,2021
2022_A13848,73,59,75,207,2022
2022_C13849,86,57,43,186,2019
2022_A13850,80,51,36,167,2021
2019_A13851,86,68,62,216,2019
2022_C13852,97,68,72,237,2022
2021_C13853,90,57,74,221,2022
2019_B13854,78,93,44,215,2022
2022_A13855,86,85,64,235,2022
2019_C13856,80,81,64,225,2019
2019_A13857,80,56,63,199,2021
2019_A13858,86,51,66,203,2022
2019_A13859,89,88,57,234,2021
2022_A13860,79,95,45,219,2022
2019_B13861,86,68,36,190,2021
2022_B13862,83,60,36,179,2019
2021_A13863,75,67,59,201,2022
2021_A13864,87,91,44,222,2022
2019_B13865,87,64,69,220,2021
2022_B13866,82,62,73,217,2021
2019_C13867,82,86,53,221,2022
2022_B13868,94,57,78,229,2021
2022_A13869,88,59,56,203,2021
2019_B13870,74,64,45,183,2022
2019_B13871,75,53,44,172,2021
2022_A13872,86,83,65,234,2021
2021_A13873,79,67,65,211,2022
2021_B13874,83,82,57,222,2021
2019_B13875,72,60,47,179,2021
2021_B13876,86,82,46,214,2022
2021_B13877,89,56,60,205,2019
2019_B13878,95,70,77,242,2021
2019_B13879,80,60,41,181,2022
2021_C13880,80,51,47,178,2021
2022_A13881,80,76,62,218,2021
2021_A13882,83,79,64,226,2022
2021_C13883,74,71,70,215,2019
2019_B13884,75,45,74,194,2021
2022_A13885,92,63,79,234,2019
2021_A13886,85,63,46,194,2021
2019_A13887,74,90,41,205,2021
2019_A13888,80,56,42,178,2019
2019_B13889,97,46,61,204,2021
2021_C13890,97,75,75,247,2022
2019_C13891,73,84,38,195,2019
2022_B13892,72,68,56,196,2021
2022_A13893,84,63,43,190,2019
2019_C13894,90,96,39,225,2021
2022_C13895,82,56,44,182,2021
2021_B13896,89,66,79,234,2019
2022_C13897,90,55,40,185,2019
2021_A13898,85,71,48,204,2022
2019_B13899,76,96,39,211,2022
2019_A13900,83,58,35,176,2021
2022_C13901,75,81,70,226,2019
2019_A13902,81,65,74,220,2019
2019_C13903,85,69,73,227,2019
2021_A13904,85,62,61,208,2022
2021_B13905,93,70,41,204,2019
2019_C13906,83,79,53,215,2019
2019_A13907,77,54,56,187,2021
2022_A13908,71,79,55,205,2021
2021_A13909,74,51,61,186,2019
2021_B13910,75,85,58,218,2022
2021_B13911,95,96,42,233,2022
2021_B13912,81,93,50,224,2022
2019_C13913,97,68,63,228,2022
2021_A13914,83,90,77,250,2022
2021_A13915,78,74,58,210,2019
2021_B13916,93,59,71,223,2019
2021_A13917,83,87,60,230,2021
2019_A13918,83,70,55,208,2021
2021_A13919,72,64,65,201,2021
2019_C13920,77,45,38,160,2022
2022_B13921,97,48,65,210,2019
2019_B13922,77,80,48,205,2021
2022_A13923,88,76,35,199,2021
2021_B13924,86,54,42,182,2021
2022_B13925,74,93,48,215,2022
2021_C13926,73,82,62,217,2022
2022_B13927,86,51,35,172,2019
2019_A13928,83,50,48,181,2022
2022_A13929,79,77,42,198,2022
2022_B13930,77,71,40,188,2021
2021_C13931,84,55,44,183,2022
2019_C13932,80,62,35,177,2021
2022_A13933,87,68,53,208,2019
2019_B13934,77,94,37,208,2022
2021_B13935,71,85,51,207,2022
2022_B13936,89,61,50,200,2019
2019_C13937,94,56,50,200,2022
2019_C13938,96,72,63,231,2019
2021_A13939,77,70,50,197,2019
2021_B13940,97,60,41,198,2019
2019_A13941,86,81,74,241,2019
2022_A13942,96,49,42,187,2021
2019_A13943,79,59,37,175,2021
2021_B13944,96,84,48,228,2019
2021_C13945,74,78,57,209,2019
2022_A13946,73,58,68,199,2021
2022_A13947,79,46,41,166,2022
2022_A13948,95,49,38,182,2021
2021_A13949,73,58,74,205,2021
2019_C13950,78,92,39,209,2019
2019_C13951,77,48,53,178,2021
2021_A13952,85,88,61,234,2021
2021_B13953,73,62,65,200,2021
2019_C13954,75,61,68,204,2021
2022_B13955,78,87,64,229,2022
2021_C13956,86,72,53,211,2021
2019_C13957,73,86,54,213,2021
2019_C13958,86,84,70,240,2019
2019_A13959,86,83,48,217,2022
2021_B13960,87,65,60,212,2021
2022_A13961,73,93,78,244,2019
2021_B13962,95,61,51,207,2021
2019_B13963,97,58,51,206,2021
2022_B13964,96,67,48,211,2021
2019_A13965,82,69,42,193,2022
2022_C13966,97,89,67,253,2021
2022_B13967,95,92,44,231,2021
2022_A13968,74,82,78,234,2021
2021_B13969,76,86,53,215,2022
2019_C13970,80,66,43,189,2019
2019_A13971,88,90,77,255,2019
2021_A13972,83,91,46,220,2019
2022_C13973,73,94,45,212,2019
2021_C13974,81,91,69,241,2021
2022_A13975,92,87,46,225,2019
2019_C13976,94,56,52,202,2021
2019_B13977,88,57,45,190,2021
2022_A13978,92,77,39,208,2022
2021_A13979,94,93,79,266,2021
2021_B13980,94,90,44,228,2022
2019_B13981,82,71,49,202,2019
2022_B13982,85,67,77,229,2022
2021_C13983,84,81,37,202,2019
2021_B13984,75,81,62,218,2021
2019_C13985,80,45,39,164,2021
2019_A13986,94,69,37,200,2022
2019_A13987,95,89,66,250,2022
2022_A13988,74,76,49,199,2019
2019_A13989,86,88,44,218,2021
2019_A13990,79,68,54,201,2022
2019_C13991,87,87,43,217,2019
2021_B13992,88,93,39,220,2021
2019_A13993,85,81,77,243,2021
2021_A13994,97,48,63,208,2022
2021_C13995,79,51,37,167,2019
2021_A13996,85,73,71,229,2021
2019_C13997,75,74,54,203,2019
2019_B13998,82,71,35,188,2019
2019_A13999,94,57,41,192,2021
2022_B14000,83,61,57,201,2021
2019_C14001,93,64,59,216,2021
2022_A14002,94,90,69,253,2021
2019_B14003,86,92,65,243,2019
2019_A14004,95,83,75,253,2022
2022_B14005,97,95,67,259,2019
2022_B14006,78,54,62,194,2022
2021_B14007,73,70,68,211,2021
2019_A14008,72,95,58,225,2022
2021_A14009,76,75,68,219,2021
2019_C14010,91,55,61,207,2022
2022_C14011,84,65,66,215,2019
2022_A14012,94,45,35,174,2021
2021_A14013,89,94,67,250,2019
2022_B14014,80,50,67,197,2021
2022_B14015,71,48,41,160,2021
2022_B14016,85,59,66,210,2021
2022_B14017,78,52,57,187,2019
2022_C14018,95,64,37,196,2021
2022_C14019,88,95,57,240,2021
2019_B14020,80,49,41,170,2021
2019_B14021,80,65,40,185,2019
2019_C14022,78,53,41,172,2019
2022_B14023,87,85,40,212,2022
2022_A14024,84,67,69,220,2021
2019_B14025,74,78,66,218,2022
2021_C14026,83,68,65,216,2022
2022_C14027,83,65,42,190,2022
2021_B14028,76,71,64,211,2019
2021_A14029,92,74,74,240,2022
2022_A14030,94,88,75,257,2019
2022_A14031,94,72,73,239,2021
2022_A14032,71,91,44,206,2021
2022_C14033,78,51,59,188,2019
2019_C14034,83,78,77,238,2019
2019_A14035,95,90,49,234,2019
2021_A14036,94,56,44,194,2022
2021_B14037,82,45,44,171,2022
2021_B14038,84,47,65,196,2022
2019_C14039,89,78,68,235,2021
2022_A14040,95,76,64,235,2022
2022_B14041,86,60,69,215,2019
2019_B14042,81,72,56,209,2022
2022_A14043,73,66,36,175,2022
2021_B14044,81,94,47,222,2022
2019_A14045,81,54,62,197,2021
2021_B14046,79,56,38,173,2021
2021_A14047,82,73,72,227,2019
2022_C14048,72,53,48,173,2022
2021_A14049,71,87,78,236,2022
2019_C14050,77,64,77,218,2022
2021_C14051,90,51,39,180,2019
2019_B14052,84,45,41,170,2019
2019_C14053,85,45,57,187,2019
2021_A14054,86,79,38,203,2021
2021_B14055,71,91,73,235,2019
2021_B14056,75,60,36,171,2019
2021_A14057,97,78,60,235,2019
2022_B14058,91,53,43,187,2021
2022_C14059,78,67,74,219,2021
2022_A14060,92,86,73,251,2019
2019_B14061,71,61,66,198,2022
2021_A14062,93,95,49,237,2021
2022_C14063,86,53,71,210,2019
2022_C14064,82,86,45,213,2021
2021_B14065,87,52,71,210,2021
2022_B14066,74,83,36,193,2021
2019_B14067,93,80,65,238,2021
2022_A14068,87,50,49,186,2019
2022_B14069,78,84,55,217,2019
2022_C14070,88,93,35,216,2019
2021_B14071,74,78,36,188,2019
2021_C14072,96,72,69,237,2019
2022_C14073,76,85,50,211,2021
2019_A14074,95,66,60,221,2019
2019_A14075,71,53,70,194,2022
2019_C14076,79,84,51,214,2019
2019_C14077,79,46,67,192,2021
2019_C14078,81,60,66,207,2021
2019_C14079,81,88,56,225,2021
2021_B14080,87,78,76,241,2019
2019_B14081,72,69,44,185,2021
2019_A14082,79,72,52,203,2021
2021_A14083,71,47,43,161,2019
2019_A14084,75,75,56,206,2019
2022_B14085,79,85,42,206,2019
2021_B14086,77,62,55,194,2022
2022_C14087,88,91,38,217,2021
2022_C14088,92,95,54,241,2019
2021_C14089,75,79,75,229,2022
2022_B14090,95,52,45,192,2022
2019_A14091,83,93,44,220,2022
2022_A14092,72,52,55,179,2019
2021_B14093,74,59,43,176,2019
2022_A14094,80,60,50,190,2019
2022_A14095,82,71,50,203,2022
2022_C14096,73,47,76,196,2022
2021_B14097,76,82,75,233,2019
2019_A14098,79,92,76,247,2022
2022_C14099,83,57,52,192,2019
2022_B14100,76,62,47,185,2022
2019_B14101,96,55,51,202,2022
2019_B14102,87,64,37,188,2022
2022_A14103,72,48,44,164,2022
2022_C14104,80,73,51,204,2019
2019_C14105,95,66,67,228,2021
2019_B14106,85,87,58,230,2021
2022_C14107,96,88,50,234,2021
2022_B14108,85,78,68,231,2019
2021_B14109,72,54,53,179,2022
2022_C14110,88,92,43,223,2022
2021_B14111,78,47,47,172,2022
2019_A14112,72,63,72,207,2022
2022_B14113,75,92,78,245,2021
2019_C14114,88,63,51,202,2021
2022_B14115,87,74,57,218,2022
2021_B14116,94,79,41,214,2021
2022_B14117,72,82,78,232,2022
2021_A14118,71,51,77,199,2021
2019_C14119,88,88,54,230,2022
2022_C14120,72,74,38,184,2021
2021_B14121,71,94,51,216,2019
2022_C14122,93,68,67,228,2022
2022_B14123,81,84,62,227,2019
2022_C14124,72,57,40,169,2019
2019_C14125,71,75,59,205,2019
2019_A14126,90,85,64,239,2022
2019_B14127,94,50,74,218,2021
2021_A14128,94,54,43,191,2022
2021_B14129,77,46,58,181,2021
2022_A14130,86,95,79,260,2019
2021_C14131,84,52,36,172,2021
2022_B14132,96,65,71,232,2022
2022_B14133,86,73,77,236,2022
2021_B14134,76,58,73,207,2021
2022_A14135,85,54,76,215,2019
2022_C14136,85,74,71,230,2021
2022_B14137,71,65,37,173,2022
2021_B14138,75,61,53,189,2021
2022_A14139,75,48,48,171,2022
2022_A14140,76,96,59,231,2019
2019_C14141,72,80,67,219,2021
2022_B14142,96,83,50,229,2022
2019_C14143,92,77,39,208,2021
2021_C14144,85,46,38,169,2022
2022_C14145,95,83,46,224,2019
2022_A14146,97,93,44,234,2019
2022_C14147,85,61,59,205,2019
2021_B14148,77,75,76,228,2022
2022_A14149,74,48,37,159,2021
2019_C14150,75,54,36,165,2019
2019_C14151,85,79,46,210,2022
2021_C14152,82,67,52,201,2022
2019_A14153,92,68,35,195,2019
2019_A14154,75,89,47,211,2019
2019_B14155,93,81,43,217,2022
2021_B14156,73,53,63,189,2022
2019_B14157,77,58,65,200,2019
2022_B14158,93,52,41,186,2021
2019_A14159,73,66,37,176,2019
2019_A14160,91,71,67,229,2022
2022_B14161,71,53,56,180,2021
2019_A14162,85,78,44,207,2022
2021_C14163,76,94,37,207,2021
2019_C14164,80,74,60,214,2021
2019_B14165,72,80,77,229,2022
2022_A14166,92,90,74,256,2022
2019_C14167,80,46,63,189,2022
2019_A14168,72,82,77,231,2019
2022_A14169,85,77,43,205,2019
2022_B14170,72,82,59,213,2021
2021_B14171,82,59,54,195,2022
2022_B14172,88,62,42,192,2021
2019_B14173,87,54,52,193,2019
2022_B14174,74,46,69,189,2022
2019_B14175,82,45,40,167,2019
2019_B14176,91,75,57,223,2021
2022_B14177,93,70,79,242,2022
2021_C14178,75,75,59,209,2019
2022_A14179,97,67,46,210,2019
2021_C14180,76,51,54,181,2019
2021_A14181,88,61,46,195,2021
2019_C14182,75,73,52,200,2021
2019_A14183,90,85,60,235,2022
2019_B14184,76,57,64,197,2019
2019_C14185,89,58,54,201,2022
2022_A14186,75,85,74,234,2019
2019_A14187,78,60,36,174,2019
2019_B14188,82,63,74,219,2022
2021_B14189,86,94,54,234,2019
2019_B14190,90,51,62,203,2022
2021_A14191,78,60,71,209,2022
2021_B14192,94,49,41,184,2021
2021_C14193,74,88,68,230,2019
2021_B14194,73,94,57,224,2022
2019_C14195,85,81,66,232,2019
2022_B14196,80,82,76,238,2021
2019_A14197,75,90,79,244,2022
2021_A14198,90,90,39,219,2022
2019_C14199,88,83,68,239,2021
2022_C14200,72,95,71,238,2019
2019_A14201,97,81,49,227,2019
2019_A14202,96,49,49,194,2022
2022_B14203,81,59,47,187,2021
2021_C14204,73,58,54,185,2022
2022_B14205,74,83,55,212,2019
2021_B14206,71,56,58,185,2022
2022_C14207,81,72,55,208,2019
2022_B14208,88,53,76,217,2021
2022_A14209,73,61,46,180,2019
2019_C14210,85,81,61,227,2019
2019_A14211,82,73,46,201,2019
2022_A14212,71,47,54,172,2021
2022_C14213,85,57,38,180,2019
2022_C14214,79,75,41,195,2022
2021_C14215,94,88,56,238,2021
2022_A14216,92,80,38,210,2022
2021_B14217,89,51,64,204,2019
2021_B14218,86,47,40,173,2019
2019_A14219,80,92,78,250,2021
2019_A14220,75,68,40,183,2019
2022_A14221,94,49,63,206,2019
2019_A14222,90,53,56,199,2021
2022_B14223,79,94,70,243,2022
2021_A14224,84,49,73,206,2021
2021_C14225,91,49,39,179,2021
2019_B14226,74,66,39,179,2022
2021_B14227,81,52,52,185,2019
2019_A14228,87,58,52,197,2019
2021_C14229,97,60,72,229,2021
2022_B14230,92,59,78,229,2022
2019_B14231,77,75,77,229,2019
2019_B14232,93,51,49,193,2019
2019_C14233,77,57,77,211,2021
2021_A14234,96,93,66,255,2019
2019_B14235,97,55,59,211,2022
2019_B14236,93,56,69,218,2019
2021_B14237,93,93,41,227,2019
2021_C14238,92,69,76,237,2022
2021_B14239,83,72,77,232,2019
2019_C14240,96,76,58,230,2019
2021_B14241,76,67,61,204,2022
2022_A14242,92,96,44,232,2019
2021_B14243,97,57,77,231,2019
2021_A14244,76,95,61,232,2021
2021_A14245,94,69,75,238,2021
2019_A14246,84,93,43,220,2019
2021_C14247,95,94,76,265,2022
2021_B14248,80,93,56,229,2022
2021_C14249,92,71,41,204,2022
2019_B14250,87,71,77,235,2021
2021_B14251,88,75,37,200,2019
2022_C14252,81,60,39,180,2021
2019_A14253,83,75,67,225,2021
2022_C14254,91,72,79,242,2019
2022_C14255,91,54,64,209,2019
2021_A14256,88,68,53,209,2021
2019_A14257,76,74,39,189,2021
2021_B14258,86,76,63,225,2019
2019_B14259,77,80,73,230,2021
2022_B14260,87,75,42,204,2021
2021_C14261,86,85,64,235,2019
2021_B14262,72,69,37,178,2022
2019_B14263,89,85,45,219,2022
2021_C14264,85,48,72,205,2019
2022_A14265,79,79,78,236,2019
2022_B14266,88,53,57,198,2022
2019_B14267,92,82,68,242,2019
2019_A14268,72,87,62,221,2022
2021_B14269,80,61,61,202,2021
2021_A14270,80,57,54,191,2019
2019_C14271,87,56,43,186,2022
2021_A14272,79,55,63,197,2022
2022_C14273,77,79,49,205,2021
2019_B14274,80,91,39,210,2019
2022_A14275,90,50,45,185,2022
2021_C14276,78,84,79,241,2022
2022_C14277,82,82,51,215,2021
2022_B14278,77,67,51,195,2019
2021_B14279,82,91,40,213,2022
2019_A14280,76,67,40,183,2019
2021_C14281,71,76,40,187,2021
2022_A14282,79,46,63,188,2021
2019_C14283,71,89,48,208,2019
2019_B14284,85,75,55,215,2019
2021_C14285,93,70,62,225,2022
2019_C14286,75,73,79,227,2022
2021_C14287,96,61,58,215,2021
2021_C14288,71,52,45,168,2019
2022_C14289,91,67,67,225,2022
2019_A14290,94,91,63,248,2019
2021_C14291,78,72,77,227,2019
2021_B14292,80,63,78,221,2021
2021_B14293,71,47,43,161,2019
2019_B14294,84,84,41,209,2019
2022_C14295,73,89,71,233,2019
2022_B14296,97,86,76,259,2022
2021_A14297,82,58,73,213,2021
2019_B14298,86,50,39,175,2021
2019_C14299,76,62,55,193,2019
2021_C14300,76,83,44,203,2022
2022_B14301,71,64,38,173,2021
2019_A14302,72,67,67,206,2021
2019_C14303,84,84,61,229,2021
2021_B14304,77,55,62,194,2022
2019_A14305,79,72,46,197,2019
2022_B14306,77,82,50,209,2021
2022_B14307,88,74,65,227,2021
2019_A14308,95,47,43,185,2021
2021_A14309,76,88,63,227,2022
2022_A14310,76,55,59,190,2022
2022_C14311,86,57,43,186,2021
2021_A14312,71,83,46,200,2021
2022_B14313,72,68,50,190,2019
2022_C14314,97,45,35,177,2022
2021_A14315,74,59,78,211,2022
2019_A14316,77,48,54,179,2022
2022_A14317,83,74,37,194,2022
2019_C14318,87,72,53,212,2021
2022_C14319,95,55,61,211,2022
2021_C14320,97,60,71,228,2022
2022_A14321,85,57,72,214,2019
2021_C14322,93,87,35,215,2022
2019_B14323,89,68,50,207,2021
2022_B14324,82,63,56,201,2022
2022_B14325,81,66,38,185,2021
2019_C14326,97,64,55,216,2021
2022_C14327,84,81,51,216,2019
2019_B14328,90,82,78,250,2021
2019_C14329,80,57,46,183,2019
2022_C14330,91,48,65,204,2022
2021_C14331,88,51,45,184,2022
2022_A14332,96,47,55,198,2021
2019_B14333,84,56,60,200,2019
2022_A14334,93,86,63,242,2021
2021_C14335,85,87,50,222,2019
2019_B14336,72,59,63,194,2019
2019_A14337,81,48,52,181,2022
2021_C14338,77,72,79,228,2021
2019_B14339,75,55,41,171,2019
2021_B14340,81,87,40,208,2022
2021_A14341,87,46,68,201,2022
2019_C14342,71,48,40,159,2019
2022_A14343,97,77,49,223,2021
2022_C14344,74,88,64,226,2022
2022_A14345,71,66,43,180,2021
2021_A14346,93,48,71,212,2021
2021_C14347,87,87,46,220,2019
2019_C14348,96,46,73,215,2021
2022_A14349,84,52,48,184,2019
2019_C14350,78,55,47,180,2022
2022_B14351,84,49,69,202,2019
2022_C14352,95,86,51,232,2022
2022_B14353,82,91,55,228,2019
2021_A14354,74,46,46,166,2021
2021_A14355,91,66,61,218,2021
2021_C14356,73,83,64,220,2022
2021_C14357,71,91,67,229,2019
2022_C14358,89,77,61,227,2022
2021_A14359,81,56,44,181,2021
2022_A14360,75,53,77,205,2022
2022_B14361,95,71,78,244,2021
2021_C14362,76,60,51,187,2019
2022_A14363,72,92,35,199,2022
2019_C14364,96,88,71,255,2021
2019_B14365,96,66,64,226,2022
2019_B14366,94,83,67,244,2019
2019_B14367,96,85,75,256,2022
2022_A14368,92,50,74,216,2021
2019_A14369,93,85,60,238,2021
2021_A14370,79,74,67,220,2019
2022_B14371,91,61,63,215,2019
2022_A14372,95,81,73,249,2019
2022_C14373,71,48,71,190,2021
2019_B14374,85,67,44,196,2022
2022_C14375,80,60,72,212,2021
2022_B14376,79,85,69,233,2019
2021_B14377,97,88,69,254,2022
2022_B14378,91,65,79,235,2021
2019_A14379,97,82,75,254,2022
2019_B14380,75,62,76,213,2022
2022_C14381,84,67,67,218,2022
2022_B14382,88,90,62,240,2022
2022_A14383,86,75,67,228,2022
2019_B14384,72,59,72,203,2021
2022_A14385,80,71,67,218,2022
2019_B14386,90,90,58,238,2021
2019_C14387,90,71,37,198,2019
2019_C14388,72,48,38,158,2022
2019_B14389,95,85,66,246,2019
2019_B14390,71,61,38,170,2021
2022_B14391,97,63,72,232,2021
2019_B14392,73,70,67,210,2022
2019_A14393,95,84,54,233,2022
2019_A14394,76,67,79,222,2022
2019_C14395,72,76,61,209,2019
2021_C14396,97,86,67,250,2021
2021_B14397,89,61,61,211,2021
2022_B14398,76,51,69,196,2022
2019_C14399,75,69,64,208,2021
2022_C14400,97,61,38,196,2019
2021_C14401,96,86,70,252,2021
2022_B14402,92,85,62,239,2022
2022_B14403,74,65,65,204,2019
2021_C14404,88,88,77,253,2019
2022_B14405,75,67,41,183,2019
2021_B14406,95,84,36,215,2022
2019_A14407,71,92,50,213,2021
2019_A14408,73,71,72,216,2022
2021_C14409,96,86,73,255,2019
2021_A14410,72,80,40,192,2022
2021_C14411,93,49,40,182,2019
2021_A14412,86,46,40,172,2021
2019_A14413,82,76,54,212,2019
2022_B14414,97,55,67,219,2022
2022_B14415,87,58,63,208,2022
2021_C14416,95,66,59,220,2022
2021_B14417,92,68,47,207,2019
2022_A14418,87,91,36,214,2021
2022_A14419,84,53,72,209,2019
2019_B14420,76,53,47,176,2021
2019_C14421,94,56,65,215,2021
2019_C14422,95,71,61,227,2019
2022_A14423,91,76,54,221,2022
2021_B14424,85,76,46,207,2021
2021_B14425,92,51,79,222,2019
2019_B14426,96,54,65,215,2022
2022_A14427,86,71,57,214,2022
2022_B14428,86,58,37,181,2022
2022_B14429,79,90,65,234,2021
2021_B14430,83,90,43,216,2019
2019_B14431,80,51,54,185,2022
2021_B14432,96,89,68,253,2022
2019_C14433,83,78,50,211,2022
2022_A14434,78,71,40,189,2022
2022_A14435,75,81,45,201,2022
2019_C14436,80,60,50,190,2022
2022_A14437,83,89,79,251,2022
2021_A14438,80,70,77,227,2021
2021_A14439,79,63,79,221,2021
2022_C14440,85,59,66,210,2021
2022_C14441,94,48,78,220,2021
2019_B14442,97,71,54,222,2022
2019_C14443,90,47,39,176,2022
2021_C14444,92,76,51,219,2022
2021_A14445,90,52,47,189,2022
2019_A14446,88,59,42,189,2022
2021_B14447,88,83,35,206,2021
2021_B14448,92,45,77,214,2019
2019_A14449,74,94,69,237,2022
2021_C14450,82,91,66,239,2019
2019_C14451,78,67,67,212,2022
2019_C14452,74,73,49,196,2021
2022_A14453,96,48,53,197,2019
2021_B14454,86,46,66,198,2019
2021_B14455,86,75,53,214,2021
2019_C14456,81,74,43,198,2019
2022_B14457,84,86,69,239,2021
2019_A14458,91,60,51,202,2022
2021_C14459,75,56,50,181,2019
2019_A14460,94,69,46,209,2022
2021_A14461,91,76,36,203,2022
2021_B14462,84,96,51,231,2021
2021_A14463,94,61,39,194,2021
2021_C14464,93,60,41,194,2022
2021_C14465,77,77,61,215,2021
2021_B14466,93,70,49,212,2019
2022_A14467,85,79,41,205,2021
2022_C14468,97,95,35,227,2021
2021_A14469,80,96,53,229,2021
2019_C14470,77,86,53,216,2019
2019_A14471,94,91,43,228,2022
2022_C14472,75,76,43,194,2019
2019_C14473,89,86,64,239,2022
2021_B14474,89,45,54,188,2021
2019_B14475,82,93,77,252,2022
2019_C14476,89,92,69,250,2019
2022_A14477,77,96,55,228,2019
2022_A14478,83,79,55,217,2022
2021_A14479,83,45,67,195,2022
2019_B14480,86,84,55,225,2021
2021_C14481,75,84,45,204,2019
2019_C14482,96,74,40,210,2022
2022_C14483,95,94,67,256,2019
2019_A14484,90,48,57,195,2022
2021_C14485,72,81,67,220,2022
2021_C14486,94,79,47,220,2019
2019_A14487,92,82,62,236,2019
2022_A14488,95,89,61,245,2022
2019_C14489,80,95,45,220,2019
2021_C14490,87,47,47,181,2019
2022_C14491,74,85,63,222,2019
2022_B14492,74,95,77,246,2021
2022_B14493,86,50,77,213,2019
2021_C14494,90,68,46,204,2019
2022_C14495,92,56,49,197,2022
2019_A14496,75,90,54,219,2021
2019_C14497,85,76,61,222,2022
2022_A14498,93,69,77,239,2019
2021_B14499,78,49,46,173,2021
2021_B14500,85,68,77,230,2021
2019_C14501,90,60,63,213,2019
2021_A14502,79,72,71,222,2021
2022_C14503,87,83,47,217,2021
2021_C14504,83,87,38,208,2019
2022_C14505,92,92,57,241,2019
2022_A14506,90,74,58,222,2022
2021_C14507,92,69,64,225,2021
2022_C14508,71,80,37,188,2022
2022_B14509,84,67,44,195,2019
2021_B14510,92,73,50,215,2022
2021_A14511,83,75,71,229,2019
2022_B14512,84,46,35,165,2022
2019_C14513,84,86,54,224,2022
2022_C14514,82,93,68,243,2021
2022_A14515,71,57,67,195,2019
2022_A14516,86,56,61,203,2021
2021_B14517,75,82,68,225,2019
2021_A14518,96,45,55,196,2019
2022_B14519,91,94,46,231,2021
2019_C14520,86,57,44,187,2019
2021_C14521,93,56,40,189,2019
2022_C14522,78,62,38,178,2022
2022_B14523,87,91,54,232,2019
2021_A14524,86,94,44,224,2021
2021_B14525,73,58,76,207,2022
2019_A14526,86,54,63,203,2021
2021_C14527,75,56,54,185,2021
2019_A14528,97,81,70,248,2019
2021_B14529,86,96,60,242,2019
2019_C14530,75,82,39,196,2021
2022_C14531,86,94,70,250,2019
2019_C14532,90,51,55,196,2021
2021_A14533,85,45,48,178,2019
2022_C14534,82,96,36,214,2022
2019_A14535,95,54,68,217,2019
2021_B14536,76,93,56,225,2022
2022_B14537,82,88,55,225,2019
2021_A14538,96,78,40,214,2022
2022_A14539,84,93,54,231,2019
2021_A14540,91,52,67,210,2019
2021_B14541,92,95,73,260,2019
2021_B14542,82,78,46,206,2022
2022_B14543,92,73,75,240,2021
2021_C14544,85,55,78,218,2022
2019_C14545,89,49,64,202,2022
2019_C14546,80,63,45,188,2021
2021_B14547,84,46,78,208,2021
2022_C14548,78,80,41,199,2019
2022_C14549,86,96,72,254,2019
2021_B14550,81,87,53,221,2021
2022_A14551,89,58,69,216,2021
2022_A14552,95,89,39,223,2022
2022_A14553,71,51,75,197,2021
2019_C14554,84,53,60,197,2019
2021_B14555,91,77,57,225,2019
2022_C14556,88,55,64,207,2019
2019_A14557,71,53,53,177,2021
2021_B14558,93,95,44,232,2022
2022_C14559,77,88,77,242,2022
2019_C14560,95,50,54,199,2022
2021_B14561,72,63,58,193,2022
2019_A14562,73,75,38,186,2019
2021_B14563,80,70,79,229,2022
2019_B14564,74,85,69,228,2022
2022_B14565,97,46,43,186,2022
2022_A14566,87,75,43,205,2021
2019_A14567,85,46,41,172,2022
2021_C14568,82,63,51,196,2022
2019_A14569,77,91,79,247,2021
2022_C14570,83,87,68,238,2022
2019_A14571,90,50,74,214,2021
2019_A14572,94,94,67,255,2022
2021_A14573,75,67,73,215,2022
2022_B14574,95,68,78,241,2019
2019_A14575,93,64,59,216,2022
2022_B14576,83,52,71,206,2022
2019_C14577,84,61,53,198,2019
2019_C14578,78,64,35,177,2021
2021_C14579,72,67,57,196,2019
2022_A14580,71,76,79,226,2019
2019_A14581,81,88,45,214,2021
2022_A14582,85,95,79,259,2019
2022_A14583,89,48,64,201,2022
2021_C14584,95,71,75,241,2021
2019_C14585,93,60,67,220,2022
2019_B14586,78,59,77,214,2021
2022_C14587,93,72,46,211,2022
2021_B14588,97,91,43,231,2019
2022_B14589,92,85,51,228,2021
2021_C14590,78,45,78,201,2022
2022_B14591,87,49,79,215,2021
2022_B14592,87,87,44,218,2021
2021_C14593,89,76,51,216,2021
2019_C14594,87,85,37,209,2022
2019_C14595,81,58,78,217,2021
2021_A14596,93,82,41,216,2019
2019_B14597,76,52,72,200,2019
2021_B14598,90,59,70,219,2019
2019_B14599,90,83,65,238,2022
2019_B14600,77,72,44,193,2019
2022_B14601,79,72,46,197,2019
2021_A14602,90,51,58,199,2022
2019_C14603,96,83,67,246,2021
2021_C14604,86,52,72,210,2021
2019_B14605,90,75,63,228,2022
2022_B14606,78,52,54,184,2021
2021_C14607,77,72,75,224,2019
2022_A14608,72,80,63,215,2022
2021_B14609,81,66,62,209,2022
2019_B14610,96,82,52,230,2022
2021_A14611,96,89,63,248,2021
2022_C14612,96,52,36,184,2021
2019_C14613,76,57,51,184,2021
2019_C14614,79,76,66,221,2022
2022_C14615,94,68,44,206,2022
2021_B14616,76,79,61,216,2021
2019_B14617,94,56,68,218,2022
2022_B14618,81,77,51,209,2022
2019_A14619,77,48,74,199,2021
2019_A14620,77,78,55,210,2022
2022_C14621,96,54,38,188,2021
2022_B14622,85,84,44,213,2021
2022_A14623,92,68,49,209,2021
2022_A14624,91,55,63,209,2022
2022_B14625,71,89,62,222,2022
2021_B14626,81,72,37,190,2021
2022_B14627,89,81,47,217,2019
2021_A14628,76,59,44,179,2019
2021_C14629,81,77,41,199,2021
2021_C14630,84,60,63,207,2022
2019_B14631,79,61,48,188,2021
2021_B14632,72,82,42,196,2019
2021_C14633,81,57,56,194,2021
2019_A14634,86,51,46,183,2019
2022_A14635,85,60,40,185,2021
2021_A14636,72,90,72,234,2021
2021_A14637,92,71,45,208,2021
2021_C14638,72,93,56,221,2019
2022_A14639,92,96,59,247,2021
2021_A14640,80,61,49,190,2019
2022_C14641,80,59,69,208,2019
2022_A14642,78,48,58,184,2021
2021_A14643,95,82,49,226,2021
2022_B14644,88,70,79,237,2021
2021_C14645,78,72,78,228,2022
2019_B14646,88,69,46,203,2022
2021_A14647,86,70,68,224,2022
2022_B14648,84,64,73,221,2021
2019_A14649,97,88,63,248,2021
2021_C14650,77,61,36,174,2019
2022_A14651,96,72,41,209,2021
2019_B14652,93,83,77,253,2019
2021_B14653,97,83,68,248,2019
2019_C14654,79,74,66,219,2019
2019_A14655,76,94,76,246,2021
2022_C14656,75,52,63,190,2022
2019_C14657,86,85,42,213,2019
2022_A14658,95,87,66,248,2022
2019_B14659,82,55,59,196,2019
2019_B14660,92,72,65,229,2019
2022_C14661,74,95,46,215,2019
2021_B14662,92,60,48,200,2021
2019_C14663,74,59,50,183,2019
2019_C14664,95,49,75,219,2021
2021_B14665,83,72,49,204,2021
2022_C14666,88,50,75,213,2022
2021_A14667,74,79,78,231,2019
2021_B14668,75,55,78,208,2021
2021_A14669,84,73,47,204,2021
2021_B14670,72,70,41,183,2022
2021_B14671,97,93,78,268,2019
2021_A14672,95,47,61,203,2019
2022_B14673,91,95,79,265,2022
2019_A14674,87,85,72,244,2021
2019_C14675,72,76,36,184,2022
2019_B14676,94,72,38,204,2022
2022_A14677,86,50,65,201,2022
2022_B14678,76,93,56,225,2019
2021_C14679,82,95,39,216,2019
2019_B14680,88,75,78,241,2019
2019_C14681,90,56,57,203,2019
2019_C14682,77,70,72,219,2022
2021_C14683,90,74,56,220,2021
2021_C14684,95,62,45,202,2022
2022_A14685,84,73,51,208,2021
2021_B14686,94,89,74,257,2022
2021_A14687,95,58,56,209,2021
2019_A14688,94,77,62,233,2021
2022_B14689,72,78,68,218,2022
2021_A14690,83,49,39,171,2021
2022_B14691,91,46,68,205,2021
2019_B14692,91,46,39,176,2021
2021_B14693,84,96,60,240,2021
2019_B14694,77,75,66,218,2019
2022_C14695,94,74,74,242,2021
2021_A14696,75,64,64,203,2021
2022_C14697,93,82,63,238,2019
2021_A14698,79,95,45,219,2022
2022_C14699,87,73,57,217,2019
2021_B14700,91,96,54,241,2021
2019_A14701,83,89,50,222,2019
2022_C14702,77,95,70,242,2022
2019_B14703,72,78,79,229,2021
2022_A14704,93,92,74,259,2022
2019_C14705,90,86,58,234,2021
2022_B14706,88,48,52,188,2019
2021_B14707,91,82,42,215,2019
2021_C14708,85,83,52,220,2019
2019_C14709,79,53,76,208,2019
2021_A14710,92,79,66,237,2022
2022_A14711,74,79,72,225,2021
2019_C14712,87,82,61,230,2019
2019_C14713,95,65,59,219,2019
2022_C14714,84,62,41,187,2022
2021_B14715,79,93,53,225,2021
2022_C14716,71,75,66,212,2019
2019_A14717,87,61,66,214,2022
2022_A14718,89,69,59,217,2021
2019_C14719,80,45,62,187,2022
2022_C14720,90,88,72,250,2021
2021_A14721,85,72,68,225,2022
2022_C14722,80,92,51,223,2021
2022_A14723,86,55,52,193,2019
2022_C14724,78,69,46,193,2019
2021_A14725,79,62,68,209,2019
2022_B14726,78,94,77,249,2019
2022_A14727,76,65,63,204,2022
2021_C14728,84,93,79,256,2019
2021_A14729,74,49,79,202,2019
2022_A14730,93,48,62,203,2019
2019_A14731,78,89,75,242,2022
2021_C14732,96,84,72,252,2021
2021_B14733,76,79,74,229,2021
2022_B14734,80,49,62,191,2022
2022_B14735,85,92,47,224,2019
2021_C14736,97,75,53,225,2022
2022_A14737,88,80,39,207,2022
2022_A14738,71,49,65,185,2022
2019_C14739,96,60,76,232,2022
2022_B14740,88,79,64,231,2021
2019_B14741,75,64,70,209,2021
2019_A14742,72,73,46,191,2021
2021_C14743,81,89,75,245,2019
2019_C14744,73,70,48,191,2019
2019_C14745,86,96,39,221,2019
2022_B14746,75,45,73,193,2021
2022_B14747,82,90,58,230,2021
2022_C14748,80,74,79,233,2022
2022_C14749,89,54,48,191,2019
2022_C14750,89,67,44,200,2019
2022_A14751,90,74,41,205,2021
2022_C14752,73,76,64,213,2019
2019_A14753,82,91,39,212,2022
2022_C14754,93,64,44,201,2022
2019_A14755,73,79,70,222,2022
2022_B14756,94,70,52,216,2022
2021_C14757,89,70,65,224,2021
2022_A14758,81,92,47,220,2019
2019_A14759,74,83,46,203,2021
2021_B14760,95,57,61,213,2019
2019_A14761,77,79,54,210,2022
2022_A14762,97,61,62,220,2019
2019_B14763,74,81,52,207,2021
2021_A14764,72,81,53,206,2019
2022_C14765,86,85,74,245,2019
2019_B14766,86,52,49,187,2021
2021_C14767,89,69,74,232,2021
2019_B14768,86,95,60,241,2019
2022_C14769,90,81,75,246,2022
2019_B14770,93,88,53,234,2021
2021_B14771,86,66,40,192,2022
2021_A14772,84,94,75,253,2019
2019_A14773,77,79,47,203,2019
2021_C14774,88,73,55,216,2022
2022_B14775,83,57,61,201,2021
2022_C14776,89,82,48,219,2022
2019_B14777,73,91,48,212,2021
2019_A14778,80,87,63,230,2022
2021_C14779,71,53,43,167,2019
2022_C14780,85,58,74,217,2021
2022_B14781,89,92,45,226,2021
2021_B14782,75,83,68,226,2022
2022_B14783,84,92,76,252,2019
2022_B14784,85,88,55,228,2022
2022_B14785,83,83,77,243,2019
2019_C14786,90,62,78,230,2021
2022_A14787,94,61,38,193,2021
2019_C14788,81,81,67,229,2021
2021_C14789,79,70,45,194,2022
2022_C14790,80,80,45,205,2021
2019_B14791,92,48,62,202,2019
2019_A14792,87,73,48,208,2021
2022_A14793,88,91,46,225,2022
2019_C14794,79,68,63,210,2021
2022_C14795,82,52,64,198,2019
2019_A14796,79,49,54,182,2021
2021_A14797,88,77,65,230,2022
2022_C14798,78,62,60,200,2022
2021_A14799,85,72,37,194,2019
2022_C14800,84,52,57,193,2019
2019_B14801,86,65,45,196,2021
2022_A14802,84,60,61,205,2019
2019_C14803,79,96,68,243,2021
2019_A14804,79,60,45,184,2021
2022_A14805,77,68,39,184,2021
2021_B14806,77,63,44,184,2022
2019_C14807,75,64,40,179,2019
2021_B14808,92,81,73,246,2021
2021_C14809,87,93,36,216,2021
2021_A14810,90,91,45,226,2019
2022_A14811,87,48,70,205,2022
2019_A14812,85,53,46,184,2022
2021_C14813,74,94,77,245,2021
2021_C14814,95,47,54,196,2019
2019_A14815,73,45,61,179,2022
2022_B14816,93,61,40,194,2019
2021_C14817,73,88,66,227,2019
2019_B14818,85,93,62,240,2019
2019_C14819,76,49,62,187,2019
2022_C14820,84,67,68,219,2019
2022_C14821,78,48,79,205,2021
2022_B14822,85,47,58,190,2022
2021_B14823,73,68,71,212,2022
2021_B14824,80,57,50,187,2019
2021_A14825,88,63,43,194,2019
2021_B14826,75,77,69,221,2019
2021_A14827,74,58,68,200,2021
2022_C14828,96,86,78,260,2021
2019_C14829,83,96,61,240,2021
2019_A14830,83,49,40,172,2021
2021_A14831,76,78,52,206,2019
2021_C14832,87,67,63,217,2022
2021_A14833,87,74,57,218,2019
2022_C14834,71,71,76,218,2021
2021_B14835,78,88,41,207,2021
2019_B14836,76,86,71,233,2022
2019_C14837,73,65,52,190,2022
2022_C14838,96,86,67,249,2022
2022_C14839,93,51,50,194,2019
2019_B14840,96,64,71,231,2021
2019_A14841,74,71,68,213,2019
2019_A14842,90,94,67,251,2019
2019_B14843,96,57,78,231,2022
2022_A14844,94,49,73,216,2019
2022_A14845,95,77,68,240,2022
2019_C14846,79,57,64,200,2021
2022_A14847,72,80,52,204,2021
2019_C14848,94,87,72,253,2022
2022_C14849,86,71,38,195,2022
2022_B14850,91,74,58,223,2019
2022_C14851,87,65,67,219,2022
2022_A14852,95,89,46,230,2022
2019_B14853,75,79,63,217,2021
2022_A14854,90,64,67,221,2019
2022_A14855,90,84,76,250,2021
2021_C14856,81,70,71,222,2022
2019_B14857,84,72,39,195,2019
2021_A14858,77,84,47,208,2022
2019_C14859,79,79,47,205,2021
2022_C14860,88,69,79,236,2022
2019_A14861,90,60,78,228,2022
2022_B14862,80,55,68,203,2019
2021_A14863,75,48,74,197,2022
2021_A14864,84,80,57,221,2021
2021_A14865,82,68,66,216,2021
2022_C14866,95,54,74,223,2022
2022_B14867,76,82,46,204,2022
2021_A14868,75,84,54,213,2022
2022_C14869,85,47,61,193,2022
2021_A14870,85,58,46,189,2022
2021_C14871,91,63,75,229,2022
2022_A14872,82,59,53,194,2022
2022_B14873,82,70,77,229,2021
2021_A14874,85,54,45,184,2019
2019_A14875,82,64,70,216,2019
2019_B14876,86,51,52,189,2021
2022_A14877,94,45,76,215,2022
2022_B14878,76,75,49,200,2021
2021_C14879,92,92,70,254,2019
2021_C14880,91,71,48,210,2022
2019_A14881,88,66,67,221,2021
2022_B14882,76,74,69,219,2019
2022_B14883,93,77,76,246,2019
2022_C14884,78,91,66,235,2021
2021_A14885,79,78,77,234,2021
2019_C14886,95,85,76,256,2022
2019_A14887,71,51,55,177,2021
2021_C14888,78,75,38,191,2019
2019_B14889,78,84,72,234,2021
2021_A14890,82,86,75,243,2022
2019_C14891,91,91,58,240,2021
2021_C14892,74,93,73,240,2019
2019_C14893,72,79,47,198,2022
2021_C14894,73,47,70,190,2021
2021_B14895,95,82,66,243,2019
2019_A14896,73,73,70,216,2021
2021_B14897,86,76,56,218,2022
2021_A14898,95,57,50,202,2021
2019_A14899,72,76,65,213,2019
2021_B14900,89,52,63,204,2021
2021_C14901,72,59,49,180,2021
2019_B14902,79,54,56,189,2019
2021_B14903,93,79,68,240,2019
2021_B14904,85,80,40,205,2019
2022_A14905,78,67,71,216,2019
2019_A14906,85,51,44,180,2022
2022_B14907,83,59,78,220,2021
2022_C14908,79,73,35,187,2019
2019_C14909,74,59,78,211,2019
2021_C14910,72,88,47,207,2021
2022_C14911,88,83,50,221,2021
2021_C14912,94,95,63,252,2022
2021_A14913,83,51,51,185,2022
2022_A14914,72,82,68,222,2019
2022_C14915,71,77,79,227,2019
2019_A14916,83,57,79,219,2022
2022_B14917,78,52,52,182,2019
2022_A14918,79,55,50,184,2021
2021_A14919,80,48,76,204,2021
2022_C14920,86,52,62,200,2019
2022_A14921,90,68,72,230,2019
2022_B14922,94,68,63,225,2019
2019_B14923,87,80,60,227,2019
2021_B14924,84,83,75,242,2022
2019_A14925,76,77,45,198,2021
2022_C14926,82,63,61,206,2022
2019_A14927,92,58,41,191,2019
2022_A14928,73,83,71,227,2019
2019_C14929,84,82,50,216,2022
2021_C14930,88,69,70,227,2021
2022_A14931,89,61,66,216,2022
2022_B14932,78,95,58,231,2022
2021_C14933,96,84,43,223,2021
2022_B14934,93,95,49,237,2021
2021_C14935,90,85,37,212,2019
2019_B14936,97,75,73,245,2019
2021_A14937,72,89,49,210,2022
2022_C14938,90,47,46,183,2022
2019_B14939,93,68,59,220,2019
2019_B14940,71,89,45,205,2022
2019_C14941,93,79,61,233,2022
2019_B14942,77,87,56,220,2021
2021_A14943,80,57,53,190,2019
2022_C14944,80,58,45,183,2022
2021_B14945,91,71,48,210,2019
2022_C14946,92,49,62,203,2021
2022_A14947,80,87,62,229,2022
2019_A14948,95,77,63,235,2022
2019_A14949,94,94,58,246,2022
2021_A14950,87,67,70,224,2022
2021_B14951,81,79,79,239,2022
2022_C14952,85,79,71,235,2019
2021_B14953,88,90,60,238,2019
2019_C14954,76,65,62,203,2022
2019_A14955,87,91,70,248,2021
2019_B14956,83,56,50,189,2021
2021_B14957,75,49,37,161,2021
2019_B14958,85,91,37,213,2019
2022_B14959,73,60,39,172,2021
2019_C14960,83,69,51,203,2021
2021_C14961,76,47,67,190,2021
2019_A14962,91,88,67,246,2019
2019_B14963,89,67,43,199,2022
2022_A14964,96,46,66,208,2019
2019_C14965,84,86,54,224,2022
2021_A14966,85,48,52,185,2019
2019_B14967,84,62,36,182,2021
2022_C14968,96,63,43,202,2022
2019_A14969,74,59,50,183,2021
2022_B14970,94,81,49,224,2019
2021_A14971,81,76,57,214,2021
2022_C14972,91,61,42,194,2022
2022_C14973,94,88,67,249,2022
2021_B14974,82,61,79,222,2019
2022_B14975,73,73,66,212,2021
2021_B14976,73,78,43,194,2022
2021_A14977,82,61,73,216,2021
2022_A14978,79,68,75,222,2021
2021_A14979,83,47,76,206,2022
2022_C14980,80,72,46,198,2019
2022_B14981,73,93,38,204,2022
2021_C14982,93,61,68,222,2019
2019_B14983,84,84,35,203,2021
2022_B14984,81,71,35,187,2019
2021_A14985,82,72,41,195,2021
2021_B14986,72,68,42,182,2019
2022_A14987,88,70,48,206,2022
2021_B14988,77,47,50,174,2021
2022_B14989,76,46,43,165,2019
2019_B14990,80,64,41,185,2019
2022_C14991,96,54,45,195,2021
2021_B14992,72,93,43,208,2021
2022_A14993,83,49,62,194,2021
2022_A14994,73,55,43,171,2022
2019_B14995,95,49,36,180,2019
2021_B14996,84,57,43,184,2021
2021_C14997,80,48,43,171,2019
2022_C14998,79,92,66,237,2022
2019_A14999,88,83,51,222,2022
2022_C15000,96,62,37,195,2019
2022_B15001,94,91,57,242,2022
2022_A15002,89,50,67,206,2021
2019_C15003,75,89,79,243,2021
2021_C15004,72,53,79,204,2021
2022_B15005,92,93,72,257,2022
2022_A15006,75,87,54,216,2022
2021_A15007,71,92,79,242,2019
2021_C15008,84,80,62,226,2019
2022_C15009,74,46,35,155,2019
2022_A15010,72,54,78,204,2022
2022_B15011,95,72,55,222,2019
2021_C15012,73,54,40,167,2019
2019_B15013,82,63,40,185,2019
2022_C15014,91,89,62,242,2021
2021_B15015,86,86,65,237,2021
2021_A15016,82,63,46,191,2022
2019_A15017,95,45,51,191,2019
2022_C15018,84,56,56,196,2022
2021_C15019,96,54,77,227,2022
2022_B15020,75,63,74,212,2022
2021_C15021,72,74,47,193,2022
2019_B15022,90,62,73,225,2022
2022_A15023,87,50,66,203,2019
2022_A15024,78,58,52,188,2019
2022_C15025,89,90,68,247,2019
2021_C15026,75,60,53,188,2021
2019_B15027,86,61,48,195,2019
2022_C15028,78,95,63,236,2022
2022_C15029,96,57,74,227,2021
2019_A15030,73,95,47,215,2022
2022_A15031,77,55,35,167,2021
2019_A15032,84,54,50,188,2022
2021_A15033,76,64,39,179,2021
2022_C15034,73,68,60,201,2021
2022_B15035,72,76,77,225,2022
2022_C15036,76,62,66,204,2019
2022_C15037,87,58,65,210,2022
2022_B15038,73,76,61,210,2021
2019_A15039,88,77,35,200,2021
2019_C15040,90,72,72,234,2021
2022_A15041,75,58,47,180,2021
2022_B15042,77,53,40,170,2019
2021_A15043,92,84,39,215,2019
2021_A15044,71,53,57,181,2021
2022_C15045,73,92,37,202,2019
2019_C15046,71,93,69,233,2019
2022_A15047,85,71,72,228,2022
2019_A15048,92,89,65,246,2021
2019_A15049,94,69,67,230,2021
2022_A15050,92,92,61,245,2022
2019_C15051,89,61,58,208,2019
2021_A15052,95,72,77,244,2022
2021_B15053,89,79,40,208,2022
2021_A15054,83,60,66,209,2019
2019_B15055,85,94,74,253,2021
2021_B15056,82,93,66,241,2021
2022_B15057,84,46,78,208,2021
2021_B15058,88,60,60,208,2022
2021_B15059,90,51,78,219,2019
2019_B15060,82,45,55,182,2019
2019_B15061,81,78,56,215,2019
2021_C15062,86,46,58,190,2022
2022_C15063,93,77,71,241,2019
2019_C15064,88,57,48,193,2021
2022_B15065,97,85,63,245,2021
2019_B15066,82,89,40,211,2021
2019_A15067,87,57,77,221,2019
2021_C15068,91,88,74,253,2022
2019_C15069,80,65,55,200,2019
2021_C15070,78,48,47,173,2019
2019_A15071,85,61,48,194,2022
2019_C15072,90,92,35,217,2021
2021_C15073,82,91,48,221,2019
2022_B15074,90,53,57,200,2022
2022_A15075,82,48,39,169,2022
2019_B15076,77,86,68,231,2021
2019_B15077,75,66,66,207,2021
2021_B15078,87,69,44,200,2021
2021_A15079,93,68,56,217,2019
2019_B15080,79,73,43,195,2021
2019_B15081,79,53,52,184,2022
2021_B15082,88,66,40,194,2021
2021_C15083,96,75,46,217,2022
2022_B15084,92,91,38,221,2022
2019_A15085,73,67,67,207,2019
2019_C15086,74,49,75,198,2019
2022_A15087,72,80,50,202,2019
2019_B15088,81,84,35,200,2022
2022_C15089,94,60,78,232,2019
2022_C15090,97,69,38,204,2019
2021_C15091,96,51,67,214,2022
2021_A15092,73,59,73,205,2022
2022_C15093,73,56,41,170,2021
2022_B15094,90,49,53,192,2021
2021_C15095,93,67,44,204,2019
2021_B15096,76,87,35,198,2022
2019_A15097,92,91,78,261,2019
2019_A15098,76,54,75,205,2021
2019_C15099,91,74,62,227,2022
2022_A15100,84,87,64,235,2022
2021_A15101,80,54,53,187,2022
2022_C15102,77,67,74,218,2019
2019_A15103,81,57,37,175,2021
2019_B15104,97,51,71,219,2022
2021_A15105,95,58,72,225,2019
2021_B15106,84,58,66,208,2021
2021_B15107,82,87,49,218,2021
2021_C15108,97,76,54,227,2019
2021_C15109,76,49,63,188,2022
2022_C15110,83,93,67,243,2021
2022_C15111,76,76,78,230,2021
2022_C15112,73,46,62,181,2019
2022_C15113,97,49,39,185,2022
2021_C15114,94,62,78,234,2021
2022_B15115,82,45,50,177,2021
2019_A15116,90,47,76,213,2021
2019_B15117,74,48,63,185,2022
2022_A15118,78,80,70,228,2019
2019_A15119,91,75,79,245,2021
2019_C15120,89,90,65,244,2021
2021_B15121,82,62,78,222,2022
2021_C15122,93,76,54,223,2019
2021_C15123,74,57,76,207,2019
2022_C15124,86,45,51,182,2019
2019_A15125,78,59,79,216,2022
2022_A15126,79,87,45,211,2021
2021_A15127,75,87,66,228,2019
2022_A15128,76,75,58,209,2022
2021_C15129,92,85,51,228,2021
2021_A15130,79,56,37,172,2019
2022_B15131,79,77,37,193,2022
2022_B15132,97,77,65,239,2022
2019_A15133,88,54,62,204,2022
2022_A15134,85,81,53,219,2019
2022_C15135,76,78,47,201,2022
2021_C15136,86,74,57,217,2022
2022_B15137,81,73,48,202,2019
2022_B15138,89,52,54,195,2019
2019_A15139,84,66,56,206,2019
2022_A15140,73,83,44,200,2019
2021_B15141,93,73,67,233,2022
2022_C15142,92,63,37,192,2022
2021_A15143,79,45,62,186,2019
2021_B15144,80,55,66,201,2022
2021_B15145,95,56,76,227,2021
2019_B15146,88,77,74,239,2021
2021_A15147,84,83,46,213,2022
2019_C15148,91,51,56,198,2019
2022_A15149,82,80,55,217,2022
2022_A15150,86,65,70,221,2022
2019_A15151,79,80,41,200,2019
2022_B15152,71,53,55,179,2021
2021_C15153,81,48,67,196,2019
2022_B15154,93,82,65,240,2022
2022_A15155,80,76,51,207,2021
2021_B15156,87,47,69,203,2021
2021_A15157,83,69,68,220,2021
2022_C15158,88,56,38,182,2022
2021_B15159,84,88,57,229,2022
2021_A15160,73,56,71,200,2022
2019_C15161,84,79,61,224,2021
2019_A15162,76,54,72,202,2021
2021_C15163,77,78,71,226,2021
2022_A15164,71,52,76,199,2019
2019_B15165,90,62,49,201,2021
2022_C15166,86,90,77,253,2019
2019_A15167,95,47,36,178,2021
2021_A15168,81,95,48,224,2019
2022_A15169,72,63,52,187,2022
2022_C15170,86,79,51,216,2019
2022_C15171,79,88,53,220,2022
2021_B15172,82,71,54,207,2019
2021_A15173,90,48,36,174,2022
2021_C15174,77,64,74,215,2019
2022_B15175,72,73,74,219,2021
2021_C15176,96,58,58,212,2019
2021_B15177,76,48,46,170,2022
2022_C15178,93,75,74,242,2019
2022_A15179,90,45,78,213,2019
2019_C15180,95,60,35,190,2019
2019_A15181,83,90,63,236,2021
2022_C15182,88,85,37,210,2022
2022_A15183,83,70,57,210,2019
2019_A15184,94,80,68,242,2021
2021_B15185,83,63,57,203,2022
2019_C15186,72,72,49,193,2021
2021_A15187,82,45,35,162,2022
2022_A15188,75,57,64,196,2021
2019_B15189,94,80,64,238,2022
2022_B15190,72,94,40,206,2021
2019_B15191,72,64,70,206,2022
2022_C15192,90,81,64,235,2019
2022_C15193,86,70,61,217,2022
2019_C15194,94,52,55,201,2021
2021_B15195,96,71,77,244,2021
2022_A15196,85,93,51,229,2021
2021_A15197,97,49,43,189,2022
2021_C15198,76,88,43,207,2019
2021_C15199,84,58,70,212,2021
2021_A15200,96,48,60,204,2021
2021_B15201,85,58,45,188,2021
2019_A15202,86,79,46,211,2019
2021_B15203,74,60,61,195,2022
2019_A15204,93,48,59,200,2019
2021_B15205,96,66,79,241,2019
2021_C15206,82,91,47,220,2022
2019_A15207,80,76,74,230,2019
2022_A15208,72,67,70,209,2021
2021_B15209,76,94,62,232,2022
2021_A15210,97,79,36,212,2022
2021_B15211,75,77,75,227,2019
2022_B15212,95,57,68,220,2022
2021_C15213,88,54,53,195,2022
2022_A15214,97,80,64,241,2021
2021_A15215,89,48,58,195,2021
2022_B15216,87,89,42,218,2019
2022_C15217,75,46,44,165,2021
2021_A15218,97,86,56,239,2021
2019_A15219,96,55,41,192,2021
2021_C15220,72,46,57,175,2021
2019_B15221,84,78,50,212,2021
2022_A15222,73,58,38,169,2022
2021_A15223,96,83,70,249,2021
2022_B15224,93,88,53,234,2022
2021_A15225,86,70,76,232,2019
2022_C15226,97,59,59,215,2019
2019_A15227,78,57,37,172,2019
2022_C15228,79,68,74,221,2022
2019_A15229,82,48,70,200,2019
2019_C15230,82,84,39,205,2019
2021_C15231,87,48,59,194,2021
2021_C15232,71,86,37,194,2022
2022_B15233,77,63,73,213,2021
2021_C15234,74,64,45,183,2021
2019_B15235,95,91,57,243,2019
2019_B15236,90,72,35,197,2022
2022_A15237,82,62,56,200,2022
2019_C15238,90,66,70,226,2022
2021_C15239,80,82,69,231,2019
2021_B15240,81,51,37,169,2021
2022_C15241,91,52,39,182,2022
2019_A15242,93,78,41,212,2022
2022_B15243,75,51,42,168,2019
2021_A15244,92,65,55,212,2022
2022_C15245,73,70,38,181,2022
2019_B15246,71,65,73,209,2019
2019_C15247,81,72,46,199,2019
2022_C15248,79,53,37,169,2022
2019_C15249,90,51,55,196,2021
2021_B15250,81,79,74,234,2019
2022_C15251,94,45,53,192,2022
2019_C15252,74,49,79,202,2021
2019_B15253,93,90,64,247,2022
2021_A15254,89,74,65,228,2021
2022_A15255,93,46,57,196,2022
2022_C15256,82,91,58,231,2021
2021_A15257,96,79,68,243,2022
2021_C15258,97,58,62,217,2021
2022_C15259,97,66,76,239,2022
2022_A15260,80,47,47,174,2022
2019_C15261,95,63,41,199,2021
2021_B15262,95,58,44,197,2019
2019_B15263,87,80,55,222,2021
2021_C15264,82,92,74,248,2022
2022_B15265,82,93,35,210,2019
2021_C15266,81,90,75,246,2021
2019_B15267,72,63,47,182,2021
2019_B15268,73,47,65,185,2021
2022_B15269,83,83,76,242,2022
2022_C15270,75,87,50,212,2021
2022_B15271,83,50,59,192,2019
2019_A15272,82,56,66,204,2019
2021_C15273,96,50,52,198,2022
2019_C15274,84,71,46,201,2022
2019_C15275,86,48,68,202,2021
2019_C15276,77,71,58,206,2021
2019_C15277,91,50,64,205,2021
2022_A15278,88,87,73,248,2022
2019_A15279,92,73,76,241,2021
2021_A15280,71,47,62,180,2019
2021_C15281,96,56,59,211,2019
2022_B15282,74,93,65,232,2019
2022_B15283,90,84,43,217,2022
2022_B15284,96,83,78,257,2021
2019_A15285,81,87,67,235,2021
2021_B15286,97,62,61,220,2022
2021_C15287,93,58,36,187,2019
2021_A15288,90,48,38,176,2021
2021_A15289,84,65,46,195,2022
2022_B15290,76,55,43,174,2022
2022_A15291,86,88,67,241,2019
2022_A15292,85,83,53,221,2022
2021_C15293,89,73,62,224,2022
2019_C15294,86,84,67,237,2019
2019_C15295,94,93,52,239,2022
2019_C15296,80,68,48,196,2021
2019_C15297,82,47,75,204,2022
2019_B15298,90,71,68,229,2019
2019_C15299,92,91,44,227,2022
2019_C15300,82,84,53,219,2022
2021_C15301,74,80,40,194,2022
2019_A15302,81,66,36,183,2019
2022_C15303,95,92,44,231,2022
2022_A15304,87,93,60,240,2021
2022_A15305,84,81,37,202,2019
2019_A15306,90,90,52,232,2019
2019_B15307,71,55,52,178,2019
2021_B15308,89,53,48,190,2019
2021_B15309,76,90,38,204,2022
2019_C15310,94,66,45,205,2021
2022_C15311,91,86,61,238,2021
2022_C15312,93,51,48,192,2021
2022_A15313,87,54,79,220,2021
2019_B15314,87,70,59,216,2022
2019_A15315,90,75,67,232,2022
2022_A15316,88,79,64,231,2019
2021_B15317,83,75,61,219,2022
2022_A15318,87,53,59,199,2019
2022_C15319,72,48,46,166,2021
2019_A15320,91,88,72,251,2022
2019_A15321,93,55,59,207,2022
2021_B15322,93,82,61,236,2022
2019_A15323,73,46,74,193,2019
2019_B15324,95,50,45,190,2021
2021_A15325,77,72,77,226,2019
2021_B15326,96,92,36,224,2022
2021_A15327,78,48,56,182,2022
2019_C15328,94,82,36,212,2019
2022_C15329,97,77,67,241,2019
2022_A15330,88,78,65,231,2022
2022_B15331,90,83,39,212,2022
2022_A15332,76,48,43,167,2019
2019_C15333,94,93,57,244,2019
2022_C15334,95,75,79,249,2022
2021_A15335,93,81,42,216,2019
2022_B15336,90,67,64,221,2019
2019_A15337,72,70,60,202,2022
2019_B15338,81,90,58,229,2022
2019_A15339,87,85,70,242,2019
2019_A15340,89,93,77,259,2019
2021_A15341,77,45,49,171,2021
2019_B15342,91,55,69,215,2022
2022_C15343,87,63,56,206,2022
2019_A15344,80,47,73,200,2019
2019_C15345,73,66,38,177,2019
2019_A15346,92,91,79,262,2019
2019_B15347,84,89,38,211,2022
2019_B15348,76,51,48,175,2021
2019_B15349,77,58,79,214,2019
2022_B15350,93,68,75,236,2019
2019_B15351,76,59,35,170,2021
2019_B15352,77,77,73,227,2021
2021_C15353,80,49,76,205,2022
2021_A15354,72,70,70,212,2022
2022_C15355,95,82,57,234,2022
2021_A15356,97,55,53,205,2019
2021_B15357,88,67,64,219,2022
2021_C15358,94,73,74,241,2022
2019_A15359,76,62,47,185,2021
2021_C15360,80,59,61,200,2021
2022_C15361,96,70,67,233,2022
2022_A15362,73,90,66,229,2019
2019_C15363,81,55,52,188,2021
2022_B15364,71,47,76,194,2019
2022_C15365,78,83,73,234,2022
2019_C15366,91,64,59,214,2021
2021_A15367,79,68,50,197,2022
2019_C15368,84,47,72,203,2021
2021_C15369,89,62,40,191,2021
2022_C15370,75,95,65,235,2021
2021_B15371,90,64,57,211,2021
2019_C15372,72,72,74,218,2021
2019_C15373,75,59,71,205,2022
2019_A15374,76,67,46,189,2022
2019_B15375,77,54,48,179,2021
2019_B15376,91,90,79,260,2019
2022_A15377,74,84,49,207,2022
2021_B15378,79,57,70,206,2022
2022_A15379,97,79,75,251,2019
2019_C15380,72,80,36,188,2019
2022_B15381,80,72,47,199,2019
2021_B15382,80,49,43,172,2021
2022_B15383,74,93,45,212,2021
2021_B15384,88,92,36,216,2021
2019_C15385,86,59,56,201,2021
2021_B15386,93,96,65,254,2019
2021_B15387,79,74,59,212,2021
2022_A15388,81,72,62,215,2022
2019_C15389,74,71,46,191,2019
2021_A15390,85,92,51,228,2021
2019_B15391,77,80,54,211,2022
2019_B15392,88,78,49,215,2021
2019_C15393,90,78,52,220,2019
2019_C15394,89,53,47,189,2021
2021_B15395,90,68,77,235,2022
2021_B15396,97,80,65,242,2021
2019_B15397,71,54,50,175,2019
2019_A15398,82,60,60,202,2021
2022_C15399,79,94,57,230,2022
2019_C15400,97,78,76,251,2022
2019_B15401,96,64,46,206,2022
2019_B15402,74,84,36,194,2022
2022_B15403,74,80,72,226,2019
2021_C15404,95,50,67,212,2019
2022_B15405,71,71,76,218,2022
2019_A15406,87,71,72,230,2022
2022_A15407,93,66,41,200,2021
2022_A15408,86,62,35,183,2021
2021_B15409,92,89,37,218,2021
2019_A15410,78,70,73,221,2019
2019_A15411,96,64,37,197,2019
2022_A15412,75,60,42,177,2022
2021_C15413,96,63,61,220,2021
2021_A15414,88,63,57,208,2022
2021_A15415,78,48,48,174,2021
2022_C15416,75,46,46,167,2019
2019_A15417,73,49,59,181,2022
2021_C15418,96,78,57,231,2021
2022_B15419,81,55,42,178,2019
2019_B15420,86,48,37,171,2022
2019_B15421,76,46,78,200,2019
2021_C15422,79,80,37,196,2019
2019_B15423,96,45,65,206,2019
2022_A15424,79,57,45,181,2021
2021_A15425,89,63,45,197,2021
2021_C15426,71,83,70,224,2019
2021_A15427,74,68,44,186,2021
2019_C15428,75,56,54,185,2021
2019_B15429,86,94,73,253,2021
2021_B15430,84,61,67,212,2022
2021_A15431,77,80,41,198,2022
2019_C15432,80,51,40,171,2019
2019_C15433,84,48,48,180,2022
2022_C15434,75,84,62,221,2022
2022_B15435,91,77,59,227,2019
2021_B15436,97,63,40,200,2021
2019_B15437,85,95,64,244,2021
2019_B15438,90,77,36,203,2019
2019_A15439,82,89,52,223,2022
2022_B15440,83,64,48,195,2022
2021_A15441,85,86,69,240,2021
2019_A15442,71,48,77,196,2021
2019_C15443,95,57,50,202,2019
2022_A15444,94,83,65,242,2021
2021_B15445,86,89,41,216,2021
2019_C15446,78,85,43,206,2021
2021_C15447,89,91,72,252,2019
2019_C15448,82,47,35,164,2022
2022_C15449,84,48,52,184,2022
2021_A15450,85,84,43,212,2021
2021_C15451,82,57,52,191,2022
2021_C15452,87,88,70,245,2021
2019_C15453,71,62,66,199,2022
2021_C15454,88,82,78,248,2021
2019_B15455,97,66,43,206,2022
2019_B15456,96,80,53,229,2022
2021_C15457,97,82,68,247,2022
2022_C15458,90,72,38,200,2022
2019_C15459,80,68,73,221,2022
2021_A15460,77,57,76,210,2021
2019_B15461,72,78,74,224,2019
2021_A15462,87,93,68,248,2022
2021_A15463,83,84,36,203,2019
2022_A15464,87,45,73,205,2022
2019_B15465,76,88,50,214,2022
2021_A15466,78,50,48,176,2019
2021_A15467,96,93,49,238,2019
2022_B15468,77,64,55,196,2021
2022_C15469,79,74,47,200,2022
2019_C15470,80,79,56,215,2019
2022_B15471,73,69,50,192,2021
2022_C15472,86,47,66,199,2021
2019_A15473,92,50,45,187,2019
2022_B15474,77,76,43,196,2019
2021_B15475,77,80,51,208,2019
2021_C15476,90,50,47,187,2021
2019_C15477,73,83,52,208,2019
2019_B15478,92,47,70,209,2022
2021_B15479,92,77,38,207,2019
2021_B15480,86,82,39,207,2019
2021_A15481,84,57,78,219,2019
2022_C15482,73,56,72,201,2022
2021_C15483,73,57,63,193,2021
2019_C15484,80,66,76,222,2022
2022_A15485,90,59,62,211,2021
2021_B15486,86,95,71,252,2021
2019_C15487,71,57,62,190,2022
2021_A15488,88,90,45,223,2019
2019_B15489,76,45,62,183,2022
2021_A15490,76,52,76,204,2019
2021_B15491,83,67,54,204,2021
2021_C15492,82,93,52,227,2022
2021_C15493,97,55,73,225,2019
2022_C15494,84,74,37,195,2022
2021_C15495,97,45,78,220,2022
2019_B15496,93,74,54,221,2021
2019_A15497,95,91,40,226,2021
2019_C15498,77,64,44,185,2021
2022_B15499,76,63,58,197,2022
2022_C15500,94,48,77,219,2022
2019_B15501,84,48,53,185,2022
2022_C15502,75,74,79,228,2022
2021_B15503,71,89,52,212,2019
2019_C15504,83,93,67,243,2019
2019_A15505,74,87,49,210,2022
2019_A15506,93,96,46,235,2022
2021_C15507,81,95,62,238,2021
2019_C15508,90,89,48,227,2021
2022_B15509,94,57,51,202,2021
2022_A15510,95,85,50,230,2022
2022_C15511,78,60,73,211,2021
2021_B15512,76,60,78,214,2022
2019_C15513,96,55,63,214,2022
2019_C15514,85,63,39,187,2022
2021_C15515,73,49,51,173,2022
2021_C15516,94,78,71,243,2019
2019_C15517,74,67,35,176,2021
2019_A15518,96,64,47,207,2022
2019_A15519,97,89,35,221,2021
2019_B15520,83,57,35,175,2021
2021_A15521,83,48,56,187,2021
2021_C15522,94,89,72,255,2019
2021_C15523,77,73,48,198,2019
2022_B15524,76,93,49,218,2021
2019_C15525,80,60,79,219,2021
2022_A15526,94,72,37,203,2019
2022_C15527,74,70,78,222,2021
2021_B15528,72,65,57,194,2022
2022_C15529,71,93,52,216,2019
2019_C15530,80,83,50,213,2022
2021_A15531,94,96,65,255,2019
2019_C15532,74,74,76,224,2022
2021_A15533,71,72,46,189,2019
2021_C15534,75,47,69,191,2019
2022_A15535,93,52,77,222,2019
2021_A15536,89,93,61,243,2022
2022_A15537,77,82,77,236,2022
2019_A15538,73,61,49,183,2022
2019_C15539,73,78,69,220,2019
2019_B15540,74,59,68,201,2019
2019_B15541,94,88,70,252,2019
2021_A15542,95,83,72,250,2019
2019_A15543,79,88,71,238,2021
2022_B15544,84,60,50,194,2021
2019_B15545,80,73,56,209,2022
2021_A15546,79,50,47,176,2022
2021_B15547,90,53,50,193,2022
2019_B15548,85,93,69,247,2021
2022_A15549,84,94,66,244,2022
2022_B15550,85,91,63,239,2021
2021_A15551,72,79,40,191,2021
2021_C15552,90,87,46,223,2022
2019_B15553,78,54,41,173,2021
2019_C15554,95,71,38,204,2019
2019_B15555,72,66,52,190,2019
2022_B15556,84,62,54,200,2022
2021_C15557,93,59,66,218,2019
2021_A15558,76,90,70,236,2021
2022_C15559,72,62,74,208,2019
2022_B15560,72,76,62,210,2019
2021_B15561,83,45,42,170,2022
2019_C15562,92,77,75,244,2022
2022_B15563,96,79,63,238,2022
2022_A15564,82,69,57,208,2022
2019_C15565,75,77,46,198,2022
2019_C15566,77,55,66,198,2021
2022_A15567,79,84,45,208,2019
2022_A15568,85,64,69,218,2022
2021_B15569,86,64,55,205,2022
2019_B15570,81,85,37,203,2021
2021_C15571,76,51,72,199,2021
2021_A15572,71,86,56,213,2022
2019_A15573,83,85,56,224,2021
2022_B15574,89,96,35,220,2019
2022_B15575,72,79,66,217,2019
2022_B15576,77,79,73,229,2021
2021_C15577,80,62,79,221,2021
2019_A15578,71,79,52,202,2021
2021_C15579,73,51,70,194,2021
2022_A15580,96,73,57,226,2019
2021_A15581,96,83,40,219,2019
2019_B15582,77,57,71,205,2021
2022_B15583,80,59,56,195,2021
2022_A15584,93,91,64,248,2022
2019_C15585,89,69,45,203,2019
2019_B15586,78,88,50,216,2022
2022_A15587,77,53,59,189,2021
2019_A15588,96,67,38,201,2021
2022_A15589,79,72,36,187,2019
2021_B15590,92,73,47,212,2022
2021_C15591,95,91,38,224,2019
2021_C15592,97,88,73,258,2021
2022_C15593,87,59,42,188,2022
2021_C15594,76,55,54,185,2019
2022_A15595,71,80,72,223,2022
2021_A15596,87,54,46,187,2022
2022_B15597,80,61,62,203,2022
2019_A15598,81,71,70,222,2021
2019_A15599,78,87,36,201,2019
2019_A15600,90,81,76,247,2021
2019_C15601,93,54,65,212,2019
2021_C15602,81,47,78,206,2022
2019_C15603,83,74,39,196,2019
2019_B15604,96,54,36,186,2019
2019_A15605,80,62,69,211,2021
2022_A15606,85,81,49,215,2021
2019_B15607,94,85,55,234,2021
2019_C15608,89,52,53,194,2021
2022_C15609,93,45,59,197,2022
2019_A15610,92,60,56,208,2019
2021_A15611,91,47,45,183,2021
2019_A15612,88,92,61,241,2021
2022_C15613,83,46,66,195,2021
2021_B15614,91,63,49,203,2022
2021_B15615,76,84,75,235,2019
2019_A15616,88,96,47,231,2022
2022_C15617,88,88,76,252,2019
2022_A15618,85,55,65,205,2022
2019_A15619,92,74,71,237,2021
2021_A15620,93,71,46,210,2019
2022_A15621,94,49,61,204,2019
2019_A15622,87,90,74,251,2021
2022_A15623,80,88,76,244,2021
2019_C15624,94,64,65,223,2019
2019_B15625,74,68,53,195,2021
2021_A15626,86,66,65,217,2019
2019_B15627,76,95,70,241,2019
2021_B15628,96,63,63,222,2019
2021_A15629,72,87,45,204,2021
2019_A15630,87,73,68,228,2019
2019_B15631,90,92,78,260,2019
2021_C15632,91,60,59,210,2021
2019_B15633,93,46,56,195,2021
2019_C15634,84,59,39,182,2021
2022_C15635,93,96,49,238,2021
2021_B15636,72,56,36,164,2021
2019_B15637,78,51,73,202,2022
2022_A15638,78,79,42,199,2019
2022_A15639,91,62,71,224,2022
2019_C15640,73,66,56,195,2022
2019_B15641,95,94,76,265,2019
2021_C15642,76,49,67,192,2022
2022_B15643,78,72,53,203,2019
2022_B15644,96,56,55,207,2021
2022_B15645,82,74,63,219,2022
2022_B15646,97,76,39,212,2019
2022_C15647,72,64,35,171,2021
2019_C15648,73,72,40,185,2019
2021_A15649,90,61,46,197,2019
2022_A15650,73,67,51,191,2019
2022_C15651,94,58,70,222,2022
2021_A15652,87,70,71,228,2022
2021_C15653,84,69,76,229,2022
2022_C15654,96,63,67,226,2021
2021_A15655,75,91,46,212,2022
2021_C15656,87,86,60,233,2019
2019_C15657,83,62,44,189,2021
2019_B15658,93,62,61,216,2022
2021_A15659,77,69,50,196,2022
2019_B15660,79,91,79,249,2021
2021_B15661,97,88,51,236,2022
2022_C15662,82,70,73,225,2019
2019_C15663,97,74,42,213,2021
2019_A15664,85,55,59,199,2021
2022_B15665,77,85,58,220,2019
2021_B15666,82,56,73,211,2019
2022_C15667,74,85,55,214,2019
2022_A15668,95,88,58,241,2021
2021_A15669,85,53,72,210,2019
2021_B15670,71,70,38,179,2019
2022_B15671,79,50,61,190,2021
2022_C15672,97,56,77,230,2019
2019_C15673,71,69,42,182,2019
2019_A15674,88,57,51,196,2021
2021_C15675,93,50,75,218,2021
2019_C15676,71,82,71,224,2022
2022_B15677,79,75,60,214,2021
2019_B15678,93,64,77,234,2021
2022_B15679,72,88,78,238,2022
2019_C15680,79,84,78,241,2022
2022_B15681,82,45,65,192,2019
2021_A15682,85,53,63,201,2019
2021_C15683,81,66,78,225,2021
2022_B15684,84,70,76,230,2019
2021_B15685,74,86,72,232,2021
2021_B15686,71,57,38,166,2021
2019_B15687,74,96,72,242,2019
2022_B15688,85,70,45,200,2021
2022_A15689,88,87,55,230,2021
2021_B15690,84,61,41,186,2022
2019_C15691,89,90,75,254,2022
2021_C15692,91,53,74,218,2019
2019_A15693,81,57,41,179,2019
2021_A15694,86,65,43,194,2022
2022_B15695,87,87,79,253,2021
2022_C15696,83,95,56,234,2019
2022_A15697,80,75,77,232,2021
2022_C15698,74,53,65,192,2021
2019_C15699,90,82,74,246,2019
2021_A15700,94,51,46,191,2021
2019_C15701,91,57,69,217,2019
2021_B15702,80,50,75,205,2022
2021_C15703,97,50,43,190,2021
2019_C15704,95,80,66,241,2021
2019_A15705,91,66,66,223,2021
2022_C15706,75,75,72,222,2021
2021_B15707,94,74,48,216,2022
2019_C15708,72,91,63,226,2019
2022_B15709,95,79,43,217,2022
2021_B15710,89,47,46,182,2021
2022_A15711,94,89,39,222,2019
2019_B15712,83,68,74,225,2021
2019_B15713,75,84,58,217,2019
2021_B15714,86,55,73,214,2019
2022_A15715,71,52,67,190,2021
2022_B15716,95,84,77,256,2022
2021_C15717,91,83,75,249,2021
2022_C15718,71,73,49,193,2022
2021_A15719,77,50,65,192,2019
2019_C15720,92,85,39,216,2021
2021_A15721,81,58,37,176,2022
2019_B15722,72,82,65,219,2022
2019_B15723,80,72,37,189,2022
2019_B15724,78,95,73,246,2019
2022_C15725,85,63,47,195,2021
2022_B15726,80,77,37,194,2021
2022_B15727,95,83,54,232,2021
2019_A15728,74,89,54,217,2022
2021_A15729,74,92,36,202,2019
2022_B15730,90,50,63,203,2021
2021_C15731,73,61,71,205,2021
2022_B15732,77,55,47,179,2021
2021_C15733,97,71,52,220,2021
2022_B15734,84,58,60,202,2019
2021_A15735,83,90,35,208,2022
2022_C15736,71,46,38,155,2021
2022_A15737,74,46,47,167,2022
2019_A15738,80,68,56,204,2019
2021_B15739,85,96,74,255,2019
2021_C15740,75,55,77,207,2021
2019_B15741,84,79,68,231,2019
2021_C15742,81,68,76,225,2022
2021_B15743,85,63,36,184,2019
2021_C15744,89,85,57,231,2019
2019_C15745,71,50,57,178,2019
2021_A15746,76,49,61,186,2021
2021_A15747,93,72,43,208,2021
2019_C15748,74,93,66,233,2021
2019_B15749,89,96,56,241,2022
2021_A15750,88,52,69,209,2019
2021_A15751,80,62,60,202,2021
2019_C15752,90,89,61,240,2019
2022_B15753,90,49,66,205,2019
2022_A15754,84,96,78,258,2022
2022_C15755,96,62,74,232,2022
2022_B15756,83,81,39,203,2021
2021_C15757,71,78,41,190,2022
2019_B15758,84,70,41,195,2019
2021_B15759,75,90,74,239,2021
2019_B15760,96,82,76,254,2022
2019_C15761,76,85,70,231,2019
2019_B15762,71,67,62,200,2019
2021_C15763,74,84,37,195,2021
2022_C15764,89,69,68,226,2021
2019_A15765,72,46,36,154,2021
2021_A15766,94,65,67,226,2021
2021_A15767,77,84,63,224,2019
2021_C15768,82,72,72,226,2021
2022_A15769,81,53,70,204,2019
2021_C15770,95,86,38,219,2021
2019_C15771,78,62,76,216,2019
2019_C15772,77,56,54,187,2019
2022_B15773,80,45,74,199,2019
2021_C15774,81,85,79,245,2021
2022_C15775,82,75,77,234,2021
2022_C15776,92,72,68,232,2021
2022_A15777,84,88,71,243,2021
2022_B15778,82,72,38,192,2021
2021_B15779,90,50,48,188,2021
2019_C15780,83,65,45,193,2019
2019_B15781,94,78,70,242,2022
2019_C15782,93,90,69,252,2019
2019_C15783,89,62,42,193,2022
2021_A15784,78,62,47,187,2022
2021_C15785,81,76,66,223,2019
2019_C15786,83,53,67,203,2022
2022_A15787,93,95,61,249,2021
2021_B15788,85,91,44,220,2021
2021_A15789,75,51,39,165,2022
2019_C15790,89,61,74,224,2019
2019_B15791,85,83,53,221,2022
2022_B15792,97,72,48,217,2021
2021_B15793,95,88,70,253,2021
2022_B15794,94,83,70,247,2019
2021_A15795,86,93,60,239,2022
2019_C15796,72,53,68,193,2022
2019_A15797,90,89,69,248,2021
2021_B15798,96,49,39,184,2019
2021_A15799,78,59,56,193,2019
2022_A15800,91,57,79,227,2021
2021_B15801,74,55,63,192,2021
2019_A15802,87,61,78,226,2022
2021_B15803,74,48,45,167,2019
2021_C15804,73,71,50,194,2022
2021_B15805,91,61,48,200,2019
2021_C15806,72,89,37,198,2019
2022_C15807,91,67,72,230,2019
2019_C15808,83,57,48,188,2022
2022_C15809,93,92,77,262,2021
2021_B15810,81,78,63,222,2019
2022_C15811,76,87,66,229,2022
2021_A15812,73,50,77,200,2022
2022_C15813,73,56,54,183,2019
2021_C15814,78,87,60,225,2019
2019_A15815,78,63,79,220,2019
2019_C15816,75,63,40,178,2022
2019_A15817,72,91,62,225,2022
2021_B15818,77,49,62,188,2021
2021_C15819,97,83,62,242,2019
2021_B15820,96,86,73,255,2021
2021_C15821,83,81,48,212,2022
2019_B15822,94,63,47,204,2022
2022_C15823,96,45,59,200,2019
2022_C15824,90,78,54,222,2021
2021_B15825,75,91,35,201,2022
2022_B15826,85,89,36,210,2019
2019_A15827,95,49,49,193,2021
2019_A15828,83,48,67,198,2019
2019_A15829,71,71,44,186,2021
2022_A15830,73,66,73,212,2022
2022_A15831,94,82,65,241,2019
2019_A15832,76,82,48,206,2019
2022_B15833,97,89,73,259,2021
2022_A15834,95,70,36,201,2021
2021_B15835,90,85,78,253,2021
2022_C15836,83,91,67,241,2021
2019_C15837,72,68,37,177,2022
2021_B15838,80,96,54,230,2021
2022_B15839,95,45,50,190,2022
2022_A15840,89,73,79,241,2022
2019_A15841,90,87,47,224,2019
2021_B15842,71,78,61,210,2021
2022_B15843,73,83,53,209,2019
2019_C15844,75,96,47,218,2019
2022_A15845,93,80,57,230,2021
2021_A15846,79,45,60,184,2022
2019_B15847,96,94,60,250,2019
2019_C15848,79,57,68,204,2022
2022_B15849,95,48,37,180,2021
2021_C15850,75,69,51,195,2022
2021_C15851,85,45,75,205,2022
2022_B15852,79,53,56,188,2022
2019_B15853,71,75,46,192,2021
2019_C15854,97,54,62,213,2021
2021_C15855,85,85,61,231,2019
2022_C15856,92,89,40,221,2019
2019_B15857,83,77,36,196,2022
2019_A15858,74,72,35,181,2022
2019_B15859,76,91,78,245,2019
2021_C15860,88,70,54,212,2022
2022_A15861,91,88,59,238,2021
2022_C15862,72,53,58,183,2022
2019_B15863,79,74,36,189,2022
2021_B15864,73,94,54,221,2019
2019_C15865,73,73,75,221,2019
2019_C15866,81,75,36,192,2022
2022_B15867,81,50,54,185,2019
2019_A15868,82,76,47,205,2022
2022_A15869,87,62,64,213,2022
2022_A15870,96,65,43,204,2022
2019_B15871,97,57,66,220,2019
2022_A15872,92,94,74,260,2021
2021_A15873,88,50,72,210,2019
2022_B15874,79,48,44,171,2021
2021_C15875,91,90,44,225,2021
2019_B15876,74,57,48,179,2019
2022_A15877,80,82,53,215,2022
2019_C15878,90,56,69,215,2019
2021_C15879,93,95,74,262,2022
2019_C15880,93,95,42,230,2022
2021_C15881,86,67,68,221,2019
2022_B15882,76,89,58,223,2021
2019_A15883,74,86,44,204,2021
2022_B15884,95,63,53,211,2021
2021_A15885,82,87,70,239,2022
2022_A15886,85,46,69,200,2021
2021_B15887,96,61,52,209,2019
2022_B15888,85,56,57,198,2022
2019_C15889,80,57,73,210,2019
2022_A15890,71,61,63,195,2021
2021_A15891,75,65,68,208,2021
2021_A15892,82,95,63,240,2019
2019_B15893,72,79,59,210,2022
2022_C15894,79,45,59,183,2019
2019_A15895,81,90,72,243,2019
2022_B15896,87,78,60,225,2019
2021_B15897,87,96,52,235,2019
2021_B15898,73,91,76,240,2022
2021_B15899,73,80,74,227,2022
2022_A15900,91,51,66,208,2022
2019_A15901,87,75,40,202,2022
2019_B15902,96,88,46,230,2022
2019_A15903,82,81,71,234,2019
2019_C15904,91,63,68,222,2019
2022_C15905,77,83,76,236,2021
2022_B15906,76,50,41,167,2021
2019_B15907,82,47,65,194,2021
2019_B15908,97,79,77,253,2019
2022_A15909,96,53,69,218,2021
2019_A15910,76,76,61,213,2022
2022_A15911,79,56,64,199,2022
2022_B15912,71,69,65,205,2021
2019_C15913,91,62,53,206,2022
2022_A15914,95,51,52,198,2021
2021_C15915,77,46,62,185,2019
2022_B15916,74,61,50,185,2022
2019_B15917,76,79,70,225,2019
2021_A15918,92,71,47,210,2021
2021_B15919,89,45,68,202,2019
2022_B15920,93,61,59,213,2022
2019_C15921,71,82,69,222,2021
2021_A15922,93,87,40,220,2019
2022_A15923,97,87,38,222,2022
2021_C15924,94,57,64,215,2022
2022_B15925,94,55,51,200,2021
2019_C15926,95,74,49,218,2021
2019_B15927,89,61,77,227,2019
2022_A15928,91,87,73,251,2019
2019_A15929,84,73,64,221,2021
2021_A15930,82,86,77,245,2022
2022_C15931,94,86,35,215,2019
2022_B15932,80,94,72,246,2022
2019_A15933,75,71,37,183,2022
2022_A15934,94,76,50,220,2019
2021_B15935,95,71,54,220,2021
2019_A15936,93,68,60,221,2019
2019_B15937,81,71,67,219,2021
2021_A15938,93,45,46,184,2022
2021_B15939,83,56,35,174,2022
2021_A15940,73,54,70,197,2021
2021_C15941,97,66,43,206,2019
2019_C15942,90,80,44,214,2021
2022_A15943,95,82,76,253,2022
2021_A15944,75,79,49,203,2021
2022_A15945,83,89,64,236,2019
2021_C15946,88,65,74,227,2022
2021_A15947,94,56,50,200,2021
2022_A15948,86,55,47,188,2021
2022_C15949,71,92,62,225,2019
2019_C15950,80,80,47,207,2021
2021_A15951,79,90,39,208,2021
2022_C15952,79,72,70,221,2022
2021_A15953,90,88,70,248,2021
2022_C15954,93,94,69,256,2021
2019_B15955,80,64,77,221,2021
2019_A15956,86,67,70,223,2019
2021_B15957,84,82,41,207,2022
2022_A15958,82,87,58,227,2022
2019_C15959,81,57,48,186,2019
2019_B15960,96,87,35,218,2021
2021_C15961,83,95,52,230,2021
2021_A15962,75,88,37,200,2021
2019_A15963,78,86,77,241,2019
2022_B15964,92,72,46,210,2021
2021_A15965,73,64,78,215,2019
2021_B15966,97,66,41,204,2019
2022_C15967,88,50,46,184,2021
2021_B15968,78,58,68,204,2019
2021_C15969,84,72,78,234,2019
2021_B15970,79,64,58,201,2019
2021_C15971,81,63,40,184,2022
2019_C15972,93,48,59,200,2021
2021_A15973,77,79,57,213,2021
2019_C15974,96,65,37,198,2019
2019_B15975,85,81,43,209,2021
2022_A15976,72,73,65,210,2021
2019_C15977,90,53,57,200,2019
2019_C15978,77,71,53,201,2019
2019_A15979,75,61,44,180,2021
2021_C15980,97,70,77,244,2022
2022_A15981,96,81,45,222,2021
2019_C15982,80,93,77,250,2021
2019_C15983,71,45,70,186,2021
2021_B15984,92,73,79,244,2022
2019_B15985,71,45,79,195,2021
2022_A15986,90,60,50,200,2022
2022_A15987,94,70,64,228,2021
2021_C15988,91,53,46,190,2021
2021_C15989,71,61,60,192,2022
2022_C15990,85,56,42,183,2019
2022_A15991,77,46,72,195,2021
2022_C15992,88,65,72,225,2021
2021_C15993,95,93,41,229,2021
2019_A15994,75,48,60,183,2021
2019_B15995,90,89,55,234,2019
2022_B15996,87,62,73,222,2021
2021_B15997,73,69,70,212,2022
2021_B15998,79,92,51,222,2019
2021_B15999,92,55,58,205,2021
2021_C16000,86,68,48,202,2019
2021_C16001,81,53,42,176,2022
2021_C16002,82,84,35,201,2019
2022_C16003,74,66,66,206,2022
2019_B16004,89,74,71,234,2022
2022_A16005,74,54,58,186,2019
2022_B16006,76,69,71,216,2021
2021_A16007,76,79,35,190,2022
2019_C16008,77,88,36,201,2019
2021_B16009,83,45,60,188,2022
2019_B16010,74,67,66,207,2019
2019_A16011,79,71,53,203,2019
2019_C16012,71,48,67,186,2021
2019_C16013,94,56,35,185,2019
2022_A16014,78,54,44,176,2022
2021_A16015,71,67,59,197,2022
2022_A16016,81,53,56,190,2022
2022_A16017,94,57,45,196,2021
2019_C16018,79,82,64,225,2021
2019_B16019,72,69,68,209,2021
2022_B16020,72,56,36,164,2019
2021_A16021,77,79,37,193,2019
2021_C16022,97,69,63,229,2021
2021_A16023,94,83,67,244,2019
2022_A16024,94,76,51,221,2019
2021_B16025,90,45,72,207,2022
2022_A16026,93,45,72,210,2019
2021_B16027,89,46,63,198,2022
2021_C16028,91,56,44,191,2019
2021_B16029,76,67,53,196,2021
2021_C16030,84,64,73,221,2022
2021_B16031,76,53,49,178,2019
2019_A16032,77,48,58,183,2022
2021_C16033,94,91,41,226,2021
2019_B16034,82,71,59,212,2019
2022_C16035,96,47,76,219,2022
2021_B16036,91,62,56,209,2019
2019_A16037,81,49,57,187,2022
2019_B16038,91,77,51,219,2022
2022_B16039,72,52,39,163,2019
2022_A16040,72,91,64,227,2019
2022_A16041,83,95,77,255,2019
2021_B16042,78,82,75,235,2022
2022_C16043,71,84,70,225,2021
2019_A16044,75,74,77,226,2021
2019_C16045,74,51,44,169,2021
2021_C16046,82,66,48,196,2019
2022_C16047,94,82,67,243,2021
2022_B16048,85,73,55,213,2021
2019_B16049,77,81,69,227,2021
2021_C16050,81,66,69,216,2021
2022_A16051,79,53,65,197,2021
2022_A16052,90,78,39,207,2022
2019_C16053,75,61,46,182,2022
2019_B16054,76,76,40,192,2022
2022_A16055,89,79,56,224,2022
2022_A16056,91,50,44,185,2021
2022_B16057,95,75,50,220,2021
2022_C16058,73,60,72,205,2019
2021_C16059,77,75,58,210,2019
2022_B16060,82,90,79,251,2021
2019_A16061,72,70,67,209,2019
2019_B16062,96,63,72,231,2022
2021_B16063,71,89,42,202,2019
2022_C16064,80,95,55,230,2019
2019_B16065,71,55,61,187,2022
2019_B16066,86,53,65,204,2021
2019_B16067,72,62,49,183,2022
2021_A16068,97,74,77,248,2019
2019_A16069,93,46,54,193,2022
2022_A16070,83,69,70,222,2022
2019_B16071,73,83,62,218,2021
2019_C16072,76,85,53,214,2019
2022_C16073,89,69,61,219,2019
2021_B16074,86,82,49,217,2022
2021_A16075,71,96,38,205,2019
2019_C16076,76,75,45,196,2019
2019_A16077,73,83,57,213,2022
2022_C16078,85,93,79,257,2022
2022_B16079,89,81,36,206,2021
2022_B16080,96,91,57,244,2019
2019_A16081,84,77,40,201,2019
2021_C16082,95,53,52,200,2019
2022_C16083,78,46,68,192,2021
2021_C16084,85,63,55,203,2022
2021_A16085,93,95,56,244,2021
2022_B16086,79,67,48,194,2022
2019_B16087,92,54,44,190,2019
2021_A16088,93,71,64,228,2021
2021_A16089,95,50,61,206,2022
2021_C16090,97,84,63,244,2021
2019_A16091,86,45,66,197,2022
2022_C16092,77,88,66,231,2021
2019_C16093,93,63,77,233,2019
2021_B16094,91,65,46,202,2021
2022_C16095,76,66,65,207,2021
2019_C16096,91,74,64,229,2021
2022_C16097,81,46,77,204,2019
2022_C16098,93,72,56,221,2019
2021_C16099,87,81,37,205,2019
2019_C16100,80,48,46,174,2022
2022_C16101,86,81,48,215,2022
2021_A16102,90,75,71,236,2022
2021_B16103,83,62,49,194,2019
2021_B16104,75,75,50,200,2022
2019_A16105,84,63,48,195,2019
2021_A16106,75,96,35,206,2022
2022_B16107,73,70,53,196,2019
2022_A16108,77,63,36,176,2019
2021_C16109,96,81,37,214,2021
2021_A16110,91,63,45,199,2021
2019_A16111,94,76,77,247,2019
2022_B16112,96,63,58,217,2019
2021_A16113,86,61,75,222,2021
2019_B16114,93,89,56,238,2021
2021_B16115,85,73,75,233,2021
2021_B16116,96,60,79,235,2021
2019_C16117,89,59,71,219,2019
2021_A16118,89,88,70,247,2022
2021_A16119,76,52,36,164,2021
2022_C16120,76,95,48,219,2022
2019_C16121,74,75,39,188,2019
2021_C16122,92,67,57,216,2022
2022_C16123,76,79,48,203,2021
2022_C16124,87,72,37,196,2021
2021_B16125,71,57,59,187,2021
2021_A16126,85,88,42,215,2019
2019_A16127,80,89,66,235,2022
2019_A16128,96,73,35,204,2019
2022_B16129,73,93,77,243,2019
2022_B16130,75,79,78,232,2021
2021_B16131,71,69,56,196,2021
2019_C16132,80,52,73,205,2021
2019_C16133,93,91,38,222,2021
2021_B16134,81,67,61,209,2022
2021_B16135,71,88,72,231,2021
2019_A16136,92,67,74,233,2019
2019_B16137,80,72,49,201,2019
2019_B16138,77,45,52,174,2021
2022_B16139,92,64,62,218,2019
2022_B16140,72,64,42,178,2021
2019_A16141,75,76,60,211,2021
2019_C16142,94,51,40,185,2022
2019_C16143,74,57,36,167,2021
2022_B16144,76,67,62,205,2021
2022_C16145,77,59,52,188,2019
2021_B16146,73,72,64,209,2022
2021_A16147,97,60,46,203,2021
2021_A16148,74,96,70,240,2022
2022_B16149,71,64,75,210,2019
2022_B16150,89,93,78,260,2022
2022_A16151,76,67,38,181,2019
2022_C16152,79,54,50,183,2019
2021_B16153,78,51,60,189,2021
2019_C16154,96,66,66,228,2019
2021_A16155,94,82,46,222,2022
2019_B16156,83,91,66,240,2021
2022_B16157,96,56,37,189,2022
2019_A16158,94,48,72,214,2019
2019_C16159,72,52,69,193,2019
2021_A16160,80,61,73,214,2019
2019_C16161,78,63,76,217,2022
2021_A16162,85,75,53,213,2021
2022_A16163,76,71,41,188,2021
2019_B16164,80,63,64,207,2022
2019_B16165,93,61,50,204,2021
2019_C16166,72,80,76,228,2022
2019_B16167,79,59,64,202,2022
2019_C16168,76,88,37,201,2021
2022_A16169,76,53,77,206,2021
2021_A16170,91,91,35,217,2019
2021_A16171,89,65,62,216,2022
2022_C16172,88,52,63,203,2021
2019_C16173,81,87,75,243,2022
2021_A16174,90,80,72,242,2021
2019_A16175,81,67,52,200,2021
2022_B16176,83,78,77,238,2022
2021_B16177,84,51,61,196,2019
2021_C16178,80,47,58,185,2021
2021_A16179,97,65,75,237,2022
2019_B16180,76,73,47,196,2019
2021_B16181,73,53,53,179,2019
2021_C16182,97,92,73,262,2022
2021_A16183,83,79,70,232,2019
2022_B16184,86,72,64,222,2021
2019_C16185,89,84,52,225,2021
2021_C16186,78,60,59,197,2019
2021_A16187,85,47,58,190,2021
2022_A16188,71,60,58,189,2022
2021_C16189,73,51,65,189,2019
2019_B16190,96,64,45,205,2022
2019_B16191,89,55,69,213,2019
2021_C16192,91,47,41,179,2019
2022_B16193,83,92,71,246,2021
2021_B16194,85,95,58,238,2019
2021_C16195,85,54,76,215,2022
2021_B16196,71,85,54,210,2021
2022_A16197,71,59,65,195,2022
2022_B16198,74,69,35,178,2022
2022_A16199,71,46,63,180,2022
2022_C16200,83,78,77,238,2019
2022_C16201,90,61,70,221,2022
2022_B16202,72,60,45,177,2022
2019_C16203,88,92,51,231,2019
2021_A16204,96,51,72,219,2022
2021_B16205,72,84,68,224,2022
2021_C16206,84,48,35,167,2019
2019_A16207,90,79,37,206,2022
2022_A16208,80,74,70,224,2022
2019_A16209,76,70,71,217,2022
2022_C16210,96,48,78,222,2022
2021_B16211,84,68,44,196,2022
2022_B16212,77,91,45,213,2019
2021_A16213,89,92,75,256,2019
2022_C16214,73,63,40,176,2019
2019_A16215,82,94,59,235,2021
2022_A16216,76,89,41,206,2022
2021_C16217,77,58,47,182,2019
2022_B16218,90,50,77,217,2022
2021_C16219,72,78,42,192,2022
2019_A16220,76,59,71,206,2019
2019_B16221,91,52,47,190,2022
2021_A16222,74,51,38,163,2019
2021_B16223,79,92,76,247,2019
2021_C16224,96,45,55,196,2022
2022_A16225,89,59,52,200,2022
2022_C16226,92,77,42,211,2021
2021_C16227,93,55,76,224,2021
2019_A16228,93,88,69,250,2022
2019_B16229,83,73,67,223,2021
2019_C16230,77,76,57,210,2022
2022_C16231,72,55,40,167,2022
2022_A16232,77,88,50,215,2022
2022_B16233,83,64,72,219,2019
2021_B16234,80,86,47,213,2022
2019_C16235,91,74,46,211,2019
2019_A16236,97,84,48,229,2019
2021_C16237,75,59,49,183,2021
2022_C16238,71,68,72,211,2019
2022_B16239,71,77,58,206,2022
2022_C16240,71,54,56,181,2022
2019_A16241,79,96,76,251,2021
2021_B16242,87,68,39,194,2019
2021_A16243,72,88,76,236,2021
2021_B16244,79,69,70,218,2022
2021_B16245,95,61,63,219,2021
2022_C16246,83,77,59,219,2022
2021_C16247,84,51,74,209,2021
2021_C16248,74,67,67,208,2021
2022_A16249,95,49,49,193,2022
2021_C16250,80,89,66,235,2022
2021_B16251,85,53,52,190,2019
