Roll_Code,Math,English,Science,Total,Year
2022_A10001,22,60,61,143,2022
2022_B10002,6,20,31,57,2022
2022_A10003,19,40,30,89,2022
2022_B10004,4,39,75,118,2022
2021_C10005,66,30,24,120,2021
2021_A10006,70,96,52,218,2021
2022_C10007,33,28,66,127,2022
2022_C10008,88,37,99,224,2022
2021_C10009,79,25,61,165,2021
2022_A10010,18,47,62,127,2022
2022_A10011,79,17,73,169,2022
2022_A10012,77,58,62,197,2022
2022_B10013,51,32,22,105,2022
2022_C10014,28,12,57,97,2022
2021_C10015,63,94,44,201,2021
2019_B10016,43,97,93,233,2019
2021_A10017,12,54,48,114,2021
2022_B10018,51,52,31,134,2022
2019_B10019,78,75,69,222,2019
2019_A10020,40,20,80,140,2019
2019_C10021,19,52,87,158,2019
2019_C10022,40,34,39,113,2019
2022_B10023,25,64,64,153,2022
2019_C10024,64,40,49,153,2019
2022_B10025,80,54,87,221,2022
2022_B10026,13,37,71,121,2022
2019_A10027,81,31,30,142,2019
2019_B10028,28,32,39,99,2019
2021_C10029,7,90,74,171,2021
2021_B10030,64,65,72,201,2021
2019_C10031,76,25,23,124,2019
2022_C10032,40,78,31,149,2022
2022_A10033,66,61,98,225,2022
2021_A10034,91,60,57,208,2021
2019_A10035,67,36,23,126,2019
2019_A10036,90,30,29,149,2019
2022_B10037,3,93,67,163,2022
2022_C10038,97,54,50,201,2022
2022_A10039,19,39,26,84,2022
2022_A10040,99,94,51,244,2022
2021_B10041,22,61,66,149,2021
2019_C10042,74,53,30,157,2019
2021_A10043,45,75,29,149,2021
2022_A10044,5,49,57,111,2022
2022_C10045,11,83,31,125,2022
2022_C10046,16,51,76,143,2022
2019_A10047,100,94,26,220,2019
2019_A10048,42,19,61,122,2019
2022_B10049,97,20,50,167,2022
2019_B10050,75,57,45,177,2019
2022_B10051,71,34,51,156,2022
2022_C10052,99,95,55,249,2022
2022_B10053,84,56,98,238,2022
2022_C10054,97,94,38,229,2022
2022_A10055,68,16,71,155,2022
2022_B10056,27,89,68,184,2022
2019_A10057,76,91,93,260,2019
2019_A10058,99,80,77,256,2019
2021_A10059,78,78,97,253,2021
2019_C10060,22,50,79,151,2019
2019_C10061,23,51,34,108,2019
2021_A10062,48,78,52,178,2021
2021_A10063,75,91,86,252,2021
2022_A10064,3,16,88,107,2022
2019_A10065,41,97,72,210,2019
2021_B10066,53,65,57,175,2021
2021_A10067,68,74,38,180,2021
2019_A10068,24,13,26,63,2019
2022_B10069,48,93,49,190,2022
2021_A10070,87,24,34,145,2021
2021_A10071,99,16,66,181,2021
2021_A10072,82,32,93,207,2021
2019_A10073,37,27,93,157,2019
2022_C10074,100,24,57,181,2022
2021_B10075,4,88,44,136,2021
2021_C10076,81,38,78,197,2021
2022_B10077,83,95,79,257,2022
2019_C10078,30,41,24,95,2019
2019_A10079,3,92,50,145,2019
2019_C10080,71,66,58,195,2019
2021_C10081,92,76,51,219,2021
2021_C10082,30,77,37,144,2021
2021_C10083,3,84,62,149,2021
2019_C10084,69,61,40,170,2019
2022_C10085,0,65,58,123,2022
2019_B10086,35,72,81,188,2019
2021_B10087,77,81,34,192,2021
2019_C10088,4,57,77,138,2019
2021_B10089,25,41,36,102,2021
2019_C10090,10,18,53,81,2019
2022_C10091,52,30,89,171,2022
2022_C10092,85,27,49,161,2022
2022_C10093,28,88,35,151,2022
2021_A10094,73,78,92,243,2021
2019_B10095,24,88,76,188,2019
2019_C10096,0,74,76,150,2019
2021_C10097,91,44,46,181,2021
2021_C10098,80,90,63,233,2021
2021_B10099,75,14,55,144,2021
2019_A10100,80,43,75,198,2019
2019_A10101,72,93,70,235,2019
2021_A10102,16,52,29,97,2021
2021_A10103,98,66,69,233,2021
2021_C10104,19,34,41,94,2021
2021_B10105,31,80,44,155,2021
2019_C10106,35,45,60,140,2019
2019_C10107,23,68,34,125,2019
2021_A10108,63,63,71,197,2021
2021_C10109,80,76,28,184,2021
2022_A10110,65,60,62,187,2022
2019_C10111,10,77,50,137,2019
2021_C10112,35,38,42,115,2021
2022_C10113,52,96,89,237,2022
2021_B10114,79,23,21,123,2021
2021_B10115,11,12,50,73,2021
2021_B10116,63,25,32,120,2021
2021_C10117,32,87,58,177,2021
2021_C10118,40,42,22,104,2021
2019_A10119,69,61,34,164,2019
2021_A10120,84,25,40,149,2021
2022_B10121,53,91,75,219,2022
2022_C10122,80,53,38,171,2022
2022_A10123,7,87,39,133,2022
2022_A10124,17,60,84,161,2022
2021_B10125,65,11,54,130,2021
2019_B10126,78,45,56,179,2019
2022_A10127,72,34,71,177,2022
2021_A10128,62,54,32,148,2021
2022_C10129,94,20,68,182,2022
2022_A10130,30,79,31,140,2022
2022_B10131,48,25,39,112,2022
2022_B10132,76,14,97,187,2022
2019_C10133,87,57,92,236,2019
2019_C10134,54,70,73,197,2019
2019_C10135,20,40,85,145,2019
2019_A10136,53,83,52,188,2019
2019_A10137,12,80,41,133,2019
2021_C10138,39,12,48,99,2021
2019_C10139,30,91,93,214,2019
2022_C10140,85,11,72,168,2022
2019_C10141,6,16,68,90,2019
2021_B10142,72,52,86,210,2021
2019_A10143,11,50,78,139,2019
2022_A10144,77,66,65,208,2022
2021_A10145,22,88,25,135,2021
2022_A10146,1,21,66,88,2022
2022_B10147,40,85,79,204,2022
2021_B10148,54,23,79,156,2021
2021_B10149,59,44,53,156,2021
2019_B10150,56,65,99,220,2019
2022_C10151,29,33,36,98,2022
2019_A10152,38,25,72,135,2019
2021_B10153,100,28,73,201,2021
2021_B10154,38,73,66,177,2021
2019_A10155,73,34,56,163,2019
2019_B10156,17,26,56,99,2019
2019_C10157,11,19,72,102,2019
2022_C10158,18,91,61,170,2022
2021_B10159,78,29,48,155,2021
2022_A10160,49,28,42,119,2022
2022_B10161,47,44,92,183,2022
2019_B10162,54,32,67,153,2019
2021_A10163,72,65,91,228,2021
2021_A10164,62,36,57,155,2021
2021_A10165,4,88,49,141,2021
2021_A10166,13,46,87,146,2021
2021_C10167,100,62,40,202,2021
2019_C10168,21,12,44,77,2019
2019_A10169,37,49,65,151,2019
2021_B10170,94,28,65,187,2021
2021_C10171,73,46,81,200,2021
2022_B10172,65,68,27,160,2022
2019_B10173,52,23,21,96,2019
2022_B10174,56,88,81,225,2022
2022_C10175,42,38,65,145,2022
2021_C10176,3,86,71,160,2021
2019_A10177,72,39,29,140,2019
2022_A10178,22,72,96,190,2022
2021_A10179,30,82,87,199,2021
2019_B10180,17,74,60,151,2019
2019_C10181,49,13,54,116,2019
2021_A10182,7,55,38,100,2021
2021_C10183,35,41,39,115,2021
2021_A10184,5,84,95,184,2021
2022_C10185,81,56,60,197,2022
2021_C10186,57,95,32,184,2021
2022_A10187,42,45,98,185,2022
2019_A10188,23,16,52,91,2019
2022_C10189,13,72,85,170,2022
2019_B10190,67,48,91,206,2019
2021_A10191,73,44,25,142,2021
2019_C10192,23,92,31,146,2019
2019_A10193,25,59,74,158,2019
2021_A10194,72,87,72,231,2021
2019_C10195,77,96,62,235,2019
2021_A10196,24,77,67,168,2021
2021_C10197,12,43,99,154,2021
2019_B10198,40,20,73,133,2019
2021_C10199,7,57,33,97,2021
2019_C10200,26,36,54,116,2019
2021_A10201,53,53,29,135,2021
2019_C10202,11,64,33,108,2019
2021_B10203,80,40,75,195,2021
2019_B10204,61,28,27,116,2019
2019_C10205,14,41,44,99,2019
2019_B10206,10,68,26,104,2019
2019_C10207,38,93,58,189,2019
2019_A10208,1,41,24,66,2019
2019_B10209,79,25,31,135,2019
2019_C10210,38,72,26,136,2019
2019_B10211,63,25,97,185,2019
2019_A10212,58,23,37,118,2019
2022_C10213,25,91,47,163,2022
2019_A10214,22,48,71,141,2019
2019_C10215,43,49,90,182,2019
2021_C10216,18,50,76,144,2021
2019_A10217,78,55,75,208,2019
2019_C10218,43,66,72,181,2019
2021_B10219,83,26,28,137,2021
2019_C10220,1,60,45,106,2019
2022_B10221,2,18,74,94,2022
2022_C10222,50,83,56,189,2022
2019_C10223,17,74,99,190,2019
2022_C10224,72,66,28,166,2022
2019_B10225,57,70,46,173,2019
2019_B10226,33,72,35,140,2019
2022_B10227,64,43,29,136,2022
2022_C10228,58,57,55,170,2022
2019_A10229,88,33,91,212,2019
2022_B10230,85,56,28,169,2022
2019_A10231,66,56,89,211,2019
2021_A10232,55,50,54,159,2021
2019_A10233,13,50,37,100,2019
2019_A10234,61,56,49,166,2019
2022_B10235,36,87,32,155,2022
2021_C10236,82,39,94,215,2021
2019_A10237,60,14,57,131,2019
2022_B10238,50,49,62,161,2022
2022_B10239,93,38,37,168,2022
2019_B10240,4,41,86,131,2019
2021_B10241,80,80,39,199,2021
2021_A10242,48,21,78,147,2021
2021_B10243,1,65,75,141,2021
2019_C10244,36,77,69,182,2019
2022_C10245,37,91,91,219,2022
2021_A10246,46,15,68,129,2021
2019_A10247,27,90,90,207,2019
2022_C10248,94,67,62,223,2022
2022_A10249,25,73,44,142,2022
2019_A10250,39,16,97,152,2019
2022_C10251,23,18,90,131,2022
2021_B10252,74,45,92,211,2021
2019_B10253,41,45,70,156,2019
2019_B10254,4,60,65,129,2019
2019_C10255,62,46,90,198,2019
2022_C10256,80,30,24,134,2022
2022_A10257,70,81,60,211,2022
2021_B10258,88,22,44,154,2021
2022_C10259,74,85,55,214,2022
2022_B10260,23,30,24,77,2022
2022_A10261,42,92,41,175,2022
2021_B10262,99,75,74,248,2021
2022_B10263,31,15,79,125,2022
2019_C10264,26,41,69,136,2019
2021_A10265,17,31,36,84,2021
2021_B10266,98,62,57,217,2021
2021_A10267,75,67,92,234,2021
2022_A10268,4,22,79,105,2022
2019_B10269,39,41,97,177,2019
2021_A10270,78,14,85,177,2021
2019_B10271,87,34,24,145,2019
2019_C10272,95,41,29,165,2019
2022_C10273,46,73,45,164,2022
2022_C10274,85,61,29,175,2022
2022_C10275,22,67,72,161,2022
2022_B10276,51,13,41,105,2022
2019_B10277,72,44,35,151,2019
2019_C10278,73,27,36,136,2019
2022_C10279,10,74,26,110,2022
2019_B10280,61,18,90,169,2019
2022_A10281,82,34,89,205,2022
2022_C10282,26,87,53,166,2022
2021_C10283,19,55,84,158,2021
2021_A10284,6,85,74,165,2021
2019_C10285,63,27,24,114,2019
2019_C10286,98,78,38,214,2019
2019_B10287,55,51,53,159,2019
2019_A10288,37,33,83,153,2019
2021_B10289,39,84,48,171,2021
2022_B10290,0,33,61,94,2022
2022_C10291,40,68,94,202,2022
2021_B10292,77,84,58,219,2021
2022_A10293,96,27,56,179,2022
2019_B10294,13,73,68,154,2019
2022_C10295,6,43,78,127,2022
2022_B10296,26,88,70,184,2022
2019_A10297,21,56,42,119,2019
2021_B10298,3,82,47,132,2021
2022_C10299,93,13,93,199,2022
2021_C10300,98,37,76,211,2021
2021_C10301,83,91,41,215,2021
2019_C10302,95,44,57,196,2019
2021_B10303,15,77,22,114,2021
2021_C10304,80,83,25,188,2021
2019_A10305,45,15,45,105,2019
2022_C10306,98,72,73,243,2022
2022_B10307,53,19,95,167,2022
2019_A10308,78,21,64,163,2019
2022_C10309,31,84,96,211,2022
2019_C10310,79,29,60,168,2019
2021_A10311,74,89,42,205,2021
2022_A10312,22,42,95,159,2022
2022_C10313,27,37,97,161,2022
2021_A10314,59,71,33,163,2021
2019_C10315,8,96,43,147,2019
2022_C10316,69,15,29,113,2022
2021_C10317,30,28,74,132,2021
2021_A10318,18,44,76,138,2021
2022_A10319,21,55,89,165,2022
2019_B10320,32,57,80,169,2019
2019_B10321,54,25,31,110,2019
2019_C10322,11,38,43,92,2019
2022_A10323,91,21,83,195,2022
2022_B10324,5,66,44,115,2022
2022_B10325,14,91,66,171,2022
2021_C10326,63,43,37,143,2021
2019_B10327,86,50,93,229,2019
2022_C10328,79,41,29,149,2022
2022_C10329,47,65,46,158,2022
2019_B10330,31,23,29,83,2019
2021_A10331,40,16,90,146,2021
2022_C10332,34,39,88,161,2022
2021_B10333,70,80,43,193,2021
2021_A10334,95,93,51,239,2021
2021_B10335,70,96,82,248,2021
2022_C10336,27,77,26,130,2022
2021_A10337,14,58,98,170,2021
2021_B10338,99,70,46,215,2021
2022_C10339,12,24,76,112,2022
2021_A10340,42,43,50,135,2021
2022_A10341,96,63,67,226,2022
2021_A10342,72,14,75,161,2021
2019_A10343,74,46,43,163,2019
2022_B10344,66,40,63,169,2022
2022_C10345,44,71,55,170,2022
2022_C10346,76,59,75,210,2022
2021_B10347,38,47,73,158,2021
2022_C10348,88,17,35,140,2022
2019_B10349,66,65,99,230,2019
2022_A10350,41,87,81,209,2022
2022_A10351,79,89,54,222,2022
2022_A10352,21,14,74,109,2022
2022_B10353,54,37,67,158,2022
2019_B10354,44,82,21,147,2019
2021_C10355,87,60,89,236,2021
2019_C10356,72,68,89,229,2019
2021_B10357,17,24,91,132,2021
2021_B10358,61,88,52,201,2021
2022_B10359,96,56,27,179,2022
2019_A10360,19,29,76,124,2019
2022_B10361,11,57,43,111,2022
2022_C10362,63,59,91,213,2022
2021_C10363,72,12,64,148,2021
2022_C10364,77,85,71,233,2022
2021_A10365,74,71,93,238,2021
2021_C10366,31,63,94,188,2021
2022_C10367,69,65,51,185,2022
2022_A10368,40,84,72,196,2022
2022_A10369,29,40,45,114,2022
2022_C10370,84,23,37,144,2022
2019_B10371,42,93,68,203,2019
2021_C10372,48,59,71,178,2021
2021_C10373,93,51,61,205,2021
2019_A10374,34,85,31,150,2019
2022_B10375,10,53,38,101,2022
2022_B10376,16,92,74,182,2022
2021_A10377,51,50,47,148,2021
2022_C10378,41,18,22,81,2022
2019_C10379,86,12,41,139,2019
2021_C10380,6,92,49,147,2021
2019_A10381,70,90,23,183,2019
2022_A10382,55,41,71,167,2022
2021_C10383,78,31,92,201,2021
2019_C10384,67,19,61,147,2019
2021_A10385,23,53,87,163,2021
2019_B10386,43,24,28,95,2019
2021_C10387,5,24,75,104,2021
2022_B10388,29,19,87,135,2022
2019_B10389,24,92,32,148,2019
2019_A10390,5,20,52,77,2019
2022_A10391,33,89,30,152,2022
2022_B10392,42,48,66,156,2022
2022_C10393,78,86,47,211,2022
2019_C10394,27,39,89,155,2019
2019_B10395,94,14,74,182,2019
2019_B10396,61,76,23,160,2019
2022_A10397,50,66,75,191,2022
2022_A10398,11,45,36,92,2022
2021_B10399,62,33,74,169,2021
2022_B10400,71,94,51,216,2022
2021_A10401,70,66,26,162,2021
2019_C10402,70,12,51,133,2019
2021_A10403,31,12,45,88,2021
2021_C10404,40,62,74,176,2021
2019_C10405,7,40,54,101,2019
2019_C10406,2,66,34,102,2019
2021_A10407,46,96,67,209,2021
2019_A10408,100,83,87,270,2019
2021_C10409,29,41,79,149,2021
2021_C10410,20,65,31,116,2021
2019_B10411,68,67,92,227,2019
2022_A10412,89,20,38,147,2022
2019_B10413,94,12,24,130,2019
2021_B10414,46,69,47,162,2021
2019_A10415,32,42,72,146,2019
2019_B10416,7,58,59,124,2019
2022_A10417,34,48,55,137,2022
2021_C10418,13,95,60,168,2021
2019_C10419,56,49,59,164,2019
2022_C10420,69,34,92,195,2022
2019_C10421,84,82,74,240,2019
2022_C10422,50,14,23,87,2022
2021_C10423,70,95,37,202,2021
2019_B10424,83,54,60,197,2019
2019_B10425,58,52,75,185,2019
2021_B10426,5,55,68,128,2021
2019_C10427,20,73,98,191,2019
2022_C10428,24,81,64,169,2022
2019_B10429,95,56,44,195,2019
2021_B10430,16,93,52,161,2021
2021_B10431,100,96,93,289,2021
2021_A10432,35,91,99,225,2021
2021_B10433,89,30,61,180,2021
2022_C10434,80,29,54,163,2022
2019_C10435,57,79,89,225,2019
2021_B10436,44,35,43,122,2021
2022_A10437,55,25,26,106,2022
2021_B10438,92,61,92,245,2021
2019_C10439,100,73,30,203,2019
2021_C10440,48,79,46,173,2021
2022_A10441,47,88,31,166,2022
2021_C10442,92,88,74,254,2021
2019_C10443,39,85,83,207,2019
2021_A10444,26,76,34,136,2021
2019_C10445,33,82,49,164,2019
2019_A10446,48,75,27,150,2019
2019_B10447,44,64,44,152,2019
2022_C10448,49,73,68,190,2022
2021_A10449,5,56,83,144,2021
2022_C10450,3,61,70,134,2022
2021_A10451,67,71,58,196,2021
2022_C10452,65,31,54,150,2022
2022_B10453,71,87,48,206,2022
2021_B10454,86,80,80,246,2021
2021_C10455,69,32,76,177,2021
2021_A10456,92,42,31,165,2021
2021_B10457,5,48,27,80,2021
2022_B10458,26,72,58,156,2022
2019_A10459,4,68,48,120,2019
2019_A10460,11,55,46,112,2019
2019_B10461,14,83,62,159,2019
2022_C10462,61,68,97,226,2022
2021_B10463,100,17,63,180,2021
2019_A10464,74,19,56,149,2019
2019_C10465,9,88,80,177,2019
2022_A10466,0,23,77,100,2022
2021_A10467,1,64,78,143,2021
2021_B10468,93,97,24,214,2021
2019_A10469,40,59,42,141,2019
2019_B10470,99,54,51,204,2019
2021_B10471,62,51,47,160,2021
2022_C10472,5,14,36,55,2022
2022_C10473,65,54,48,167,2022
2019_C10474,72,40,98,210,2019
2019_C10475,96,66,85,247,2019
2021_A10476,74,29,38,141,2021
2022_A10477,75,13,87,175,2022
2019_B10478,15,26,73,114,2019
2022_A10479,28,54,76,158,2022
2021_B10480,31,14,27,72,2021
2022_B10481,87,46,78,211,2022
2022_B10482,75,70,29,174,2022
2019_B10483,60,56,91,207,2019
2022_B10484,0,49,87,136,2022
2019_A10485,47,12,48,107,2019
2019_B10486,48,78,79,205,2019
2019_B10487,40,32,30,102,2019
2019_B10488,85,53,56,194,2019
2022_B10489,48,85,99,232,2022
2022_C10490,23,21,24,68,2022
2019_A10491,55,94,79,228,2019
2021_C10492,82,39,49,170,2021
2021_B10493,20,56,57,133,2021
2021_C10494,52,46,47,145,2021
2022_C10495,52,79,38,169,2022
2022_A10496,33,42,66,141,2022
2022_A10497,24,73,40,137,2022
2021_A10498,79,76,32,187,2021
2019_A10499,22,80,72,174,2019
2021_C10500,80,66,26,172,2021
2022_C10501,50,75,21,146,2022
2022_C10502,25,41,49,115,2022
2022_A10503,78,57,30,165,2022
2021_A10504,58,21,36,115,2021
2021_B10505,89,58,92,239,2021
2021_C10506,39,40,64,143,2021
2019_C10507,15,90,40,145,2019
2022_A10508,1,30,82,113,2022
2019_A10509,11,52,28,91,2019
2022_A10510,33,23,60,116,2022
2021_A10511,11,84,54,149,2021
2019_C10512,67,60,99,226,2019
2019_C10513,64,14,74,152,2019
2019_C10514,77,84,86,247,2019
2019_C10515,23,20,49,92,2019
2019_B10516,61,69,31,161,2019
2022_B10517,16,50,87,153,2022
2019_A10518,93,53,39,185,2019
2021_A10519,65,24,34,123,2021
2021_C10520,84,24,73,181,2021
2021_A10521,56,88,37,181,2021
2021_A10522,2,70,75,147,2021
2021_C10523,6,21,57,84,2021
2021_B10524,30,59,70,159,2021
2021_B10525,32,68,84,184,2021
2022_C10526,91,92,95,278,2022
2019_A10527,40,42,28,110,2019
2019_A10528,83,76,36,195,2019
2022_C10529,40,32,99,171,2022
2021_B10530,37,28,64,129,2021
2022_A10531,59,81,55,195,2022
2022_A10532,72,22,45,139,2022
2022_B10533,0,23,45,68,2022
2019_B10534,3,58,61,122,2019
2022_A10535,88,90,58,236,2022
2021_C10536,87,16,41,144,2021
2019_B10537,30,30,79,139,2019
2021_A10538,42,91,57,190,2021
2019_A10539,53,84,58,195,2019
2021_C10540,17,38,75,130,2021
2022_B10541,74,19,58,151,2022
2021_A10542,62,21,47,130,2021
2021_A10543,55,26,45,126,2021
2022_B10544,92,90,96,278,2022
2019_B10545,63,62,56,181,2019
2022_A10546,71,93,90,254,2022
2019_B10547,66,75,26,167,2019
2019_B10548,82,40,24,146,2019
2022_B10549,39,68,23,130,2022
2019_C10550,41,88,64,193,2019
2019_B10551,51,60,85,196,2019
2021_A10552,41,69,49,159,2021
2021_C10553,73,39,77,189,2021
2021_A10554,39,54,81,174,2021
2019_C10555,50,87,53,190,2019
2019_B10556,13,60,39,112,2019
2019_A10557,22,94,32,148,2019
2022_C10558,6,81,77,164,2022
2022_B10559,50,26,77,153,2022
2021_C10560,42,74,93,209,2021
2022_A10561,53,43,71,167,2022
2022_A10562,97,26,64,187,2022
2022_B10563,85,45,81,211,2022
2021_B10564,48,87,73,208,2021
2021_B10565,11,58,35,104,2021
2021_C10566,96,31,68,195,2021
2022_C10567,87,24,47,158,2022
2019_C10568,20,44,81,145,2019
2022_C10569,14,13,89,116,2022
2019_A10570,90,51,62,203,2019
2021_A10571,13,93,85,191,2021
2019_B10572,67,35,37,139,2019
2021_B10573,30,96,86,212,2021
2022_C10574,30,94,58,182,2022
2019_A10575,95,37,25,157,2019
2019_A10576,99,38,26,163,2019
2022_C10577,45,46,57,148,2022
2022_A10578,82,39,45,166,2022
2022_A10579,59,42,90,191,2022
2021_C10580,5,77,81,163,2021
2019_C10581,54,47,37,138,2019
2022_C10582,11,40,86,137,2022
2022_A10583,13,46,69,128,2022
2022_B10584,77,52,60,189,2022
2019_A10585,67,17,77,161,2019
2022_B10586,54,34,90,178,2022
2022_A10587,56,12,59,127,2022
2019_C10588,51,35,78,164,2019
2021_C10589,11,44,99,154,2021
2019_A10590,32,58,96,186,2019
2019_B10591,59,48,85,192,2019
2022_C10592,94,11,98,203,2022
2019_B10593,13,56,37,106,2019
2021_C10594,97,21,57,175,2021
2019_B10595,37,17,50,104,2019
2019_B10596,30,20,59,109,2019
2019_B10597,94,77,63,234,2019
2021_A10598,10,22,34,66,2021
2019_B10599,68,86,81,235,2019
2022_C10600,36,32,89,157,2022
2019_A10601,45,36,63,144,2019
2021_B10602,0,23,39,62,2021
2021_B10603,30,76,30,136,2021
2019_A10604,25,37,22,84,2019
2021_C10605,50,74,30,154,2021
2022_A10606,92,27,31,150,2022
2019_A10607,67,17,99,183,2019
2022_C10608,22,87,46,155,2022
2019_A10609,48,42,43,133,2019
2021_C10610,48,18,29,95,2021
2019_C10611,46,68,64,178,2019
2022_A10612,60,36,23,119,2022
2019_B10613,17,38,43,98,2019
2019_C10614,29,94,23,146,2019
2021_A10615,0,86,40,126,2021
2021_B10616,69,57,59,185,2021
2021_C10617,88,56,46,190,2021
2019_B10618,44,22,26,92,2019
2021_C10619,21,67,71,159,2021
2022_A10620,49,61,96,206,2022
2019_A10621,33,27,93,153,2019
2019_A10622,46,55,28,129,2019
2022_C10623,26,22,54,102,2022
2021_C10624,19,94,51,164,2021
2021_C10625,44,60,26,130,2021
2019_C10626,7,68,93,168,2019
2021_A10627,58,68,54,180,2021
2022_B10628,61,39,24,124,2022
2019_C10629,36,17,59,112,2019
2021_C10630,89,90,78,257,2021
2019_B10631,42,16,27,85,2019
2021_C10632,35,22,38,95,2021
2021_A10633,45,87,39,171,2021
2021_B10634,92,66,78,236,2021
2022_B10635,54,70,43,167,2022
2022_C10636,4,77,91,172,2022
2019_A10637,45,21,58,124,2019
2019_A10638,41,95,89,225,2019
2022_C10639,24,83,95,202,2022
2021_B10640,59,83,75,217,2021
2022_C10641,7,78,62,147,2022
2021_B10642,71,19,93,183,2021
2022_B10643,48,68,25,141,2022
2022_C10644,8,22,31,61,2022
2021_C10645,39,15,35,89,2021
2021_B10646,0,31,34,65,2021
2022_B10647,62,29,28,119,2022
2019_C10648,3,65,46,114,2019
2021_A10649,35,57,40,132,2021
2021_C10650,78,87,40,205,2021
2019_B10651,61,29,21,111,2019
2021_C10652,77,53,47,177,2021
2021_C10653,90,85,73,248,2021
2019_C10654,34,94,29,157,2019
2021_C10655,81,85,39,205,2021
2021_A10656,12,30,86,128,2021
2019_C10657,5,97,61,163,2019
2021_B10658,51,87,21,159,2021
2021_A10659,57,31,81,169,2021
2021_A10660,37,79,52,168,2021
2021_A10661,52,57,38,147,2021
2021_A10662,96,76,88,260,2021
2019_A10663,23,45,38,106,2019
2021_A10664,14,14,95,123,2021
2021_C10665,50,47,80,177,2021
2019_C10666,82,28,51,161,2019
2019_A10667,76,33,73,182,2019
2022_C10668,76,64,89,229,2022
2021_C10669,68,15,62,145,2021
2019_A10670,95,24,85,204,2019
2019_C10671,15,29,32,76,2019
2022_C10672,68,90,21,179,2022
2019_C10673,9,46,99,154,2019
2019_B10674,60,76,66,202,2019
2019_B10675,98,62,78,238,2019
2022_A10676,89,60,72,221,2022
2022_B10677,87,81,24,192,2022
2021_A10678,76,37,70,183,2021
2021_C10679,90,72,31,193,2021
2021_B10680,8,14,31,53,2021
2019_A10681,60,53,21,134,2019
2022_A10682,9,24,46,79,2022
2021_A10683,40,85,81,206,2021
2019_C10684,99,86,38,223,2019
2022_A10685,87,96,85,268,2022
2021_A10686,46,23,23,92,2021
2021_A10687,52,64,99,215,2021
2019_B10688,100,53,30,183,2019
2021_C10689,64,37,86,187,2021
2022_A10690,41,48,81,170,2022
2019_A10691,43,34,59,136,2019
2022_B10692,21,80,94,195,2022
2021_A10693,71,59,97,227,2021
2021_A10694,62,85,77,224,2021
2019_B10695,45,34,96,175,2019
2021_C10696,23,44,27,94,2021
2019_A10697,4,96,34,134,2019
2021_C10698,75,93,71,239,2021
2021_A10699,2,73,83,158,2021
2022_B10700,44,89,22,155,2022
2022_A10701,32,43,27,102,2022
2019_C10702,20,64,67,151,2019
2021_B10703,2,81,81,164,2021
2019_B10704,97,66,91,254,2019
2021_A10705,91,70,95,256,2021
2022_B10706,28,49,38,115,2022
2022_B10707,55,14,37,106,2022
2022_A10708,63,12,84,159,2022
2021_B10709,86,84,24,194,2021
2019_B10710,48,24,38,110,2019
2022_A10711,20,21,44,85,2022
2019_B10712,72,83,83,238,2019
2022_A10713,23,93,90,206,2022
2022_B10714,41,73,50,164,2022
2019_C10715,10,12,60,82,2019
2019_A10716,97,50,62,209,2019
2022_C10717,65,85,60,210,2022
2022_B10718,75,13,28,116,2022
2021_A10719,63,51,61,175,2021
2022_A10720,95,96,88,279,2022
2019_B10721,81,91,75,247,2019
2021_B10722,25,72,63,160,2021
2019_A10723,6,96,37,139,2019
2021_B10724,26,60,53,139,2021
2022_A10725,72,80,78,230,2022
2019_C10726,95,22,35,152,2019
2022_B10727,68,77,21,166,2022
2022_A10728,2,19,59,80,2022
2022_B10729,13,46,28,87,2022
2019_B10730,89,65,26,180,2019
2022_C10731,25,97,58,180,2022
2022_B10732,98,92,98,288,2022
2021_C10733,5,96,66,167,2021
2019_C10734,18,75,44,137,2019
2021_A10735,73,89,65,227,2021
2021_A10736,78,67,77,222,2021
2022_A10737,80,45,23,148,2022
2022_C10738,11,87,54,152,2022
2022_C10739,11,24,67,102,2022
2019_A10740,2,59,43,104,2019
2021_A10741,55,63,94,212,2021
2019_C10742,80,73,96,249,2019
2021_A10743,14,72,39,125,2021
2022_C10744,24,85,96,205,2022
2022_B10745,55,55,99,209,2022
2021_A10746,75,43,51,169,2021
2019_B10747,53,77,81,211,2019
2019_B10748,28,36,77,141,2019
2019_A10749,78,96,73,247,2019
2019_C10750,65,90,95,250,2019
2021_C10751,93,40,51,184,2021
2021_B10752,34,64,90,188,2021
2019_B10753,29,17,76,122,2019
2022_C10754,21,31,71,123,2022
2021_A10755,11,42,90,143,2021
2019_A10756,12,25,30,67,2019
2019_C10757,4,30,85,119,2019
2019_C10758,94,77,92,263,2019
2021_C10759,24,80,89,193,2021
2021_B10760,87,34,22,143,2021
2019_C10761,100,94,55,249,2019
2021_C10762,10,21,65,96,2021
2022_C10763,54,91,92,237,2022
2021_B10764,32,77,84,193,2021
2022_A10765,78,79,88,245,2022
2019_A10766,79,14,98,191,2019
2019_A10767,29,54,58,141,2019
2021_B10768,32,87,34,153,2021
2019_C10769,27,20,50,97,2019
2019_C10770,73,59,41,173,2019
2022_A10771,5,56,47,108,2022
2019_A10772,36,96,97,229,2019
2022_C10773,17,18,38,73,2022
2022_A10774,88,45,50,183,2022
2022_A10775,99,23,30,152,2022
2019_A10776,14,75,40,129,2019
2022_B10777,56,81,61,198,2022
2022_B10778,24,87,89,200,2022
2019_B10779,62,45,41,148,2019
2021_C10780,88,48,94,230,2021
2021_B10781,39,82,21,142,2021
2019_B10782,69,87,38,194,2019
2022_A10783,3,69,39,111,2022
2021_C10784,59,40,85,184,2021
2021_B10785,36,77,53,166,2021
2021_C10786,72,30,93,195,2021
2021_B10787,56,68,48,172,2021
2019_A10788,6,22,22,50,2019
2019_A10789,24,85,35,144,2019
2021_C10790,93,38,56,187,2021
2019_B10791,76,85,34,195,2019
2019_C10792,34,94,91,219,2019
2019_A10793,67,86,94,247,2019
2022_C10794,20,82,28,130,2022
2022_A10795,12,78,78,168,2022
2022_C10796,45,42,93,180,2022
2021_A10797,51,81,78,210,2021
2022_C10798,63,88,43,194,2022
2021_B10799,62,68,76,206,2021
2019_C10800,47,37,56,140,2019
2021_C10801,0,76,71,147,2021
2022_C10802,92,66,34,192,2022
2021_A10803,91,46,80,217,2021
2022_A10804,16,20,42,78,2022
2019_B10805,87,23,78,188,2019
2021_A10806,69,49,58,176,2021
2019_A10807,60,63,83,206,2019
2021_A10808,87,13,94,194,2021
2021_C10809,95,22,96,213,2021
2022_B10810,55,83,58,196,2022
2021_B10811,86,29,29,144,2021
2022_B10812,61,27,36,124,2022
2021_C10813,13,21,65,99,2021
2019_A10814,15,92,41,148,2019
2019_C10815,57,97,59,213,2019
2021_C10816,43,43,48,134,2021
2019_B10817,67,60,85,212,2019
2022_A10818,0,18,76,94,2022
2021_B10819,96,45,26,167,2021
2019_A10820,39,28,49,116,2019
2019_A10821,76,42,78,196,2019
2021_C10822,83,89,91,263,2021
2021_C10823,95,38,70,203,2021
2022_B10824,23,51,34,108,2022
2022_B10825,11,72,94,177,2022
2019_A10826,48,97,95,240,2019
2019_C10827,28,97,36,161,2019
2022_A10828,70,15,87,172,2022
2019_B10829,29,62,50,141,2019
2022_B10830,99,16,44,159,2022
2021_B10831,63,23,42,128,2021
2019_C10832,52,17,26,95,2019
2019_A10833,99,54,45,198,2019
2022_C10834,13,48,26,87,2022
2021_A10835,40,65,46,151,2021
2019_A10836,21,54,45,120,2019
2022_C10837,92,62,21,175,2022
2019_C10838,80,89,90,259,2019
2021_A10839,57,97,36,190,2021
2021_A10840,14,45,75,134,2021
2019_A10841,65,13,87,165,2019
2022_A10842,47,35,68,150,2022
2022_C10843,97,17,45,159,2022
2021_B10844,69,86,25,180,2021
2019_C10845,41,71,35,147,2019
2021_C10846,41,93,23,157,2021
2021_B10847,76,38,93,207,2021
2022_C10848,46,51,52,149,2022
2022_A10849,44,22,82,148,2022
2019_B10850,47,82,80,209,2019
2021_A10851,28,62,30,120,2021
2021_B10852,29,65,60,154,2021
2019_A10853,89,87,23,199,2019
2021_A10854,83,93,70,246,2021
2021_B10855,28,84,96,208,2021
2019_B10856,72,58,38,168,2019
2021_A10857,14,12,92,118,2021
2019_A10858,50,94,32,176,2019
2019_B10859,86,59,34,179,2019
2021_C10860,1,16,31,48,2021
2021_B10861,92,25,84,201,2021
2022_C10862,43,55,62,160,2022
2022_B10863,46,41,38,125,2022
2021_B10864,73,85,52,210,2021
2022_A10865,15,94,99,208,2022
2022_A10866,8,14,69,91,2022
2022_B10867,99,76,24,199,2022
2019_C10868,13,73,46,132,2019
2021_B10869,54,52,76,182,2021
2019_A10870,63,38,54,155,2019
2021_C10871,30,93,97,220,2021
2021_B10872,6,31,58,95,2021
2019_C10873,14,66,67,147,2019
2022_A10874,73,43,53,169,2022
2021_C10875,54,83,25,162,2021
2019_A10876,9,34,22,65,2019
2019_B10877,54,30,73,157,2019
2019_A10878,79,24,27,130,2019
2019_C10879,94,66,88,248,2019
2019_B10880,13,26,57,96,2019
2019_B10881,78,53,77,208,2019
2019_B10882,52,27,51,130,2019
2019_A10883,26,40,55,121,2019
2019_A10884,85,16,60,161,2019
2022_C10885,94,65,71,230,2022
2021_A10886,27,64,94,185,2021
2019_B10887,61,12,52,125,2019
2019_B10888,32,26,45,103,2019
2021_A10889,73,91,41,205,2021
2022_B10890,82,94,38,214,2022
2021_C10891,41,21,47,109,2021
2021_A10892,100,43,31,174,2021
2022_B10893,31,18,28,77,2022
2022_B10894,6,41,60,107,2022
2019_A10895,66,86,23,175,2019
2021_C10896,8,59,55,122,2021
2019_B10897,34,90,72,196,2019
2019_C10898,14,48,99,161,2019
2021_B10899,55,47,24,126,2021
2019_C10900,18,60,92,170,2019
2022_A10901,5,48,50,103,2022
2019_C10902,3,83,69,155,2019
2021_A10903,62,17,59,138,2021
2021_A10904,38,80,66,184,2021
2022_B10905,43,70,41,154,2022
2021_C10906,73,57,23,153,2021
2022_A10907,9,30,39,78,2022
2019_A10908,70,40,86,196,2019
2021_B10909,61,74,81,216,2021
2019_B10910,96,96,98,290,2019
2019_B10911,79,52,85,216,2019
2022_C10912,91,43,69,203,2022
2019_B10913,37,16,28,81,2019
2022_B10914,54,58,24,136,2022
2022_B10915,92,41,51,184,2022
2021_B10916,44,20,77,141,2021
2021_B10917,41,31,64,136,2021
2022_A10918,41,65,52,158,2022
2022_A10919,0,13,80,93,2022
2022_C10920,4,84,53,141,2022
2019_C10921,18,38,53,109,2019
2019_C10922,12,84,31,127,2019
2019_A10923,20,47,70,137,2019
2019_B10924,10,73,72,155,2019
2022_C10925,67,41,43,151,2022
2022_B10926,15,73,64,152,2022
2021_B10927,11,93,80,184,2021
2019_B10928,69,73,78,220,2019
2019_C10929,51,63,65,179,2019
2021_C10930,18,43,88,149,2021
2022_B10931,70,30,91,191,2022
2022_C10932,77,76,38,191,2022
2019_A10933,45,37,39,121,2019
2022_C10934,90,65,21,176,2022
2021_C10935,55,89,38,182,2021
2022_A10936,94,34,71,199,2022
2021_C10937,20,97,28,145,2021
2019_C10938,4,16,95,115,2019
2022_B10939,58,90,74,222,2022
2019_A10940,76,20,57,153,2019
2019_C10941,83,38,86,207,2019
2019_C10942,43,60,85,188,2019
2022_B10943,66,72,37,175,2022
2021_A10944,94,72,88,254,2021
2019_B10945,1,94,80,175,2019
2022_B10946,46,64,44,154,2022
2019_C10947,55,95,47,197,2019
2022_C10948,39,46,57,142,2022
2021_A10949,83,34,90,207,2021
2021_B10950,13,27,83,123,2021
2022_A10951,41,66,32,139,2022
2019_B10952,10,32,29,71,2019
2019_C10953,20,45,81,146,2019
2021_C10954,61,58,87,206,2021
2019_B10955,6,13,88,107,2019
2019_B10956,88,13,24,125,2019
2019_B10957,91,45,36,172,2019
2019_A10958,34,92,32,158,2019
2022_A10959,10,67,56,133,2022
2021_B10960,59,30,65,154,2021
2022_B10961,5,58,66,129,2022
2022_C10962,89,45,79,213,2022
2021_B10963,51,83,36,170,2021
2021_B10964,82,21,90,193,2021
2019_B10965,46,69,70,185,2019
2022_B10966,2,90,29,121,2022
2019_C10967,12,83,56,151,2019
2021_C10968,40,30,50,120,2021
2022_B10969,24,34,55,113,2022
2019_C10970,48,95,91,234,2019
2021_A10971,95,48,29,172,2021
2019_A10972,88,34,29,151,2019
2021_C10973,44,11,41,96,2021
2021_C10974,78,27,40,145,2021
2022_A10975,37,82,33,152,2022
2022_B10976,0,75,62,137,2022
2019_B10977,37,39,22,98,2019
2022_C10978,7,74,88,169,2022
2022_B10979,7,67,76,150,2022
2021_B10980,16,66,77,159,2021
2022_A10981,0,95,44,139,2022
2021_A10982,49,90,38,177,2021
2019_C10983,12,39,93,144,2019
2019_A10984,87,14,78,179,2019
2022_B10985,70,50,63,183,2022
2019_C10986,52,75,32,159,2019
2019_B10987,84,48,38,170,2019
2021_C10988,7,15,81,103,2021
2019_B10989,0,59,99,158,2019
2021_B10990,73,28,56,157,2021
2021_C10991,47,67,37,151,2021
2022_B10992,52,20,25,97,2022
2021_B10993,98,26,30,154,2021
2019_A10994,70,92,96,258,2019
2019_A10995,6,50,65,121,2019
2021_C10996,33,89,90,212,2021
2021_C10997,19,47,41,107,2021
2021_B10998,67,67,58,192,2021
2022_A10999,39,68,55,162,2022
2022_A11000,26,20,32,78,2022
2019_C11001,95,84,25,204,2019
2019_C11002,19,40,65,124,2019
2021_A11003,61,86,48,195,2021
2021_C11004,84,54,66,204,2021
2022_A11005,35,54,88,177,2022
2022_C11006,100,32,21,153,2022
2021_A11007,59,90,98,247,2021
2022_A11008,84,42,40,166,2022
2022_B11009,78,29,38,145,2022
2019_B11010,62,49,58,169,2019
2022_C11011,98,36,50,184,2022
2019_C11012,80,25,88,193,2019
2021_C11013,91,94,88,273,2021
2019_A11014,75,78,92,245,2019
2022_C11015,93,76,61,230,2022
2019_C11016,88,84,21,193,2019
2019_C11017,76,57,99,232,2019
2019_B11018,95,64,90,249,2019
2022_A11019,3,67,61,131,2022
2021_C11020,26,95,72,193,2021
2019_C11021,81,45,37,163,2019
2019_C11022,82,28,23,133,2019
2021_C11023,92,54,59,205,2021
2021_C11024,53,40,89,182,2021
2019_A11025,62,91,74,227,2019
2021_A11026,60,11,40,111,2021
2022_C11027,37,34,36,107,2022
2022_C11028,71,41,86,198,2022
2019_C11029,28,87,88,203,2019
2019_C11030,64,59,81,204,2019
2022_B11031,6,93,77,176,2022
2022_A11032,39,37,75,151,2022
2021_B11033,86,28,37,151,2021
2021_A11034,95,12,60,167,2021
2019_B11035,99,69,70,238,2019
2019_A11036,80,73,40,193,2019
2022_B11037,39,83,53,175,2022
2022_B11038,19,44,69,132,2022
2021_C11039,46,23,81,150,2021
2021_C11040,94,91,42,227,2021
2019_B11041,18,21,79,118,2019
2021_A11042,11,33,41,85,2021
2019_B11043,74,81,53,208,2019
2021_B11044,4,25,86,115,2021
2022_A11045,89,93,82,264,2022
2022_B11046,35,17,97,149,2022
2022_C11047,82,97,66,245,2022
2021_B11048,71,86,71,228,2021
2019_C11049,35,36,94,165,2019
2021_A11050,88,22,40,150,2021
2022_A11051,27,24,56,107,2022
2022_A11052,89,67,23,179,2022
2019_B11053,16,36,76,128,2019
2021_A11054,78,87,21,186,2021
2019_C11055,36,20,97,153,2019
2021_A11056,41,57,26,124,2021
2022_A11057,21,39,62,122,2022
2022_C11058,21,22,93,136,2022
2022_B11059,88,34,94,216,2022
2022_B11060,36,91,81,208,2022
2021_B11061,29,64,27,120,2021
2021_A11062,29,43,50,122,2021
2019_A11063,37,77,45,159,2019
2022_C11064,45,90,22,157,2022
2019_C11065,43,45,22,110,2019
2019_A11066,15,74,28,117,2019
2019_C11067,66,79,44,189,2019
2022_A11068,49,42,80,171,2022
2022_A11069,96,97,82,275,2022
2022_C11070,89,16,72,177,2022
2021_C11071,84,42,75,201,2021
2022_C11072,17,73,24,114,2022
2019_C11073,3,27,24,54,2019
2022_C11074,9,50,57,116,2022
2022_A11075,13,46,31,90,2022
2019_C11076,36,50,29,115,2019
2022_B11077,93,57,47,197,2022
2021_A11078,100,25,95,220,2021
2021_B11079,28,35,78,141,2021
2021_A11080,67,94,84,245,2021
2021_B11081,75,47,80,202,2021
2022_A11082,77,27,94,198,2022
2021_C11083,17,75,59,151,2021
2022_C11084,61,90,80,231,2022
2019_B11085,100,47,25,172,2019
2019_B11086,96,46,96,238,2019
2021_C11087,93,29,62,184,2021
2019_C11088,45,45,44,134,2019
2022_B11089,23,85,93,201,2022
2021_C11090,27,56,43,126,2021
2021_C11091,41,56,73,170,2021
2021_B11092,80,43,57,180,2021
2022_B11093,74,66,34,174,2022
2022_A11094,47,13,56,116,2022
2022_A11095,1,62,48,111,2022
2019_A11096,65,75,93,233,2019
2022_B11097,42,41,95,178,2022
2021_C11098,52,72,65,189,2021
2021_C11099,98,83,87,268,2021
2019_B11100,18,57,36,111,2019
2022_B11101,67,22,43,132,2022
2019_B11102,73,61,76,210,2019
2019_C11103,99,50,30,179,2019
2022_B11104,25,96,73,194,2022
2019_C11105,92,49,58,199,2019
2019_A11106,76,54,27,157,2019
2019_C11107,20,18,51,89,2019
2019_B11108,58,30,83,171,2019
2019_B11109,34,78,49,161,2019
2022_C11110,0,35,80,115,2022
2021_C11111,66,62,62,190,2021
2021_B11112,52,46,40,138,2021
2022_C11113,14,44,92,150,2022
2022_B11114,91,93,90,274,2022
2021_B11115,3,25,25,53,2021
2019_B11116,60,65,80,205,2019
2022_C11117,24,50,45,119,2022
2022_A11118,97,95,63,255,2022
2021_B11119,51,76,98,225,2021
2022_A11120,16,15,52,83,2022
2022_B11121,7,43,93,143,2022
2021_A11122,53,57,43,153,2021
2019_A11123,94,66,27,187,2019
2021_C11124,69,24,81,174,2021
2019_B11125,82,23,67,172,2019
2021_B11126,94,15,83,192,2021
2022_A11127,80,79,23,182,2022
2022_C11128,4,94,93,191,2022
2021_B11129,63,77,51,191,2021
2021_A11130,1,95,68,164,2021
2019_C11131,65,39,72,176,2019
2019_B11132,1,21,86,108,2019
2022_C11133,37,74,43,154,2022
2019_A11134,49,93,71,213,2019
2021_C11135,69,94,43,206,2021
2022_C11136,33,67,24,124,2022
2021_C11137,24,23,80,127,2021
2022_A11138,25,19,26,70,2022
2021_B11139,9,24,99,132,2021
2022_C11140,73,89,91,253,2022
2022_C11141,52,56,45,153,2022
2019_C11142,90,58,73,221,2019
2021_A11143,98,33,65,196,2021
2019_B11144,39,59,25,123,2019
2021_B11145,73,22,67,162,2021
2022_A11146,4,75,41,120,2022
2022_A11147,89,37,91,217,2022
2019_C11148,90,31,81,202,2019
2022_C11149,55,87,78,220,2022
2019_A11150,60,40,50,150,2019
2021_A11151,97,37,24,158,2021
2019_A11152,89,74,27,190,2019
2019_C11153,38,66,85,189,2019
2022_A11154,16,32,46,94,2022
2019_B11155,59,81,48,188,2019
2021_C11156,41,55,30,126,2021
2022_A11157,0,58,74,132,2022
2021_B11158,79,86,77,242,2021
2022_A11159,29,82,55,166,2022
2019_A11160,67,37,90,194,2019
2021_C11161,38,26,97,161,2021
2021_C11162,9,29,94,132,2021
2021_A11163,61,72,35,168,2021
2022_B11164,43,86,43,172,2022
2021_A11165,70,48,31,149,2021
2022_A11166,53,66,45,164,2022
2019_C11167,53,74,32,159,2019
2021_A11168,11,42,85,138,2021
2021_B11169,41,31,75,147,2021
2022_A11170,22,29,86,137,2022
2019_B11171,10,46,91,147,2019
2021_B11172,78,51,97,226,2021
2019_C11173,81,97,74,252,2019
2021_A11174,46,40,97,183,2021
2019_B11175,41,74,31,146,2019
2021_A11176,88,27,87,202,2021
2021_B11177,63,25,46,134,2021
2021_B11178,61,73,22,156,2021
2021_B11179,19,69,33,121,2021
2022_C11180,22,11,86,119,2022
2019_A11181,23,57,30,110,2019
2019_B11182,12,83,76,171,2019
2021_C11183,56,66,34,156,2021
2022_B11184,38,65,80,183,2022
2019_B11185,98,52,80,230,2019
2019_B11186,73,36,91,200,2019
2019_A11187,20,55,25,100,2019
2019_C11188,65,31,85,181,2019
2022_C11189,44,53,61,158,2022
2022_C11190,92,82,78,252,2022
2021_A11191,100,63,35,198,2021
2021_B11192,59,85,86,230,2021
2021_C11193,79,27,28,134,2021
2019_A11194,0,74,31,105,2019
2021_A11195,74,67,56,197,2021
2022_C11196,13,96,58,167,2022
2022_C11197,17,32,87,136,2022
2019_C11198,30,70,56,156,2019
2021_C11199,43,79,68,190,2021
2022_B11200,83,72,85,240,2022
2021_A11201,80,70,60,210,2021
2021_A11202,67,39,32,138,2021
2021_A11203,12,93,68,173,2021
2021_B11204,7,32,54,93,2021
2021_B11205,5,68,53,126,2021
2022_B11206,83,40,85,208,2022
2022_A11207,69,86,57,212,2022
2022_B11208,92,79,76,247,2022
2022_C11209,44,31,55,130,2022
2021_B11210,84,53,32,169,2021
2019_B11211,57,34,46,137,2019
2022_C11212,80,28,98,206,2022
2021_C11213,12,83,68,163,2021
2022_B11214,15,81,84,180,2022
2019_C11215,51,72,54,177,2019
2022_A11216,89,73,38,200,2022
2019_B11217,83,94,89,266,2019
2019_C11218,43,93,62,198,2019
2022_B11219,25,61,43,129,2022
2022_A11220,21,64,75,160,2022
2021_A11221,42,65,47,154,2021
2019_A11222,4,28,65,97,2019
2019_A11223,89,80,74,243,2019
2019_A11224,88,21,31,140,2019
2022_C11225,11,77,47,135,2022
2022_A11226,8,81,24,113,2022
2021_B11227,63,39,28,130,2021
2021_A11228,49,45,68,162,2021
2021_C11229,54,53,36,143,2021
2021_C11230,13,38,82,133,2021
2021_C11231,34,54,59,147,2021
2021_B11232,52,79,70,201,2021
2021_B11233,48,34,49,131,2021
2022_B11234,12,45,70,127,2022
2021_A11235,24,33,87,144,2021
2021_A11236,60,62,80,202,2021
2022_B11237,71,30,77,178,2022
2019_C11238,59,24,24,107,2019
2022_C11239,12,64,56,132,2022
2019_C11240,25,30,74,129,2019
2022_C11241,33,59,49,141,2022
2021_B11242,30,96,41,167,2021
2019_B11243,43,49,90,182,2019
2019_B11244,14,94,65,173,2019
2022_A11245,74,32,40,146,2022
2021_B11246,68,50,42,160,2021
2022_A11247,59,40,99,198,2022
2021_C11248,96,16,87,199,2021
2019_A11249,35,60,34,129,2019
2022_B11250,47,43,43,133,2022
2022_A11251,79,87,58,224,2022
2022_C11252,0,54,28,82,2022
2022_A11253,90,65,85,240,2022
2021_B11254,89,11,22,122,2021
2021_A11255,98,63,85,246,2021
2021_B11256,49,11,61,121,2021
2019_A11257,27,20,21,68,2019
2021_B11258,75,59,77,211,2021
2019_C11259,13,63,62,138,2019
2021_B11260,97,34,64,195,2021
2019_C11261,27,70,35,132,2019
2022_B11262,74,25,72,171,2022
2022_A11263,53,59,62,174,2022
2019_B11264,87,91,39,217,2019
2019_C11265,20,30,48,98,2019
2022_A11266,32,95,80,207,2022
2019_A11267,9,60,21,90,2019
2022_C11268,30,44,32,106,2022
2022_B11269,24,30,23,77,2022
2019_C11270,40,54,75,169,2019
2022_A11271,17,92,78,187,2022
2019_B11272,73,19,59,151,2019
2019_A11273,14,62,96,172,2019
2022_A11274,3,33,83,119,2022
2021_B11275,76,91,69,236,2021
2022_A11276,87,68,63,218,2022
2021_C11277,100,85,34,219,2021
2022_C11278,76,28,95,199,2022
2021_C11279,55,16,28,99,2021
2021_A11280,24,23,50,97,2021
2021_B11281,70,67,38,175,2021
2019_C11282,65,42,93,200,2019
2019_A11283,51,27,98,176,2019
2021_B11284,100,53,88,241,2021
2022_A11285,39,70,49,158,2022
2021_B11286,97,82,63,242,2021
2022_B11287,3,39,59,101,2022
2022_A11288,84,19,98,201,2022
2021_C11289,11,86,54,151,2021
2022_C11290,100,42,63,205,2022
2022_A11291,38,95,96,229,2022
2021_B11292,20,36,45,101,2021
2022_B11293,4,91,51,146,2022
2021_C11294,2,13,55,70,2021
2022_A11295,94,63,26,183,2022
2021_B11296,40,41,80,161,2021
2021_B11297,96,83,61,240,2021
2022_C11298,19,81,31,131,2022
2021_B11299,11,12,66,89,2021
2019_C11300,10,14,51,75,2019
2021_B11301,79,97,69,245,2021
2021_A11302,17,71,46,134,2021
2019_A11303,24,42,96,162,2019
2022_B11304,78,51,43,172,2022
2021_A11305,57,86,97,240,2021
2019_C11306,33,73,79,185,2019
2021_B11307,25,31,78,134,2021
2019_C11308,71,65,83,219,2019
2019_B11309,80,87,41,208,2019
2021_B11310,86,75,87,248,2021
2021_A11311,6,81,23,110,2021
2022_C11312,77,93,33,203,2022
2019_C11313,43,41,91,175,2019
2021_C11314,30,88,87,205,2021
2022_C11315,17,89,92,198,2022
2022_C11316,97,27,48,172,2022
2019_A11317,14,94,55,163,2019
2022_B11318,73,29,29,131,2022
2022_B11319,66,69,86,221,2022
2022_B11320,21,48,51,120,2022
2022_B11321,18,41,41,100,2022
2022_A11322,96,36,87,219,2022
2022_C11323,25,87,82,194,2022
2022_A11324,78,21,41,140,2022
2019_B11325,60,94,56,210,2019
2021_B11326,88,65,90,243,2021
2022_B11327,18,44,54,116,2022
2021_C11328,93,56,46,195,2021
2022_B11329,60,19,36,115,2022
2021_C11330,46,52,35,133,2021
2019_B11331,32,75,56,163,2019
2021_C11332,35,54,58,147,2021
2022_B11333,26,18,30,74,2022
2021_B11334,10,88,49,147,2021
2022_B11335,8,75,72,155,2022
2019_A11336,40,58,77,175,2019
2022_C11337,83,58,45,186,2022
2019_A11338,39,74,89,202,2019
2019_B11339,49,38,25,112,2019
2021_C11340,42,48,78,168,2021
2022_A11341,11,67,36,114,2022
2021_B11342,87,40,64,191,2021
2021_B11343,87,16,34,137,2021
2021_B11344,43,24,56,123,2021
2021_A11345,53,42,83,178,2021
2021_A11346,1,33,38,72,2021
2021_A11347,81,64,33,178,2021
2022_A11348,20,68,64,152,2022
2021_C11349,77,80,71,228,2021
2022_C11350,36,95,62,193,2022
2021_C11351,19,96,92,207,2021
2022_A11352,46,79,78,203,2022
2019_B11353,56,68,46,170,2019
2019_B11354,76,69,74,219,2019
2021_B11355,38,36,76,150,2021
2019_C11356,16,29,61,106,2019
2022_A11357,68,71,98,237,2022
2021_A11358,65,67,96,228,2021
2021_A11359,35,53,90,178,2021
2021_B11360,85,21,93,199,2021
2019_B11361,18,81,91,190,2019
2021_B11362,38,42,76,156,2021
2019_B11363,46,76,77,199,2019
2022_B11364,62,83,72,217,2022
2022_B11365,31,51,43,125,2022
2021_B11366,8,22,69,99,2021
2021_C11367,91,50,46,187,2021
2021_A11368,29,46,34,109,2021
2022_B11369,35,30,68,133,2022
2019_A11370,24,30,39,93,2019
2019_C11371,51,78,71,200,2019
2021_C11372,88,48,42,178,2021
2019_C11373,92,25,24,141,2019
2019_C11374,71,43,88,202,2019
2022_B11375,0,69,41,110,2022
2022_B11376,0,77,88,165,2022
2019_A11377,31,82,58,171,2019
2019_A11378,89,53,90,232,2019
2021_C11379,4,48,47,99,2021
2021_B11380,55,30,60,145,2021
2021_C11381,5,41,30,76,2021
2022_C11382,41,73,49,163,2022
2019_A11383,31,12,33,76,2019
2021_A11384,5,11,48,64,2021
2022_B11385,88,77,79,244,2022
2019_A11386,34,49,80,163,2019
2019_C11387,38,40,83,161,2019
2022_A11388,55,11,54,120,2022
2021_C11389,30,81,43,154,2021
2019_A11390,53,19,92,164,2019
2019_A11391,68,68,23,159,2019
2021_B11392,70,41,57,168,2021
2021_C11393,8,89,51,148,2021
2019_A11394,89,47,25,161,2019
2021_A11395,91,53,80,224,2021
2021_B11396,58,78,48,184,2021
2022_A11397,34,42,53,129,2022
2021_B11398,62,22,24,108,2021
2021_A11399,47,41,81,169,2021
2019_A11400,33,29,36,98,2019
2022_C11401,12,33,34,79,2022
2021_C11402,32,26,67,125,2021
2022_A11403,43,77,58,178,2022
2021_C11404,32,59,85,176,2021
2021_C11405,46,68,46,160,2021
2022_C11406,41,20,69,130,2022
2022_A11407,57,65,37,159,2022
2019_C11408,57,57,41,155,2019
2019_C11409,62,95,77,234,2019
2022_C11410,63,90,36,189,2022
2022_C11411,42,43,70,155,2022
2021_C11412,23,29,87,139,2021
2019_C11413,97,63,29,189,2019
2021_B11414,26,11,57,94,2021
2019_C11415,57,92,50,199,2019
2022_A11416,19,36,39,94,2022
2022_A11417,6,42,55,103,2022
2022_B11418,95,37,42,174,2022
2019_C11419,84,22,79,185,2019
2021_C11420,34,30,98,162,2021
2019_A11421,30,38,27,95,2019
2021_C11422,97,91,64,252,2021
2022_B11423,27,22,57,106,2022
2021_B11424,12,54,85,151,2021
2022_B11425,43,21,59,123,2022
2019_C11426,41,97,29,167,2019
2022_A11427,59,68,87,214,2022
2021_C11428,5,87,93,185,2021
2022_B11429,1,56,97,154,2022
2022_A11430,56,27,87,170,2022
2021_C11431,98,33,88,219,2021
2019_B11432,42,85,90,217,2019
2019_B11433,37,53,46,136,2019
2022_C11434,66,65,30,161,2022
2021_B11435,88,60,94,242,2021
2021_A11436,8,57,87,152,2021
2021_B11437,97,83,78,258,2021
2021_B11438,53,14,52,119,2021
2019_B11439,100,50,26,176,2019
2021_B11440,10,35,77,122,2021
2022_C11441,34,14,96,144,2022
2022_C11442,25,78,79,182,2022
2021_A11443,46,40,45,131,2021
2022_A11444,13,78,53,144,2022
2021_A11445,69,32,71,172,2021
2021_A11446,41,71,87,199,2021
2021_B11447,73,13,82,168,2021
2022_B11448,60,55,61,176,2022
2022_C11449,67,19,21,107,2022
2021_C11450,55,19,22,96,2021
2021_B11451,17,54,57,128,2021
2021_C11452,18,32,74,124,2021
2021_B11453,60,13,58,131,2021
2021_C11454,2,93,77,172,2021
2021_C11455,44,83,49,176,2021
2021_B11456,80,75,65,220,2021
2022_C11457,96,53,39,188,2022
2019_A11458,73,60,27,160,2019
2021_B11459,13,26,39,78,2021
2021_B11460,36,17,68,121,2021
2022_A11461,68,88,41,197,2022
2021_B11462,20,67,85,172,2021
2022_A11463,49,62,70,181,2022
2021_C11464,20,60,23,103,2021
2022_A11465,62,50,79,191,2022
2022_B11466,60,77,44,181,2022
2022_C11467,100,53,41,194,2022
2021_C11468,42,42,39,123,2021
2021_B11469,40,44,39,123,2021
2019_B11470,32,97,81,210,2019
2021_B11471,23,56,76,155,2021
2021_A11472,74,87,91,252,2021
2019_C11473,14,24,84,122,2019
2022_A11474,0,49,63,112,2022
2019_C11475,12,13,57,82,2019
2022_A11476,97,77,48,222,2022
2019_B11477,48,71,64,183,2019
2021_A11478,37,64,53,154,2021
2022_A11479,24,68,65,157,2022
2022_B11480,52,35,60,147,2022
2022_A11481,20,45,57,122,2022
2019_A11482,20,60,41,121,2019
2022_A11483,10,80,88,178,2022
2022_A11484,29,68,84,181,2022
2021_B11485,35,51,41,127,2021
2021_A11486,71,43,44,158,2021
2022_A11487,13,19,24,56,2022
2019_B11488,21,42,21,84,2019
2019_B11489,84,42,52,178,2019
2019_C11490,13,29,49,91,2019
2021_A11491,57,66,30,153,2021
2021_B11492,79,92,61,232,2021
2019_B11493,40,22,62,124,2019
2022_A11494,43,15,92,150,2022
2019_A11495,37,93,86,216,2019
2019_C11496,62,27,60,149,2019
2022_C11497,37,72,29,138,2022
2019_A11498,54,89,97,240,2019
2021_A11499,96,25,76,197,2021
2019_A11500,79,64,47,190,2019
2019_A11501,60,11,80,151,2019
2019_B11502,25,93,47,165,2019
2021_B11503,9,14,30,53,2021
2022_B11504,52,42,33,127,2022
2022_B11505,17,55,97,169,2022
2019_C11506,15,13,80,108,2019
2019_C11507,56,55,92,203,2019
2019_C11508,36,86,51,173,2019
2019_B11509,1,72,66,139,2019
2019_C11510,12,27,84,123,2019
2019_C11511,93,58,51,202,2019
2019_C11512,13,31,83,127,2019
2019_A11513,70,32,74,176,2019
2019_C11514,8,89,87,184,2019
2022_B11515,71,42,55,168,2022
2022_B11516,10,50,25,85,2022
2021_C11517,62,79,63,204,2021
2022_A11518,90,87,64,241,2022
2021_C11519,48,82,45,175,2021
2021_B11520,21,38,91,150,2021
2022_A11521,42,31,33,106,2022
2021_A11522,2,63,22,87,2021
2022_C11523,94,76,75,245,2022
2022_B11524,13,92,92,197,2022
2021_A11525,89,51,80,220,2021
2019_A11526,14,27,62,103,2019
2021_A11527,76,16,65,157,2021
2019_C11528,65,42,44,151,2019
2019_C11529,47,30,63,140,2019
2022_A11530,0,67,75,142,2022
2022_C11531,84,23,96,203,2022
2021_C11532,82,11,39,132,2021
2019_C11533,34,62,70,166,2019
2022_C11534,43,21,37,101,2022
2022_C11535,48,56,56,160,2022
2021_A11536,75,57,40,172,2021
2021_B11537,63,82,86,231,2021
2021_A11538,26,97,90,213,2021
2021_A11539,58,91,61,210,2021
2019_C11540,54,23,49,126,2019
2022_A11541,81,51,91,223,2022
2021_A11542,27,80,77,184,2021
2022_A11543,46,47,64,157,2022
2019_B11544,72,14,78,164,2019
2022_C11545,19,24,34,77,2022
2022_A11546,28,73,87,188,2022
2021_B11547,73,32,70,175,2021
2022_A11548,100,64,30,194,2022
2021_B11549,20,63,82,165,2021
2019_C11550,33,31,43,107,2019
2022_B11551,88,63,62,213,2022
2021_B11552,6,76,64,146,2021
2021_A11553,11,64,73,148,2021
2019_A11554,80,70,52,202,2019
2022_C11555,95,65,74,234,2022
2022_B11556,69,22,36,127,2022
2019_B11557,3,90,54,147,2019
2021_B11558,50,79,31,160,2021
2019_C11559,97,14,32,143,2019
2021_A11560,87,68,65,220,2021
2022_C11561,23,75,37,135,2022
2019_C11562,31,32,86,149,2019
2021_C11563,31,30,49,110,2021
2021_A11564,86,90,32,208,2021
2019_A11565,12,93,62,167,2019
2021_B11566,46,33,41,120,2021
2019_C11567,30,58,87,175,2019
2021_C11568,76,71,47,194,2021
2022_A11569,27,50,26,103,2022
2021_A11570,23,31,34,88,2021
2021_C11571,82,75,88,245,2021
2022_B11572,90,44,33,167,2022
2019_B11573,32,29,72,133,2019
2019_C11574,34,64,21,119,2019
2022_A11575,16,54,22,92,2022
2019_B11576,5,65,29,99,2019
2021_A11577,98,32,39,169,2021
2022_A11578,64,93,87,244,2022
2022_A11579,71,72,37,180,2022
2021_C11580,56,22,73,151,2021
2019_C11581,31,48,71,150,2019
2021_C11582,79,73,50,202,2021
2021_C11583,86,74,88,248,2021
2022_A11584,18,33,31,82,2022
2019_B11585,51,17,93,161,2019
2022_C11586,32,55,94,181,2022
2022_B11587,4,59,74,137,2022
2022_A11588,70,85,28,183,2022
2022_A11589,3,18,63,84,2022
2019_C11590,15,64,49,128,2019
2022_C11591,0,96,64,160,2022
2022_A11592,18,26,22,66,2022
2019_A11593,43,97,94,234,2019
2019_B11594,22,89,53,164,2019
2019_A11595,78,17,70,165,2019
2022_C11596,76,11,58,145,2022
2021_C11597,87,25,73,185,2021
2021_A11598,93,94,35,222,2021
2021_C11599,37,49,41,127,2021
2022_B11600,87,54,91,232,2022
2022_B11601,10,90,22,122,2022
2019_C11602,87,90,52,229,2019
2022_A11603,69,52,47,168,2022
2019_C11604,42,62,44,148,2019
2022_A11605,54,25,72,151,2022
2019_A11606,67,44,67,178,2019
2021_C11607,67,28,37,132,2021
2021_A11608,79,22,96,197,2021
2022_B11609,76,49,46,171,2022
2019_A11610,42,13,25,80,2019
2021_A11611,33,22,97,152,2021
2021_A11612,45,41,25,111,2021
2019_A11613,10,28,48,86,2019
2021_A11614,100,36,61,197,2021
2022_A11615,78,64,27,169,2022
2021_B11616,94,89,42,225,2021
2019_B11617,26,97,33,156,2019
2019_A11618,25,74,61,160,2019
2021_A11619,7,58,56,121,2021
2019_A11620,35,32,55,122,2019
2019_A11621,16,87,72,175,2019
2019_A11622,20,87,95,202,2019
2021_B11623,50,83,39,172,2021
2022_A11624,31,78,76,185,2022
2021_A11625,96,57,97,250,2021
2022_B11626,69,56,89,214,2022
2021_C11627,93,53,46,192,2021
2019_A11628,10,61,77,148,2019
2021_A11629,76,66,92,234,2021
2021_A11630,18,53,63,134,2021
2019_A11631,54,44,42,140,2019
2022_B11632,53,57,89,199,2022
2022_B11633,37,91,81,209,2022
2022_A11634,38,19,26,83,2022
2019_C11635,89,44,39,172,2019
2021_C11636,79,27,68,174,2021
2022_C11637,17,68,28,113,2022
2021_C11638,18,66,25,109,2021
2021_C11639,28,45,26,99,2021
2021_A11640,3,48,55,106,2021
2019_B11641,25,41,48,114,2019
2021_A11642,29,29,77,135,2021
2021_B11643,77,76,34,187,2021
2022_B11644,0,74,91,165,2022
2021_B11645,52,18,21,91,2021
2021_A11646,12,37,40,89,2021
2019_C11647,0,30,86,116,2019
2019_A11648,3,49,49,101,2019
2021_C11649,40,65,79,184,2021
2021_C11650,80,47,69,196,2021
2019_C11651,20,70,83,173,2019
2022_B11652,37,79,59,175,2022
2022_B11653,25,34,83,142,2022
2022_A11654,1,91,27,119,2022
2022_B11655,97,28,80,205,2022
2019_A11656,17,92,96,205,2019
2022_C11657,65,71,53,189,2022
2022_C11658,3,60,30,93,2022
2022_C11659,13,93,52,158,2022
2019_C11660,49,81,99,229,2019
2021_C11661,29,51,39,119,2021
2021_B11662,91,91,58,240,2021
2022_C11663,41,54,35,130,2022
2021_B11664,92,18,74,184,2021
2022_A11665,76,59,32,167,2022
2021_B11666,39,89,49,177,2021
2022_A11667,93,67,50,210,2022
2022_C11668,65,53,26,144,2022
2021_C11669,58,81,94,233,2021
2019_C11670,98,16,50,164,2019
2021_C11671,76,97,45,218,2021
2021_C11672,67,70,28,165,2021
2021_A11673,86,25,98,209,2021
2021_B11674,63,19,59,141,2021
2022_C11675,30,29,92,151,2022
2021_A11676,98,81,35,214,2021
2022_B11677,65,18,33,116,2022
2021_B11678,52,39,22,113,2021
2022_A11679,30,47,30,107,2022
2021_B11680,90,49,96,235,2021
2021_B11681,39,39,35,113,2021
2019_A11682,59,56,65,180,2019
2021_B11683,81,25,44,150,2021
2022_B11684,8,49,39,96,2022
2021_A11685,77,23,73,173,2021
2022_B11686,87,57,62,206,2022
2019_A11687,96,91,85,272,2019
2022_A11688,58,16,97,171,2022
2019_A11689,30,86,31,147,2019
2019_A11690,28,38,40,106,2019
2019_C11691,70,49,52,171,2019
2021_B11692,70,24,89,183,2021
2022_B11693,74,11,62,147,2022
2021_C11694,17,51,82,150,2021
2021_B11695,31,57,32,120,2021
2022_A11696,59,18,69,146,2022
2022_B11697,86,36,38,160,2022
2021_A11698,69,88,96,253,2021
2019_C11699,36,21,81,138,2019
2022_A11700,58,25,69,152,2022
2019_A11701,3,31,98,132,2019
2022_A11702,9,17,41,67,2022
2022_C11703,75,38,61,174,2022
2022_B11704,32,74,56,162,2022
2022_C11705,91,51,56,198,2022
2022_A11706,39,43,62,144,2022
2019_C11707,44,50,51,145,2019
2021_A11708,72,89,30,191,2021
2021_B11709,84,67,74,225,2021
2019_B11710,17,67,22,106,2019
2022_C11711,5,62,96,163,2022
2021_A11712,45,75,30,150,2021
2022_A11713,41,37,54,132,2022
2019_B11714,41,77,56,174,2019
2019_C11715,42,94,65,201,2019
2021_A11716,54,41,75,170,2021
2022_C11717,98,83,32,213,2022
2019_C11718,51,20,65,136,2019
2022_A11719,61,25,52,138,2022
2022_A11720,36,51,49,136,2022
2021_B11721,6,75,61,142,2021
2022_B11722,91,48,23,162,2022
2022_A11723,95,77,92,264,2022
2022_A11724,63,42,60,165,2022
2021_B11725,33,23,63,119,2021
2021_C11726,68,63,84,215,2021
2021_C11727,22,52,66,140,2021
2022_A11728,11,19,94,124,2022
2022_B11729,25,43,93,161,2022
2021_A11730,54,18,81,153,2021
2022_C11731,19,53,37,109,2022
2021_A11732,48,37,48,133,2021
2022_B11733,8,74,44,126,2022
2019_B11734,75,51,90,216,2019
2019_C11735,76,32,44,152,2019
2022_B11736,41,19,87,147,2022
2021_C11737,82,23,89,194,2021
2021_C11738,41,23,96,160,2021
2021_C11739,58,61,91,210,2021
2021_A11740,10,37,47,94,2021
2019_A11741,2,29,95,126,2019
2019_C11742,85,95,79,259,2019
2021_A11743,55,58,55,168,2021
2022_A11744,45,92,41,178,2022
2022_A11745,1,72,53,126,2022
2019_A11746,41,82,45,168,2019
2022_B11747,14,22,30,66,2022
2022_B11748,96,22,56,174,2022
2019_C11749,99,32,52,183,2019
2019_C11750,65,84,99,248,2019
2021_B11751,74,18,27,119,2021
2021_C11752,58,74,23,155,2021
2019_A11753,93,36,83,212,2019
2021_C11754,15,33,94,142,2021
2019_A11755,14,44,62,120,2019
2021_B11756,45,49,29,123,2021
2022_B11757,35,67,38,140,2022
2022_A11758,4,34,72,110,2022
2021_A11759,88,28,42,158,2021
2019_B11760,5,49,90,144,2019
2022_C11761,60,19,51,130,2022
2021_C11762,81,43,91,215,2021
2021_C11763,12,90,22,124,2021
2022_B11764,59,56,77,192,2022
2021_A11765,31,68,89,188,2021
2022_C11766,89,92,49,230,2022
2019_A11767,74,49,77,200,2019
2021_A11768,46,45,77,168,2021
2021_C11769,23,71,51,145,2021
2021_A11770,82,57,35,174,2021
2022_A11771,46,61,98,205,2022
2022_A11772,39,13,69,121,2022
2019_C11773,52,79,60,191,2019
2021_B11774,28,50,89,167,2021
2021_C11775,83,13,44,140,2021
2022_A11776,76,88,21,185,2022
2021_C11777,47,91,55,193,2021
2019_C11778,62,16,77,155,2019
2019_C11779,62,16,84,162,2019
2022_B11780,20,16,61,97,2022
2019_C11781,66,41,75,182,2019
2022_B11782,7,37,72,116,2022
2022_A11783,61,33,69,163,2022
2021_A11784,72,71,71,214,2021
2022_B11785,94,70,32,196,2022
2019_C11786,41,40,66,147,2019
2022_A11787,35,40,87,162,2022
2021_A11788,42,67,41,150,2021
2022_C11789,42,89,24,155,2022
2019_B11790,22,76,62,160,2019
2022_C11791,69,33,43,145,2022
2021_A11792,54,18,26,98,2021
2019_B11793,29,34,53,116,2019
2021_C11794,79,19,81,179,2021
2022_A11795,20,41,31,92,2022
2021_C11796,47,22,83,152,2021
2021_A11797,69,76,79,224,2021
2022_B11798,15,34,37,86,2022
2021_C11799,57,25,29,111,2021
2022_C11800,92,37,56,185,2022
2022_B11801,11,81,98,190,2022
2019_C11802,68,81,74,223,2019
2021_A11803,66,51,75,192,2021
2019_A11804,55,64,57,176,2019
2022_C11805,65,74,88,227,2022
2019_C11806,72,55,38,165,2019
2019_C11807,95,52,57,204,2019
2019_A11808,64,47,72,183,2019
2022_B11809,25,41,39,105,2022
2021_B11810,52,28,81,161,2021
2021_B11811,81,43,25,149,2021
2019_C11812,25,25,98,148,2019
2022_B11813,29,23,75,127,2022
2021_A11814,49,39,96,184,2021
2022_A11815,53,41,57,151,2022
2019_C11816,65,73,42,180,2019
2021_A11817,81,62,22,165,2021
2021_C11818,60,12,85,157,2021
2022_C11819,59,75,92,226,2022
2021_A11820,56,88,71,215,2021
2022_B11821,69,32,63,164,2022
2022_A11822,11,57,42,110,2022
2021_C11823,85,71,83,239,2021
2022_A11824,65,40,58,163,2022
2019_B11825,78,97,29,204,2019
2019_B11826,50,39,76,165,2019
2022_B11827,58,29,27,114,2022
2021_C11828,8,68,61,137,2021
2019_C11829,76,88,72,236,2019
2021_B11830,42,31,50,123,2021
2021_C11831,41,72,36,149,2021
2021_C11832,6,59,23,88,2021
2022_B11833,51,22,39,112,2022
2022_A11834,12,89,78,179,2022
2022_B11835,16,61,48,125,2022
2021_A11836,21,14,65,100,2021
2022_C11837,29,49,59,137,2022
2022_C11838,63,37,54,154,2022
2022_A11839,2,57,29,88,2022
2021_C11840,91,74,74,239,2021
2021_B11841,71,92,65,228,2021
2019_A11842,2,70,75,147,2019
2021_B11843,71,62,80,213,2021
2021_B11844,0,87,43,130,2021
2021_B11845,34,77,39,150,2021
2021_A11846,40,39,97,176,2021
2019_B11847,85,80,44,209,2019
2022_B11848,89,67,95,251,2022
2019_A11849,34,24,36,94,2019
2021_B11850,4,63,86,153,2021
2019_C11851,25,87,65,177,2019
2022_C11852,70,75,87,232,2022
2019_B11853,55,27,49,131,2019
2019_B11854,67,20,76,163,2019
2019_A11855,9,31,45,85,2019
2019_A11856,48,22,63,133,2019
2021_A11857,94,97,60,251,2021
2022_B11858,63,83,40,186,2022
2021_A11859,74,73,34,181,2021
2021_B11860,26,38,41,105,2021
2021_B11861,65,19,83,167,2021
2022_C11862,50,72,78,200,2022
2019_A11863,87,77,32,196,2019
2019_A11864,0,31,93,124,2019
2021_B11865,3,79,69,151,2021
2021_B11866,42,61,83,186,2021
2019_C11867,78,25,58,161,2019
2022_B11868,20,96,34,150,2022
2022_A11869,83,68,95,246,2022
2021_C11870,5,40,30,75,2021
2019_C11871,10,33,99,142,2019
2021_C11872,26,34,58,118,2021
2022_C11873,58,55,98,211,2022
2021_B11874,95,95,68,258,2021
2019_B11875,39,14,39,92,2019
2019_A11876,48,66,59,173,2019
2022_A11877,82,55,95,232,2022
2021_C11878,77,53,71,201,2021
2019_A11879,2,70,21,93,2019
2022_A11880,32,66,38,136,2022
2019_B11881,73,75,41,189,2019
2019_B11882,30,28,55,113,2019
2022_B11883,89,44,86,219,2022
2019_C11884,81,56,64,201,2019
2021_B11885,99,56,52,207,2021
2022_A11886,15,85,93,193,2022
2022_B11887,10,41,42,93,2022
2019_A11888,95,94,22,211,2019
2019_B11889,41,93,84,218,2019
2019_A11890,70,46,40,156,2019
2019_A11891,2,46,35,83,2019
2022_B11892,37,81,72,190,2022
2019_B11893,38,47,74,159,2019
2022_C11894,83,91,23,197,2022
2019_C11895,3,71,77,151,2019
2021_A11896,41,60,37,138,2021
2021_B11897,7,89,51,147,2021
2022_A11898,37,89,32,158,2022
2021_A11899,18,62,84,164,2021
2022_B11900,59,30,71,160,2022
2022_B11901,2,37,61,100,2022
2019_C11902,66,59,74,199,2019
2022_A11903,93,14,91,198,2022
2019_A11904,9,70,52,131,2019
2021_C11905,100,77,66,243,2021
2021_C11906,92,82,94,268,2021
2022_B11907,65,68,80,213,2022
2021_A11908,91,88,31,210,2021
2019_C11909,1,78,35,114,2019
2021_B11910,42,24,53,119,2021
2022_A11911,86,74,59,219,2022
2021_C11912,54,88,30,172,2021
2021_A11913,96,14,58,168,2021
2019_B11914,80,27,38,145,2019
2021_B11915,2,61,33,96,2021
2021_B11916,72,19,94,185,2021
2021_B11917,22,68,55,145,2021
2021_B11918,92,36,99,227,2021
2022_B11919,86,86,71,243,2022
2022_B11920,0,63,22,85,2022
2019_C11921,25,32,59,116,2019
2021_C11922,32,50,90,172,2021
2021_C11923,2,31,22,55,2021
2021_B11924,42,41,90,173,2021
2022_C11925,81,35,83,199,2022
2022_A11926,53,41,71,165,2022
2021_C11927,48,29,22,99,2021
2019_C11928,51,50,92,193,2019
2021_B11929,86,82,57,225,2021
2021_B11930,2,57,49,108,2021
2021_A11931,73,97,68,238,2021
2019_B11932,18,59,38,115,2019
2022_B11933,21,69,46,136,2022
2022_A11934,16,70,80,166,2022
2022_A11935,26,18,88,132,2022
2022_A11936,20,81,93,194,2022
2022_B11937,85,62,55,202,2022
2021_B11938,28,71,76,175,2021
2019_C11939,31,18,59,108,2019
2022_C11940,31,63,52,146,2022
2021_A11941,28,62,27,117,2021
2022_A11942,21,74,58,153,2022
2021_A11943,76,33,81,190,2021
2021_C11944,11,45,68,124,2021
2022_C11945,36,19,60,115,2022
2019_C11946,70,26,70,166,2019
2022_B11947,11,76,32,119,2022
2021_A11948,84,70,72,226,2021
2022_C11949,61,95,54,210,2022
2021_B11950,12,23,42,77,2021
2019_C11951,9,37,84,130,2019
2021_A11952,4,92,87,183,2021
2019_C11953,25,65,33,123,2019
2022_B11954,8,31,93,132,2022
2019_B11955,56,29,31,116,2019
2019_C11956,98,95,81,274,2019
2022_B11957,12,35,42,89,2022
2019_C11958,95,18,31,144,2019
2021_C11959,73,89,53,215,2021
2022_A11960,89,33,53,175,2022
2021_B11961,76,92,35,203,2021
2019_A11962,83,86,40,209,2019
2022_B11963,30,64,79,173,2022
2022_B11964,77,89,50,216,2022
2022_A11965,2,78,34,114,2022
2019_A11966,100,52,23,175,2019
2021_C11967,72,82,78,232,2021
2019_C11968,36,63,61,160,2019
2021_C11969,49,19,21,89,2021
2022_B11970,31,97,36,164,2022
2022_C11971,67,63,63,193,2022
2019_B11972,95,34,88,217,2019
2019_C11973,75,89,29,193,2019
2019_B11974,69,55,24,148,2019
2022_A11975,33,91,24,148,2022
2019_C11976,35,38,84,157,2019
2019_C11977,36,72,28,136,2019
2021_C11978,12,82,40,134,2021
2022_B11979,5,66,24,95,2022
2022_C11980,8,91,42,141,2022
2021_A11981,39,27,46,112,2021
2019_B11982,73,16,89,178,2019
2021_B11983,14,20,61,95,2021
2019_C11984,66,64,81,211,2019
2021_C11985,52,68,90,210,2021
2022_C11986,85,64,41,190,2022
2019_A11987,35,46,97,178,2019
2021_B11988,96,83,79,258,2021
2022_C11989,67,65,24,156,2022
2022_A11990,51,69,80,200,2022
2021_B11991,99,50,71,220,2021
2021_C11992,21,71,51,143,2021
2022_B11993,0,46,74,120,2022
2021_B11994,22,91,28,141,2021
2019_B11995,81,30,61,172,2019
2019_A11996,23,82,25,130,2019
2021_C11997,20,71,48,139,2021
2022_B11998,87,65,67,219,2022
2022_B11999,28,14,40,82,2022
2021_A12000,98,82,27,207,2021
2019_C12001,11,93,88,192,2019
2019_A12002,97,68,95,260,2019
2019_C12003,58,38,28,124,2019
2019_C12004,36,45,81,162,2019
2022_B12005,27,11,86,124,2022
2021_C12006,70,76,48,194,2021
2022_A12007,64,52,40,156,2022
2022_A12008,77,21,93,191,2022
2022_A12009,29,83,34,146,2022
2019_B12010,70,26,96,192,2019
2021_C12011,87,40,38,165,2021
2019_C12012,58,12,37,107,2019
2022_A12013,69,27,57,153,2022
2022_A12014,5,65,50,120,2022
2019_C12015,15,46,93,154,2019
2022_C12016,24,19,48,91,2022
2021_B12017,81,63,46,190,2021
2022_B12018,56,22,91,169,2022
2019_B12019,4,39,42,85,2019
2019_B12020,61,83,40,184,2019
2021_A12021,28,70,82,180,2021
2019_C12022,15,65,53,133,2019
2019_C12023,51,36,41,128,2019
2022_A12024,29,87,81,197,2022
2019_A12025,32,91,30,153,2019
2019_A12026,37,36,23,96,2019
2021_B12027,64,17,79,160,2021
2022_A12028,0,87,72,159,2022
2021_C12029,21,43,34,98,2021
2022_A12030,48,42,87,177,2022
2021_B12031,57,71,64,192,2021
2022_A12032,93,13,97,203,2022
2021_C12033,13,90,49,152,2021
2019_A12034,74,96,23,193,2019
2021_A12035,53,84,81,218,2021
2019_A12036,51,69,56,176,2019
2019_A12037,22,17,56,95,2019
2019_A12038,91,37,93,221,2019
2022_A12039,80,40,58,178,2022
2021_A12040,6,64,59,129,2021
2019_A12041,10,11,29,50,2019
2019_B12042,68,88,28,184,2019
2021_B12043,31,46,47,124,2021
2019_C12044,66,25,85,176,2019
2021_A12045,53,50,77,180,2021
2019_B12046,75,33,96,204,2019
2021_A12047,4,73,93,170,2021
2019_A12048,83,74,44,201,2019
2022_B12049,52,29,39,120,2022
2021_C12050,75,18,89,182,2021
2019_C12051,98,23,68,189,2019
2022_B12052,27,25,97,149,2022
2019_C12053,19,77,73,169,2019
2021_C12054,62,28,43,133,2021
2019_B12055,52,64,26,142,2019
2022_B12056,41,58,39,138,2022
2021_C12057,59,14,90,163,2021
2019_A12058,98,74,46,218,2019
2019_C12059,75,15,94,184,2019
2021_B12060,69,59,96,224,2021
2022_C12061,74,60,66,200,2022
2022_C12062,2,24,55,81,2022
2022_C12063,23,14,39,76,2022
2021_C12064,79,77,94,250,2021
2019_B12065,77,43,53,173,2019
2021_A12066,20,87,30,137,2021
2022_C12067,39,75,72,186,2022
2021_C12068,63,37,34,134,2021
2021_B12069,14,74,57,145,2021
2019_A12070,5,67,57,129,2019
2019_B12071,24,27,86,137,2019
2022_C12072,87,77,85,249,2022
2022_C12073,80,69,93,242,2022
2022_A12074,7,65,73,145,2022
2021_A12075,43,40,98,181,2021
2019_C12076,62,61,58,181,2019
2022_C12077,15,83,47,145,2022
2019_B12078,95,40,43,178,2019
2022_C12079,84,25,36,145,2022
2021_C12080,14,49,51,114,2021
2022_C12081,54,28,25,107,2022
2019_C12082,61,56,76,193,2019
2021_B12083,55,32,28,115,2021
2021_A12084,95,81,35,211,2021
2021_B12085,95,22,61,178,2021
2021_B12086,38,81,34,153,2021
2019_C12087,1,12,64,77,2019
2019_A12088,7,92,35,134,2019
2019_B12089,25,70,91,186,2019
2022_C12090,35,29,88,152,2022
2021_C12091,84,87,30,201,2021
2019_A12092,82,50,42,174,2019
2019_B12093,41,38,32,111,2019
2021_B12094,4,73,92,169,2021
2019_B12095,72,35,21,128,2019
2019_B12096,51,35,47,133,2019
2022_C12097,27,94,30,151,2022
2021_B12098,33,40,85,158,2021
2021_C12099,80,83,99,262,2021
2019_C12100,46,38,70,154,2019
2019_C12101,20,62,92,174,2019
2022_A12102,72,36,34,142,2022
2022_B12103,100,50,76,226,2022
2021_C12104,78,32,41,151,2021
2022_A12105,67,41,68,176,2022
2022_C12106,62,91,55,208,2022
2022_A12107,38,12,52,102,2022
2022_B12108,63,25,96,184,2022
2021_C12109,74,77,28,179,2021
2022_B12110,57,61,46,164,2022
2019_B12111,56,39,26,121,2019
2022_C12112,79,63,70,212,2022
2021_B12113,18,80,31,129,2021
2021_C12114,92,29,58,179,2021
2022_B12115,45,35,36,116,2022
2021_A12116,5,60,21,86,2021
2019_C12117,29,36,65,130,2019
2022_C12118,30,52,25,107,2022
2022_A12119,42,60,58,160,2022
2019_C12120,3,70,64,137,2019
2021_B12121,91,36,38,165,2021
2022_B12122,1,42,25,68,2022
2021_C12123,81,40,29,150,2021
2021_C12124,69,62,97,228,2021
2022_A12125,76,20,49,145,2022
2019_C12126,43,12,36,91,2019
2022_C12127,10,87,55,152,2022
2019_C12128,35,46,25,106,2019
2019_B12129,75,47,75,197,2019
2021_A12130,47,24,24,95,2021
2021_C12131,25,81,24,130,2021
2021_C12132,38,17,33,88,2021
2022_A12133,61,52,86,199,2022
2022_A12134,71,51,69,191,2022
2019_C12135,77,87,25,189,2019
2022_A12136,88,51,57,196,2022
2021_A12137,26,13,52,91,2021
2021_C12138,35,57,49,141,2021
2019_B12139,44,22,30,96,2019
2019_B12140,15,39,35,89,2019
2022_A12141,24,76,57,157,2022
2022_A12142,100,77,60,237,2022
2019_C12143,60,73,33,166,2019
2021_B12144,97,85,79,261,2021
2021_A12145,72,66,34,172,2021
2019_C12146,68,28,46,142,2019
2021_C12147,81,26,95,202,2021
2019_A12148,44,57,40,141,2019
2019_A12149,67,37,80,184,2019
2021_C12150,44,88,70,202,2021
2021_B12151,58,49,55,162,2021
2019_A12152,59,76,74,209,2019
2022_C12153,73,33,31,137,2022
2022_A12154,22,80,28,130,2022
2022_B12155,38,27,21,86,2022
2019_C12156,4,62,54,120,2019
2022_C12157,35,33,36,104,2022
2019_A12158,53,12,23,88,2019
2022_A12159,92,34,79,205,2022
2019_C12160,73,73,27,173,2019
2019_B12161,43,74,28,145,2019
2022_B12162,68,25,87,180,2022
2021_C12163,67,85,60,212,2021
2022_A12164,81,39,70,190,2022
2021_C12165,77,48,95,220,2021
2022_C12166,19,88,71,178,2022
2019_B12167,9,63,59,131,2019
2019_B12168,1,60,84,145,2019
2022_C12169,65,34,79,178,2022
2021_B12170,98,95,36,229,2021
2021_A12171,57,44,28,129,2021
2022_C12172,22,48,77,147,2022
2022_A12173,53,30,90,173,2022
2019_A12174,35,46,45,126,2019
2021_C12175,13,93,52,158,2021
2019_C12176,28,29,86,143,2019
2021_C12177,15,17,29,61,2021
2021_C12178,45,34,93,172,2021
2019_A12179,89,86,74,249,2019
2021_B12180,24,47,68,139,2021
2019_A12181,25,30,80,135,2019
2022_C12182,10,39,38,87,2022
2022_B12183,39,94,59,192,2022
2022_C12184,85,27,97,209,2022
2022_B12185,80,16,43,139,2022
2022_A12186,0,36,65,101,2022
2022_C12187,15,80,43,138,2022
2021_C12188,67,70,57,194,2021
2022_B12189,53,12,79,144,2022
2022_A12190,2,74,24,100,2022
2021_B12191,6,76,45,127,2021
2021_C12192,20,20,62,102,2021
2019_B12193,45,33,84,162,2019
2022_A12194,17,32,56,105,2022
2019_A12195,6,22,52,80,2019
2019_B12196,10,90,25,125,2019
2019_A12197,2,88,75,165,2019
2019_C12198,74,63,73,210,2019
2021_B12199,60,31,27,118,2021
2022_C12200,95,58,48,201,2022
2021_C12201,2,80,96,178,2021
2019_A12202,9,12,42,63,2019
2022_A12203,35,30,21,86,2022
2021_C12204,23,94,54,171,2021
2021_C12205,93,80,38,211,2021
2019_B12206,63,76,83,222,2019
2022_C12207,59,20,39,118,2022
2019_C12208,1,35,78,114,2019
2022_B12209,5,73,35,113,2022
2021_B12210,42,77,28,147,2021
2019_C12211,15,21,55,91,2019
2022_A12212,94,90,78,262,2022
2022_C12213,73,95,66,234,2022
2021_B12214,76,15,42,133,2021
2022_C12215,10,75,67,152,2022
2019_C12216,71,94,73,238,2019
2021_B12217,30,46,58,134,2021
2021_C12218,95,50,96,241,2021
2019_C12219,37,62,99,198,2019
2022_B12220,31,25,59,115,2022
2019_A12221,21,15,28,64,2019
2019_B12222,15,19,73,107,2019
2021_B12223,68,84,29,181,2021
2021_C12224,80,64,95,239,2021
2022_B12225,96,16,63,175,2022
2022_A12226,32,23,76,131,2022
2019_C12227,97,39,38,174,2019
2019_C12228,39,22,30,91,2019
2019_B12229,50,61,22,133,2019
2022_A12230,40,93,26,159,2022
2022_C12231,40,19,61,120,2022
2019_C12232,93,72,83,248,2019
2022_C12233,38,57,53,148,2022
2019_B12234,89,92,74,255,2019
2022_A12235,52,63,28,143,2022
2021_B12236,95,27,94,216,2021
2021_A12237,70,11,35,116,2021
2019_C12238,91,83,58,232,2019
2019_B12239,52,32,25,109,2019
2021_A12240,26,11,52,89,2021
2021_C12241,46,70,60,176,2021
2021_A12242,84,76,72,232,2021
2022_C12243,73,93,99,265,2022
2019_B12244,78,58,48,184,2019
2021_A12245,5,74,84,163,2021
2021_B12246,77,70,61,208,2021
2021_A12247,83,85,42,210,2021
2022_C12248,23,46,91,160,2022
2019_A12249,31,96,96,223,2019
2019_C12250,100,15,63,178,2019
2021_B12251,97,28,67,192,2021
2022_C12252,44,51,46,141,2022
2021_A12253,40,42,70,152,2021
2022_C12254,60,66,27,153,2022
2022_B12255,54,30,69,153,2022
2021_C12256,60,30,31,121,2021
2022_B12257,38,89,29,156,2022
2022_B12258,52,66,24,142,2022
2021_B12259,4,72,94,170,2021
2022_B12260,62,93,56,211,2022
2022_C12261,0,38,24,62,2022
2019_C12262,0,81,58,139,2019
2022_B12263,83,19,77,179,2022
2022_A12264,90,24,26,140,2022
2019_C12265,18,33,28,79,2019
2019_C12266,55,66,77,198,2019
2022_B12267,93,79,52,224,2022
2021_B12268,7,52,44,103,2021
2022_C12269,83,92,33,208,2022
2019_C12270,51,12,96,159,2019
2019_B12271,39,39,59,137,2019
2021_A12272,96,76,90,262,2021
2022_B12273,25,12,21,58,2022
2022_C12274,70,89,83,242,2022
2019_C12275,87,90,71,248,2019
2022_C12276,57,92,36,185,2022
2019_C12277,59,93,51,203,2019
2021_B12278,81,56,66,203,2021
2019_A12279,59,82,54,195,2019
2022_A12280,64,32,54,150,2022
2022_B12281,89,69,24,182,2022
2021_C12282,76,45,96,217,2021
2019_A12283,60,83,94,237,2019
2019_A12284,47,54,91,192,2019
2022_C12285,84,39,33,156,2022
2021_A12286,64,91,82,237,2021
2019_C12287,78,73,32,183,2019
2021_A12288,80,60,56,196,2021
2021_A12289,29,69,50,148,2021
2021_A12290,77,75,61,213,2021
2019_A12291,84,49,22,155,2019
2021_C12292,50,50,97,197,2021
2021_B12293,86,52,26,164,2021
2021_C12294,37,70,74,181,2021
2021_B12295,7,68,99,174,2021
2022_C12296,85,72,98,255,2022
2022_B12297,98,45,79,222,2022
2019_C12298,60,66,45,171,2019
2021_B12299,61,40,73,174,2021
2021_A12300,86,22,87,195,2021
2022_A12301,34,44,88,166,2022
2022_A12302,84,11,79,174,2022
2021_C12303,91,26,24,141,2021
2019_B12304,90,55,22,167,2019
2019_C12305,54,83,92,229,2019
2019_B12306,32,93,91,216,2019
2021_B12307,9,73,26,108,2021
2021_A12308,31,29,28,88,2021
2022_B12309,12,16,73,101,2022
2022_A12310,73,36,59,168,2022
2022_B12311,39,16,82,137,2022
2021_B12312,97,70,22,189,2021
2021_B12313,17,70,68,155,2021
2022_B12314,22,72,39,133,2022
2019_A12315,25,83,66,174,2019
2021_B12316,60,84,60,204,2021
2022_C12317,41,27,66,134,2022
2019_C12318,65,93,66,224,2019
2021_A12319,7,85,78,170,2021
2021_C12320,26,21,74,121,2021
2022_C12321,85,30,71,186,2022
2021_C12322,100,77,63,240,2021
2021_A12323,15,87,89,191,2021
2019_C12324,41,71,55,167,2019
2022_B12325,18,57,48,123,2022
2021_A12326,79,12,50,141,2021
2021_C12327,19,61,58,138,2021
2019_C12328,77,35,37,149,2019
2022_A12329,93,72,59,224,2022
2022_A12330,65,32,37,134,2022
2022_A12331,9,75,22,106,2022
2022_C12332,18,87,61,166,2022
2019_C12333,26,41,95,162,2019
2019_B12334,40,97,71,208,2019
2022_A12335,46,20,26,92,2022
2019_B12336,35,23,99,157,2019
2022_C12337,95,54,21,170,2022
2019_B12338,83,16,27,126,2019
2022_A12339,69,58,39,166,2022
2019_A12340,47,49,32,128,2019
2021_B12341,55,66,33,154,2021
2022_B12342,38,13,65,116,2022
2019_C12343,20,75,44,139,2019
2021_B12344,18,21,40,79,2021
2021_A12345,40,59,21,120,2021
2022_B12346,7,14,76,97,2022
2021_A12347,5,57,61,123,2021
2019_A12348,84,80,62,226,2019
2021_B12349,84,41,34,159,2021
2022_B12350,25,59,52,136,2022
2021_B12351,90,60,27,177,2021
2021_C12352,42,52,36,130,2021
2019_B12353,22,27,78,127,2019
2022_C12354,70,22,83,175,2022
2019_A12355,37,23,93,153,2019
2022_A12356,60,22,40,122,2022
2022_B12357,77,24,72,173,2022
2021_A12358,77,52,53,182,2021
2019_A12359,43,41,21,105,2019
2019_A12360,56,49,42,147,2019
2019_B12361,76,56,44,176,2019
2019_C12362,6,33,35,74,2019
2022_A12363,95,40,48,183,2022
2022_B12364,48,30,56,134,2022
2021_B12365,96,32,50,178,2021
2022_C12366,63,61,63,187,2022
2019_C12367,70,93,82,245,2019
2022_A12368,62,26,31,119,2022
2019_A12369,1,86,76,163,2019
2019_B12370,56,74,88,218,2019
2022_A12371,37,39,52,128,2022
2022_B12372,4,93,80,177,2022
2022_B12373,68,70,95,233,2022
2019_A12374,34,14,80,128,2019
2021_B12375,24,90,24,138,2021
2021_C12376,10,16,34,60,2021
2022_C12377,82,48,72,202,2022
2019_C12378,94,87,87,268,2019
2019_C12379,59,80,23,162,2019
2022_A12380,52,69,29,150,2022
2022_B12381,44,23,38,105,2022
2021_B12382,48,36,85,169,2021
2022_A12383,30,81,71,182,2022
2022_B12384,16,87,52,155,2022
2021_C12385,70,87,95,252,2021
2022_B12386,13,88,62,163,2022
2021_B12387,33,79,90,202,2021
2019_C12388,26,40,39,105,2019
2021_A12389,20,93,80,193,2021
2022_B12390,43,42,76,161,2022
2019_B12391,74,14,84,172,2019
2019_A12392,63,41,84,188,2019
2021_C12393,44,26,83,153,2021
2022_B12394,42,88,25,155,2022
2022_C12395,50,31,51,132,2022
2019_B12396,97,43,23,163,2019
2019_C12397,96,15,46,157,2019
2019_A12398,15,82,36,133,2019
2019_C12399,51,63,94,208,2019
2021_B12400,23,20,53,96,2021
2022_B12401,91,49,60,200,2022
2019_A12402,87,49,41,177,2019
2022_A12403,76,19,50,145,2022
2022_C12404,86,55,94,235,2022
2022_C12405,61,95,62,218,2022
2019_C12406,22,73,32,127,2019
2021_A12407,44,65,95,204,2021
2019_A12408,26,55,47,128,2019
2021_B12409,25,50,52,127,2021
2022_C12410,10,30,33,73,2022
2021_B12411,96,37,95,228,2021
2019_C12412,64,29,81,174,2019
2021_B12413,74,51,51,176,2021
2022_A12414,25,34,51,110,2022
2021_B12415,70,29,23,122,2021
2019_C12416,28,53,43,124,2019
2021_B12417,78,15,92,185,2021
2019_A12418,70,46,85,201,2019
2021_A12419,31,27,31,89,2021
2021_B12420,66,97,55,218,2021
2019_C12421,58,58,97,213,2019
2021_A12422,26,87,60,173,2021
2022_B12423,52,53,28,133,2022
2021_A12424,64,22,71,157,2021
2022_C12425,82,15,66,163,2022
2019_A12426,36,74,97,207,2019
2022_B12427,78,34,24,136,2022
2021_A12428,96,54,35,185,2021
2022_B12429,29,80,57,166,2022
2021_A12430,2,76,72,150,2021
2019_C12431,81,25,21,127,2019
2021_C12432,29,56,24,109,2021
2019_C12433,64,57,28,149,2019
2022_C12434,87,63,88,238,2022
2022_B12435,75,87,63,225,2022
2021_B12436,86,78,55,219,2021
2021_A12437,87,96,98,281,2021
2022_A12438,55,37,45,137,2022
2022_B12439,37,67,28,132,2022
2022_A12440,3,57,94,154,2022
2021_A12441,6,12,50,68,2021
2022_B12442,89,48,75,212,2022
2022_C12443,58,83,83,224,2022
2022_A12444,89,69,33,191,2022
2019_A12445,40,87,49,176,2019
2022_C12446,43,53,83,179,2022
2019_B12447,9,40,87,136,2019
2022_B12448,0,30,95,125,2022
2021_C12449,29,88,91,208,2021
2022_C12450,98,21,28,147,2022
2022_B12451,37,95,50,182,2022
2021_B12452,100,11,89,200,2021
2019_B12453,67,74,37,178,2019
2022_C12454,57,97,88,242,2022
2022_B12455,47,56,52,155,2022
2021_A12456,60,65,57,182,2021
2019_A12457,98,87,33,218,2019
2022_B12458,94,74,24,192,2022
2021_C12459,83,78,44,205,2021
2022_C12460,96,57,55,208,2022
2022_A12461,42,84,53,179,2022
2019_B12462,5,35,65,105,2019
2021_C12463,50,22,38,110,2021
2022_B12464,18,26,61,105,2022
2021_C12465,75,55,50,180,2021
2022_B12466,67,74,61,202,2022
2022_C12467,43,56,92,191,2022
2019_B12468,9,92,62,163,2019
2021_C12469,97,87,92,276,2021
2022_A12470,33,75,92,200,2022
2019_B12471,8,47,67,122,2019
2019_A12472,51,73,98,222,2019
2019_C12473,27,65,78,170,2019
2021_B12474,20,78,40,138,2021
2021_C12475,83,94,45,222,2021
2021_A12476,12,11,30,53,2021
2022_A12477,2,17,91,110,2022
2022_A12478,23,30,95,148,2022
2022_B12479,51,56,51,158,2022
2019_A12480,91,62,93,246,2019
2019_B12481,66,25,48,139,2019
2019_A12482,12,42,84,138,2019
2019_C12483,15,42,95,152,2019
2019_A12484,47,44,44,135,2019
2021_B12485,9,78,34,121,2021
2021_C12486,53,34,25,112,2021
2022_B12487,54,65,73,192,2022
2022_C12488,23,33,60,116,2022
2022_C12489,60,62,21,143,2022
2022_B12490,87,60,93,240,2022
2022_A12491,20,57,35,112,2022
2019_A12492,31,75,72,178,2019
2019_C12493,34,53,27,114,2019
2021_C12494,41,67,75,183,2021
2019_C12495,77,86,39,202,2019
2021_A12496,78,25,96,199,2021
2019_C12497,12,48,22,82,2019
2022_C12498,56,16,80,152,2022
2022_C12499,33,30,61,124,2022
2022_A12500,41,29,28,98,2022
2021_A12501,71,54,34,159,2021
2019_B12502,72,77,46,195,2019
2019_B12503,78,93,69,240,2019
2019_C12504,51,46,22,119,2019
2021_C12505,30,49,53,132,2021
2019_C12506,74,13,95,182,2019
2022_A12507,99,39,35,173,2022
2021_B12508,16,18,92,126,2021
2022_A12509,95,11,68,174,2022
2022_C12510,55,89,42,186,2022
2021_B12511,94,53,59,206,2021
2022_A12512,73,62,51,186,2022
2021_A12513,66,57,65,188,2021
2019_B12514,37,48,91,176,2019
2022_B12515,17,55,62,134,2022
2022_B12516,50,95,52,197,2022
2021_B12517,46,38,24,108,2021
2019_A12518,27,80,36,143,2019
2021_A12519,97,31,31,159,2021
2019_B12520,95,55,91,241,2019
2019_A12521,77,71,80,228,2019
2021_B12522,85,35,24,144,2021
2021_B12523,60,64,40,164,2021
2019_C12524,14,23,61,98,2019
2021_B12525,74,23,61,158,2021
2022_B12526,29,71,55,155,2022
2021_C12527,27,91,70,188,2021
2022_A12528,47,61,83,191,2022
2022_C12529,31,76,60,167,2022
2019_A12530,99,70,97,266,2019
2021_C12531,34,74,27,135,2021
2021_B12532,67,34,27,128,2021
2022_C12533,40,59,61,160,2022
2021_C12534,17,50,87,154,2021
2021_A12535,73,48,80,201,2021
2022_A12536,100,92,31,223,2022
2022_C12537,81,31,26,138,2022
2019_C12538,97,96,30,223,2019
2021_A12539,29,46,51,126,2021
2019_A12540,76,53,93,222,2019
2022_A12541,32,84,65,181,2022
2022_C12542,72,67,29,168,2022
2022_C12543,44,51,34,129,2022
2022_A12544,49,96,90,235,2022
2019_C12545,71,84,83,238,2019
2019_B12546,45,54,74,173,2019
2019_A12547,20,68,40,128,2019
2021_B12548,6,29,59,94,2021
2021_C12549,36,77,90,203,2021
2022_A12550,33,22,21,76,2022
2021_A12551,81,34,31,146,2021
2021_B12552,90,76,58,224,2021
2021_B12553,62,29,42,133,2021
2022_A12554,90,40,54,184,2022
2019_C12555,73,80,24,177,2019
2019_C12556,22,59,72,153,2019
2021_B12557,35,74,44,153,2021
2022_B12558,19,14,23,56,2022
2019_A12559,53,37,77,167,2019
2022_B12560,91,76,45,212,2022
2021_C12561,76,25,62,163,2021
2021_C12562,94,80,61,235,2021
2022_B12563,60,40,55,155,2022
2022_A12564,82,81,59,222,2022
2019_A12565,92,70,52,214,2019
2022_C12566,28,87,62,177,2022
2019_B12567,100,76,51,227,2019
2021_C12568,90,52,94,236,2021
2022_A12569,39,82,50,171,2022
2022_A12570,32,40,34,106,2022
2019_A12571,32,52,66,150,2019
2021_A12572,39,90,25,154,2021
2022_A12573,15,96,71,182,2022
2019_B12574,72,50,62,184,2019
2021_C12575,38,35,80,153,2021
2021_C12576,48,79,62,189,2021
2019_B12577,43,43,52,138,2019
2021_B12578,44,85,89,218,2021
2022_A12579,80,82,78,240,2022
2022_B12580,65,25,99,189,2022
2021_C12581,34,45,68,147,2021
2022_C12582,56,45,43,144,2022
2022_A12583,12,69,40,121,2022
2022_C12584,11,83,89,183,2022
2022_C12585,32,74,94,200,2022
2022_A12586,92,72,64,228,2022
2021_A12587,80,27,47,154,2021
2021_C12588,93,86,52,231,2021
2019_A12589,25,25,30,80,2019
2022_B12590,61,45,77,183,2022
2022_C12591,10,29,57,96,2022
2022_A12592,24,79,46,149,2022
2022_C12593,64,69,52,185,2022
2022_A12594,62,95,83,240,2022
2021_A12595,42,30,49,121,2021
2021_C12596,80,87,74,241,2021
2021_A12597,94,88,36,218,2021
2021_C12598,51,78,92,221,2021
2019_B12599,62,75,84,221,2019
2021_A12600,72,45,94,211,2021
2019_B12601,70,43,24,137,2019
2022_C12602,100,22,66,188,2022
2019_A12603,92,36,65,193,2019
2021_C12604,11,84,81,176,2021
2019_A12605,24,35,96,155,2019
2019_A12606,92,71,39,202,2019
2021_A12607,65,67,90,222,2021
2021_A12608,2,61,33,96,2021
2022_A12609,32,28,95,155,2022
2021_B12610,19,29,34,82,2021
2022_A12611,21,58,80,159,2022
2022_B12612,78,26,42,146,2022
2019_C12613,98,49,33,180,2019
2019_A12614,64,84,85,233,2019
2019_B12615,63,61,58,182,2019
2019_B12616,68,21,94,183,2019
2022_B12617,49,84,60,193,2022
2021_B12618,7,67,48,122,2021
2022_B12619,11,90,74,175,2022
2022_C12620,14,59,47,120,2022
2022_A12621,61,79,27,167,2022
2019_B12622,20,17,75,112,2019
2022_A12623,19,36,78,133,2022
2019_C12624,35,66,62,163,2019
2019_B12625,29,84,50,163,2019
2022_C12626,94,90,35,219,2022
2019_C12627,77,41,50,168,2019
2021_A12628,71,77,50,198,2021
2021_C12629,17,30,98,145,2021
2021_C12630,21,69,21,111,2021
2021_B12631,54,11,39,104,2021
2021_A12632,18,15,27,60,2021
2022_C12633,58,97,67,222,2022
2021_C12634,60,40,63,163,2021
2019_B12635,82,58,75,215,2019
2021_A12636,25,35,25,85,2021
2021_B12637,79,33,53,165,2021
2022_C12638,1,23,79,103,2022
2021_B12639,12,79,21,112,2021
2022_C12640,16,67,82,165,2022
2022_B12641,61,34,54,149,2022
2019_B12642,73,72,57,202,2019
2019_A12643,68,74,83,225,2019
2021_B12644,79,67,23,169,2021
2022_B12645,38,11,30,79,2022
2022_B12646,91,84,95,270,2022
2021_C12647,90,63,91,244,2021
2019_B12648,22,64,96,182,2019
2021_C12649,57,56,35,148,2021
2019_C12650,12,96,70,178,2019
2022_B12651,81,40,52,173,2022
2019_C12652,41,35,28,104,2019
2019_B12653,80,38,55,173,2019
2022_A12654,80,66,68,214,2022
2022_B12655,16,92,61,169,2022
2019_B12656,62,35,54,151,2019
2019_B12657,12,42,68,122,2019
2019_A12658,14,26,47,87,2019
2019_C12659,58,22,95,175,2019
2019_A12660,41,27,97,165,2019
2022_B12661,35,77,54,166,2022
2019_C12662,76,16,82,174,2019
2019_B12663,46,47,58,151,2019
2022_A12664,92,57,96,245,2022
2022_B12665,53,87,87,227,2022
2021_C12666,43,41,89,173,2021
2021_A12667,42,39,70,151,2021
2019_C12668,36,31,93,160,2019
2021_B12669,64,95,50,209,2021
2019_A12670,94,24,86,204,2019
2019_C12671,96,44,82,222,2019
2021_A12672,23,69,23,115,2021
2021_A12673,45,73,96,214,2021
2019_C12674,44,18,42,104,2019
2021_C12675,45,13,41,99,2021
2021_C12676,75,73,77,225,2021
2021_B12677,60,69,73,202,2021
2021_A12678,66,50,87,203,2021
2021_B12679,77,35,34,146,2021
2021_C12680,93,91,98,282,2021
2021_C12681,68,30,23,121,2021
2021_A12682,27,76,73,176,2021
2019_B12683,93,91,42,226,2019
2021_B12684,91,38,70,199,2021
2021_A12685,72,28,46,146,2021
2021_A12686,87,77,78,242,2021
2022_B12687,7,38,46,91,2022
2019_A12688,63,56,72,191,2019
2019_A12689,36,45,56,137,2019
2021_B12690,64,56,23,143,2021
2019_C12691,5,46,36,87,2019
2019_C12692,4,35,69,108,2019
2021_B12693,52,47,65,164,2021
2022_C12694,44,95,63,202,2022
2022_B12695,12,91,90,193,2022
2019_B12696,67,30,75,172,2019
2022_C12697,30,77,33,140,2022
2021_A12698,97,83,53,233,2021
2021_C12699,9,42,87,138,2021
2019_B12700,79,26,48,153,2019
2022_B12701,41,69,39,149,2022
2022_A12702,87,18,74,179,2022
2019_C12703,45,29,48,122,2019
2019_A12704,96,47,39,182,2019
2022_A12705,41,14,79,134,2022
2022_C12706,77,96,36,209,2022
2021_B12707,82,27,26,135,2021
2019_C12708,95,11,37,143,2019
2021_B12709,65,43,31,139,2021
2021_B12710,66,22,61,149,2021
2021_A12711,62,77,62,201,2021
2021_B12712,82,41,84,207,2021
2022_C12713,25,48,77,150,2022
2019_A12714,7,57,39,103,2019
2022_C12715,76,82,51,209,2022
2022_B12716,47,69,41,157,2022
2019_B12717,83,50,28,161,2019
2021_A12718,12,20,48,80,2021
2019_C12719,6,35,55,96,2019
2021_B12720,28,40,61,129,2021
2022_B12721,82,63,87,232,2022
2022_A12722,7,62,24,93,2022
2022_C12723,1,33,95,129,2022
2019_A12724,87,27,41,155,2019
2019_B12725,40,93,30,163,2019
2021_A12726,62,80,64,206,2021
2022_B12727,68,33,63,164,2022
2019_B12728,7,55,43,105,2019
2022_B12729,88,90,99,277,2022
2022_B12730,15,39,45,99,2022
2022_B12731,23,21,53,97,2022
2022_A12732,62,48,64,174,2022
2021_B12733,26,90,45,161,2021
2019_B12734,60,61,89,210,2019
2022_A12735,34,44,47,125,2022
2022_A12736,7,77,85,169,2022
2021_A12737,72,26,41,139,2021
2022_C12738,61,23,38,122,2022
2022_C12739,51,44,46,141,2022
2021_A12740,36,26,48,110,2021
2022_A12741,13,13,71,97,2022
2022_A12742,11,30,41,82,2022
2019_B12743,65,66,63,194,2019
2019_C12744,50,12,49,111,2019
2021_C12745,92,92,39,223,2021
2021_C12746,23,69,26,118,2021
2019_B12747,12,64,39,115,2019
2021_B12748,94,95,60,249,2021
2021_C12749,9,63,46,118,2021
2021_C12750,84,31,63,178,2021
2022_C12751,10,61,46,117,2022
2019_C12752,28,52,53,133,2019
2022_C12753,45,18,33,96,2022
2021_B12754,52,84,83,219,2021
2022_C12755,58,41,62,161,2022
2019_A12756,70,42,43,155,2019
2021_B12757,41,19,55,115,2021
2021_B12758,47,37,81,165,2021
2022_B12759,84,74,30,188,2022
2022_C12760,69,48,51,168,2022
2021_C12761,53,64,24,141,2021
2019_B12762,19,44,60,123,2019
2019_C12763,65,85,91,241,2019
2019_C12764,62,35,24,121,2019
2019_C12765,37,58,91,186,2019
2022_A12766,24,47,65,136,2022
2019_B12767,72,60,70,202,2019
2021_C12768,96,62,30,188,2021
2019_B12769,50,54,39,143,2019
2021_B12770,4,87,71,162,2021
2021_C12771,80,72,37,189,2021
2021_B12772,68,25,70,163,2021
2021_B12773,49,76,84,209,2021
2022_B12774,94,61,39,194,2022
2022_A12775,94,52,60,206,2022
2022_A12776,64,32,96,192,2022
2022_C12777,92,87,63,242,2022
2021_A12778,63,82,99,244,2021
2021_A12779,56,15,39,110,2021
2022_B12780,52,27,66,145,2022
2022_C12781,51,22,75,148,2022
2019_B12782,29,68,81,178,2019
2021_B12783,91,41,78,210,2021
2022_B12784,41,20,86,147,2022
2022_A12785,1,18,39,58,2022
2022_C12786,14,78,94,186,2022
2021_C12787,71,44,81,196,2021
2021_C12788,53,81,30,164,2021
2021_C12789,10,73,34,117,2021
2021_A12790,48,65,50,163,2021
2021_C12791,5,41,43,89,2021
2019_A12792,44,38,31,113,2019
2022_A12793,96,30,88,214,2022
2021_C12794,73,15,99,187,2021
2019_A12795,58,69,72,199,2019
2019_A12796,42,18,47,107,2019
2021_A12797,77,95,36,208,2021
2021_B12798,70,49,30,149,2021
2022_B12799,30,59,53,142,2022
2022_C12800,9,94,41,144,2022
2019_C12801,47,55,76,178,2019
2019_C12802,42,65,72,179,2019
2019_C12803,10,66,35,111,2019
2022_C12804,41,20,65,126,2022
2022_B12805,96,53,47,196,2022
2021_B12806,95,66,63,224,2021
2022_C12807,8,39,65,112,2022
2022_B12808,88,66,84,238,2022
2019_B12809,65,64,39,168,2019
2021_B12810,42,69,86,197,2021
2019_B12811,33,68,67,168,2019
2019_B12812,24,24,94,142,2019
2019_B12813,6,63,46,115,2019
2021_A12814,48,58,48,154,2021
2021_C12815,75,76,74,225,2021
2019_B12816,20,82,34,136,2019
2022_C12817,98,33,92,223,2022
2021_C12818,89,28,52,169,2021
2021_A12819,94,58,55,207,2021
2021_C12820,42,64,65,171,2021
2022_C12821,35,87,90,212,2022
2022_A12822,23,91,79,193,2022
2022_C12823,77,50,30,157,2022
2021_C12824,39,96,86,221,2021
2022_C12825,78,23,97,198,2022
2021_B12826,70,33,74,177,2021
2021_C12827,59,13,99,171,2021
2022_B12828,40,92,84,216,2022
2022_B12829,89,18,23,130,2022
2019_A12830,17,69,84,170,2019
2019_A12831,68,43,38,149,2019
2021_A12832,75,67,35,177,2021
2022_A12833,26,43,71,140,2022
2022_A12834,72,57,42,171,2022
2021_C12835,6,23,85,114,2021
2022_C12836,27,34,83,144,2022
2021_B12837,65,35,95,195,2021
2021_C12838,94,93,55,242,2021
2022_A12839,43,73,81,197,2022
2022_B12840,70,85,97,252,2022
2022_C12841,52,31,49,132,2022
2019_A12842,99,83,56,238,2019
2021_C12843,77,33,69,179,2021
2021_A12844,53,91,88,232,2021
2022_A12845,12,41,57,110,2022
2022_B12846,39,20,98,157,2022
2022_B12847,22,73,81,176,2022
2019_A12848,83,37,82,202,2019
2021_C12849,22,35,44,101,2021
2022_A12850,67,18,55,140,2022
2019_A12851,64,25,87,176,2019
2021_B12852,40,77,22,139,2021
2019_B12853,40,53,56,149,2019
2021_A12854,44,28,40,112,2021
2019_A12855,73,16,74,163,2019
2021_A12856,30,13,65,108,2021
2022_B12857,39,28,78,145,2022
2021_C12858,54,55,38,147,2021
2019_A12859,29,43,39,111,2019
2019_A12860,45,23,22,90,2019
2021_C12861,76,24,36,136,2021
2021_C12862,88,51,52,191,2021
2021_C12863,17,31,40,88,2021
2022_A12864,67,63,35,165,2022
2019_A12865,36,33,79,148,2019
2021_B12866,70,25,29,124,2021
2022_C12867,49,85,56,190,2022
2022_B12868,95,82,38,215,2022
2019_A12869,25,92,76,193,2019
2022_B12870,62,25,50,137,2022
2019_C12871,1,69,56,126,2019
2021_B12872,81,13,80,174,2021
2019_A12873,52,69,47,168,2019
2019_B12874,8,74,50,132,2019
2019_A12875,29,91,38,158,2019
2022_C12876,22,34,70,126,2022
2019_A12877,20,34,24,78,2019
2022_A12878,49,53,42,144,2022
2022_B12879,100,48,39,187,2022
2021_A12880,22,18,61,101,2021
2022_C12881,14,95,64,173,2022
2022_A12882,69,83,43,195,2022
2021_A12883,43,45,29,117,2021
2022_B12884,28,50,83,161,2022
2021_B12885,19,94,62,175,2021
2019_C12886,72,94,30,196,2019
2019_C12887,29,90,23,142,2019
2021_A12888,68,14,57,139,2021
2021_C12889,5,21,90,116,2021
2021_C12890,24,55,32,111,2021
2022_C12891,7,76,46,129,2022
2021_A12892,38,90,84,212,2021
2019_C12893,84,90,53,227,2019
2022_C12894,20,36,28,84,2022
2019_A12895,49,60,49,158,2019
2021_A12896,84,71,87,242,2021
2021_A12897,47,86,21,154,2021
2022_A12898,54,81,44,179,2022
2019_A12899,23,70,90,183,2019
2022_A12900,4,21,29,54,2022
2021_C12901,66,67,80,213,2021
2022_C12902,6,92,49,147,2022
2021_B12903,41,39,63,143,2021
2022_A12904,58,73,42,173,2022
2022_C12905,27,93,63,183,2022
2022_B12906,84,20,67,171,2022
2022_C12907,64,83,65,212,2022
2019_A12908,7,77,55,139,2019
2021_B12909,22,73,32,127,2021
2019_C12910,99,23,66,188,2019
2021_B12911,91,91,70,252,2021
2021_C12912,22,29,30,81,2021
2021_C12913,40,39,43,122,2021
2021_B12914,71,39,85,195,2021
2019_C12915,24,46,48,118,2019
2022_B12916,84,29,85,198,2022
2022_C12917,0,71,40,111,2022
2021_B12918,13,83,95,191,2021
2021_C12919,80,19,92,191,2021
2019_C12920,54,57,54,165,2019
2021_A12921,52,69,25,146,2021
2022_C12922,90,52,63,205,2022
2021_A12923,26,53,96,175,2021
2021_A12924,14,40,73,127,2021
2022_A12925,25,36,66,127,2022
2021_C12926,31,45,61,137,2021
2021_A12927,94,14,45,153,2021
2021_A12928,52,32,70,154,2021
2019_B12929,51,18,52,121,2019
2019_C12930,66,20,68,154,2019
2022_A12931,87,44,98,229,2022
2019_A12932,99,32,67,198,2019
2022_B12933,35,48,45,128,2022
2019_C12934,14,75,38,127,2019
2022_A12935,44,91,89,224,2022
2019_A12936,58,95,93,246,2019
2022_B12937,25,92,51,168,2022
2021_C12938,94,42,94,230,2021
2021_A12939,2,11,62,75,2021
2022_A12940,84,23,28,135,2022
2022_C12941,87,16,63,166,2022
2019_C12942,82,23,37,142,2019
2021_A12943,55,88,36,179,2021
2022_C12944,57,96,30,183,2022
2019_C12945,56,56,76,188,2019
2021_C12946,77,23,65,165,2021
2022_B12947,95,50,72,217,2022
2022_A12948,6,65,92,163,2022
2021_C12949,32,21,42,95,2021
2022_C12950,7,41,78,126,2022
2019_C12951,71,29,57,157,2019
2019_B12952,78,77,77,232,2019
2022_A12953,62,58,54,174,2022
2019_C12954,24,38,65,127,2019
2021_B12955,76,79,83,238,2021
2021_B12956,63,36,40,139,2021
2019_C12957,15,46,49,110,2019
2021_B12958,9,29,60,98,2021
2022_A12959,46,57,91,194,2022
2021_C12960,13,94,30,137,2021
2019_C12961,99,37,22,158,2019
2022_A12962,90,32,98,220,2022
2022_A12963,55,79,99,233,2022
2021_B12964,3,59,90,152,2021
2021_A12965,47,65,77,189,2021
2022_B12966,57,59,39,155,2022
2021_C12967,8,63,37,108,2021
2021_A12968,97,61,94,252,2021
2021_B12969,67,12,32,111,2021
2019_A12970,9,34,48,91,2019
2019_B12971,27,43,88,158,2019
2021_B12972,65,85,31,181,2021
2019_A12973,85,67,92,244,2019
2019_C12974,13,94,52,159,2019
2021_B12975,87,71,75,233,2021
2019_B12976,93,23,59,175,2019
2021_B12977,19,83,66,168,2021
2022_A12978,15,25,78,118,2022
2021_A12979,44,26,63,133,2021
2019_C12980,92,54,32,178,2019
2019_C12981,60,70,73,203,2019
2019_A12982,40,88,49,177,2019
2019_A12983,79,36,73,188,2019
2022_C12984,32,32,76,140,2022
2019_A12985,51,61,42,154,2019
2019_A12986,92,82,39,213,2019
2019_C12987,23,84,30,137,2019
2021_B12988,72,14,83,169,2021
2021_A12989,74,68,82,224,2021
2021_B12990,20,76,55,151,2021
2021_C12991,9,13,59,81,2021
2019_A12992,55,28,99,182,2019
2019_B12993,18,51,70,139,2019
2022_C12994,67,24,89,180,2022
2022_C12995,23,76,96,195,2022
2019_A12996,22,83,93,198,2019
2019_C12997,50,39,32,121,2019
2021_A12998,21,22,42,85,2021
2022_B12999,54,57,41,152,2022
2021_B13000,63,27,32,122,2021
2019_A13001,76,16,95,187,2019
2022_C13002,51,92,48,191,2022
2022_B13003,75,30,49,154,2022
2021_C13004,47,17,37,101,2021
2019_C13005,11,12,67,90,2019
2019_A13006,44,25,31,100,2019
2021_B13007,76,36,58,170,2021
2019_B13008,46,23,29,98,2019
2019_C13009,26,58,84,168,2019
2021_B13010,24,70,28,122,2021
2022_B13011,34,16,38,88,2022
2021_C13012,17,31,72,120,2021
2021_C13013,66,11,98,175,2021
2019_C13014,57,32,53,142,2019
2019_B13015,15,56,91,162,2019
2022_C13016,57,87,72,216,2022
2022_A13017,100,79,92,271,2022
2019_B13018,19,50,87,156,2019
2021_A13019,100,93,41,234,2021
2019_C13020,79,36,67,182,2019
2022_B13021,95,56,46,197,2022
2021_C13022,86,81,65,232,2021
2021_B13023,82,73,58,213,2021
2022_C13024,90,83,48,221,2022
2022_B13025,75,39,25,139,2022
2022_A13026,28,91,98,217,2022
2019_C13027,29,11,50,90,2019
2019_B13028,3,18,27,48,2019
2021_A13029,52,31,86,169,2021
2019_B13030,52,30,52,134,2019
2019_C13031,26,38,97,161,2019
2022_A13032,62,90,53,205,2022
2021_A13033,16,81,53,150,2021
2021_C13034,15,32,78,125,2021
2021_A13035,25,89,47,161,2021
2021_C13036,32,23,99,154,2021
2021_C13037,15,23,49,87,2021
2022_B13038,32,46,38,116,2022
2019_A13039,11,76,30,117,2019
2022_C13040,47,29,76,152,2022
2021_B13041,100,64,65,229,2021
2021_B13042,98,42,21,161,2021
2021_C13043,15,62,65,142,2021
2022_A13044,30,66,91,187,2022
2019_B13045,97,95,44,236,2019
2019_C13046,62,72,67,201,2019
2022_B13047,50,18,64,132,2022
2021_B13048,94,94,84,272,2021
2022_C13049,60,73,80,213,2022
2022_A13050,31,66,95,192,2022
2021_C13051,33,22,67,122,2021
2019_C13052,76,90,89,255,2019
2019_B13053,78,51,39,168,2019
2019_B13054,41,65,76,182,2019
2019_B13055,54,65,94,213,2019
2019_B13056,74,59,42,175,2019
2019_B13057,99,71,63,233,2019
2022_C13058,75,69,36,180,2022
2019_C13059,19,28,84,131,2019
2021_B13060,26,63,77,166,2021
2022_B13061,41,29,37,107,2022
2021_A13062,44,68,85,197,2021
2022_A13063,0,30,32,62,2022
2019_A13064,24,19,37,80,2019
2022_A13065,59,50,93,202,2022
2021_B13066,28,14,50,92,2021
2021_C13067,21,70,87,178,2021
2019_A13068,80,64,97,241,2019
2021_A13069,50,70,54,174,2021
2021_C13070,57,11,28,96,2021
2021_A13071,25,82,83,190,2021
2019_B13072,15,61,68,144,2019
2019_A13073,72,70,26,168,2019
2022_A13074,48,54,95,197,2022
2021_A13075,13,15,69,97,2021
2022_A13076,56,72,90,218,2022
2022_A13077,66,87,26,179,2022
2021_B13078,100,45,58,203,2021
2022_C13079,91,55,73,219,2022
2021_C13080,92,19,67,178,2021
2019_C13081,15,90,21,126,2019
2021_A13082,27,41,87,155,2021
2021_A13083,23,96,55,174,2021
2022_C13084,20,11,48,79,2022
2021_C13085,53,78,43,174,2021
2019_B13086,96,48,24,168,2019
2021_B13087,18,32,39,89,2021
2021_C13088,98,83,79,260,2021
2021_B13089,23,63,79,165,2021
2021_C13090,72,43,51,166,2021
2022_B13091,59,20,32,111,2022
2021_C13092,39,11,80,130,2021
2022_C13093,82,14,82,178,2022
2022_B13094,26,15,47,88,2022
2021_B13095,90,26,65,181,2021
2022_A13096,99,83,50,232,2022
2021_B13097,10,38,83,131,2021
2022_C13098,7,32,66,105,2022
2022_B13099,7,24,49,80,2022
2019_A13100,24,80,35,139,2019
2019_C13101,51,42,98,191,2019
2019_C13102,58,11,60,129,2019
2022_A13103,62,16,93,171,2022
2021_B13104,60,30,56,146,2021
2021_A13105,53,72,84,209,2021
2021_A13106,40,85,48,173,2021
2019_C13107,97,85,27,209,2019
2022_A13108,71,56,41,168,2022
2021_C13109,45,54,64,163,2021
2022_C13110,67,38,88,193,2022
2021_C13111,14,52,84,150,2021
2021_C13112,42,74,91,207,2021
2021_A13113,19,71,65,155,2021
2019_A13114,52,57,33,142,2019
2022_B13115,97,27,50,174,2022
2022_A13116,39,30,98,167,2022
2019_C13117,12,57,64,133,2019
2019_B13118,5,15,57,77,2019
2019_C13119,51,53,77,181,2019
2022_C13120,75,33,94,202,2022
2019_B13121,35,75,23,133,2019
2021_A13122,79,33,81,193,2021
2022_B13123,80,70,79,229,2022
2022_B13124,73,43,96,212,2022
2021_B13125,85,14,78,177,2021
2022_B13126,81,78,64,223,2022
2019_C13127,28,93,23,144,2019
2021_A13128,83,70,71,224,2021
2019_A13129,1,17,52,70,2019
2021_C13130,34,72,64,170,2021
2019_A13131,47,67,48,162,2019
2021_A13132,75,35,86,196,2021
2021_B13133,14,41,63,118,2021
2019_A13134,81,96,77,254,2019
2019_C13135,27,41,28,96,2019
2021_A13136,46,39,79,164,2021
2021_A13137,21,40,82,143,2021
2022_A13138,27,53,97,177,2022
2019_B13139,69,57,44,170,2019
2021_C13140,55,35,23,113,2021
2022_B13141,93,21,34,148,2022
2021_A13142,24,93,31,148,2021
2021_A13143,34,59,47,140,2021
2019_A13144,49,53,21,123,2019
2021_B13145,76,97,67,240,2021
2019_A13146,54,75,95,224,2019
2022_C13147,26,24,59,109,2022
2021_B13148,50,28,51,129,2021
2021_B13149,22,13,70,105,2021
2019_A13150,97,54,82,233,2019
2019_A13151,62,66,72,200,2019
2022_C13152,83,70,21,174,2022
2021_B13153,12,47,21,80,2021
2021_B13154,35,75,88,198,2021
2019_A13155,6,90,50,146,2019
2019_C13156,33,34,38,105,2019
2021_A13157,80,11,79,170,2021
2021_B13158,75,62,35,172,2021
2022_B13159,99,90,48,237,2022
2021_A13160,40,66,89,195,2021
2021_C13161,48,48,28,124,2021
2021_C13162,36,54,54,144,2021
2022_A13163,25,40,87,152,2022
2021_A13164,57,91,84,232,2021
2022_B13165,37,65,68,170,2022
2019_A13166,90,48,58,196,2019
2019_C13167,14,63,77,154,2019
2021_A13168,33,86,50,169,2021
2019_A13169,89,30,63,182,2019
2021_A13170,78,23,48,149,2021
2022_C13171,73,91,71,235,2022
2019_C13172,81,27,34,142,2019
2021_A13173,75,74,86,235,2021
2021_C13174,58,84,56,198,2021
2021_C13175,56,82,86,224,2021
2019_B13176,28,97,42,167,2019
2021_C13177,60,57,70,187,2021
2019_A13178,57,75,99,231,2019
2021_B13179,78,60,98,236,2021
2022_C13180,78,93,29,200,2022
2021_A13181,8,41,62,111,2021
2022_C13182,3,59,74,136,2022
2021_B13183,87,78,75,240,2021
2022_A13184,12,56,57,125,2022
2022_A13185,55,87,60,202,2022
2022_A13186,26,47,39,112,2022
2019_C13187,57,73,80,210,2019
2021_B13188,66,42,56,164,2021
2019_C13189,64,76,67,207,2019
2022_B13190,58,78,59,195,2022
2019_C13191,21,93,51,165,2019
2021_A13192,17,64,67,148,2021
2022_B13193,70,26,59,155,2022
2021_C13194,25,83,60,168,2021
2021_B13195,62,83,95,240,2021
2019_B13196,100,24,76,200,2019
2019_C13197,84,18,47,149,2019
2019_B13198,11,89,89,189,2019
2021_C13199,38,65,79,182,2021
2019_C13200,2,43,28,73,2019
2019_A13201,88,30,44,162,2019
2021_C13202,33,33,73,139,2021
2022_A13203,4,94,63,161,2022
2021_A13204,21,42,84,147,2021
2022_C13205,69,87,22,178,2022
2019_A13206,32,96,26,154,2019
2019_A13207,88,63,64,215,2019
2019_B13208,87,37,63,187,2019
2022_B13209,20,72,43,135,2022
2021_C13210,32,56,66,154,2021
2022_C13211,6,58,81,145,2022
2021_B13212,20,38,72,130,2021
2022_C13213,24,20,76,120,2022
2019_A13214,74,33,77,184,2019
2019_A13215,16,40,64,120,2019
2022_B13216,73,92,87,252,2022
2019_A13217,58,33,36,127,2019
2021_C13218,17,38,21,76,2021
2019_B13219,53,17,59,129,2019
2022_C13220,99,40,79,218,2022
2021_C13221,41,40,42,123,2021
2019_A13222,90,40,91,221,2019
2022_B13223,86,70,64,220,2022
2019_A13224,68,11,28,107,2019
2019_C13225,39,57,91,187,2019
2022_A13226,69,45,25,139,2022
2022_A13227,67,51,90,208,2022
2019_C13228,89,58,29,176,2019
2022_C13229,49,71,54,174,2022
2022_C13230,4,92,80,176,2022
2022_A13231,11,61,59,131,2022
2022_B13232,80,68,65,213,2022
2022_A13233,92,82,68,242,2022
2021_C13234,14,51,57,122,2021
2021_C13235,54,16,91,161,2021
2022_A13236,29,65,31,125,2022
2021_A13237,93,16,79,188,2021
2021_B13238,78,59,30,167,2021
2019_C13239,86,22,50,158,2019
2021_A13240,82,61,50,193,2021
2022_B13241,86,68,73,227,2022
2022_B13242,67,35,62,164,2022
2019_C13243,2,97,93,192,2019
2022_C13244,28,33,62,123,2022
2019_B13245,46,82,99,227,2019
2019_C13246,56,79,99,234,2019
2021_C13247,37,66,42,145,2021
2022_A13248,30,42,71,143,2022
2021_A13249,88,21,77,186,2021
2021_B13250,22,14,51,87,2021
2021_A13251,89,21,85,195,2021
2019_B13252,77,63,21,161,2019
2019_B13253,17,12,32,61,2019
2022_B13254,46,58,22,126,2022
2019_C13255,26,74,94,194,2019
2021_A13256,52,96,82,230,2021
2019_C13257,59,33,86,178,2019
2022_C13258,22,40,57,119,2022
2019_B13259,10,58,88,156,2019
2019_B13260,57,22,81,160,2019
2021_C13261,6,77,41,124,2021
2019_A13262,13,48,79,140,2019
2022_B13263,23,52,96,171,2022
2021_C13264,22,45,46,113,2021
2019_C13265,34,14,81,129,2019
2019_C13266,35,24,91,150,2019
2022_A13267,14,91,92,197,2022
2019_C13268,76,63,73,212,2019
2022_A13269,64,58,64,186,2022
2021_A13270,89,81,70,240,2021
2021_C13271,78,41,29,148,2021
2022_C13272,85,94,61,240,2022
2022_C13273,35,97,96,228,2022
2022_C13274,82,40,95,217,2022
2019_A13275,50,92,99,241,2019
2019_C13276,34,19,73,126,2019
2019_C13277,39,80,46,165,2019
2021_C13278,71,32,68,171,2021
2019_A13279,5,34,39,78,2019
2019_A13280,45,19,29,93,2019
2019_B13281,89,17,27,133,2019
2022_C13282,50,43,21,114,2022
2021_A13283,11,83,42,136,2021
2019_C13284,75,40,52,167,2019
2019_A13285,35,87,97,219,2019
2021_A13286,38,61,82,181,2021
2021_B13287,72,89,54,215,2021
2021_B13288,90,11,65,166,2021
2022_B13289,70,27,91,188,2022
2019_C13290,43,58,81,182,2019
2019_B13291,43,30,25,98,2019
2019_A13292,52,81,75,208,2019
2021_A13293,41,16,71,128,2021
2022_A13294,13,58,66,137,2022
2019_A13295,53,79,88,220,2019
2022_A13296,19,83,88,190,2022
2022_B13297,84,97,45,226,2022
2019_A13298,69,14,84,167,2019
2019_B13299,84,60,51,195,2019
2021_C13300,72,81,21,174,2021
2019_B13301,59,23,29,111,2019
2022_B13302,52,69,68,189,2022
2019_A13303,26,89,82,197,2019
2022_B13304,30,80,37,147,2022
2019_C13305,69,76,85,230,2019
2019_A13306,49,76,22,147,2019
2019_C13307,35,46,46,127,2019
2019_C13308,60,38,59,157,2019
2022_A13309,98,53,67,218,2022
2019_C13310,58,42,49,149,2019
2022_B13311,56,74,63,193,2022
2022_C13312,14,51,90,155,2022
2021_C13313,47,90,49,186,2021
2022_C13314,77,91,44,212,2022
2019_A13315,55,58,64,177,2019
2022_C13316,94,93,22,209,2022
2022_C13317,63,84,23,170,2022
2021_B13318,3,53,86,142,2021
2022_B13319,64,24,28,116,2022
2019_C13320,18,84,32,134,2019
2021_C13321,73,38,91,202,2021
2021_C13322,43,58,51,152,2021
2021_A13323,46,82,41,169,2021
2019_B13324,82,81,71,234,2019
2021_C13325,80,30,68,178,2021
2019_A13326,31,48,46,125,2019
2022_B13327,5,74,33,112,2022
2022_C13328,57,93,79,229,2022
2022_A13329,78,67,45,190,2022
2022_A13330,27,80,99,206,2022
2019_A13331,15,33,40,88,2019
2019_B13332,6,79,58,143,2019
2022_A13333,27,97,23,147,2022
2019_C13334,86,38,49,173,2019
2021_A13335,56,78,47,181,2021
2019_A13336,45,42,89,176,2019
2019_B13337,51,18,90,159,2019
2021_B13338,57,62,62,181,2021
2019_A13339,14,40,74,128,2019
2022_C13340,16,45,45,106,2022
2019_B13341,15,79,83,177,2019
2022_C13342,20,18,48,86,2022
2021_A13343,22,95,36,153,2021
2021_A13344,65,86,68,219,2021
2019_B13345,83,28,67,178,2019
2021_B13346,63,14,86,163,2021
2019_A13347,71,62,76,209,2019
2019_A13348,9,62,29,100,2019
2022_A13349,18,69,39,126,2022
2019_B13350,96,49,63,208,2019
2022_A13351,82,16,50,148,2022
2021_C13352,33,37,60,130,2021
2022_A13353,66,47,81,194,2022
2021_C13354,85,76,81,242,2021
2021_B13355,19,45,41,105,2021
2019_C13356,50,23,40,113,2019
2019_C13357,96,52,50,198,2019
2019_A13358,36,32,67,135,2019
2019_B13359,43,76,52,171,2019
2021_A13360,13,76,53,142,2021
2022_C13361,17,46,40,103,2022
2019_C13362,28,95,44,167,2019
2021_B13363,89,43,94,226,2021
2021_B13364,38,24,87,149,2021
2019_A13365,85,80,27,192,2019
2021_C13366,75,87,24,186,2021
2021_A13367,97,60,23,180,2021
2022_C13368,3,13,45,61,2022
2022_B13369,60,42,74,176,2022
2019_C13370,84,26,22,132,2019
2021_C13371,26,53,54,133,2021
2022_C13372,95,12,81,188,2022
2022_C13373,17,27,70,114,2022
2019_C13374,64,43,98,205,2019
2019_C13375,97,60,54,211,2019
2022_B13376,93,71,44,208,2022
2022_B13377,35,97,98,230,2022
2022_B13378,22,60,98,180,2022
2019_A13379,70,95,58,223,2019
2022_C13380,74,87,73,234,2022
2019_A13381,70,46,47,163,2019
2019_C13382,54,87,90,231,2019
2019_B13383,80,85,79,244,2019
2022_A13384,85,17,75,177,2022
2019_A13385,30,62,60,152,2019
2021_B13386,45,48,22,115,2021
2019_A13387,60,17,88,165,2019
2022_A13388,72,16,87,175,2022
2019_B13389,30,84,45,159,2019
2019_B13390,86,71,56,213,2019
2019_A13391,74,20,93,187,2019
2022_A13392,40,44,42,126,2022
2019_B13393,24,92,36,152,2019
2022_B13394,29,88,81,198,2022
2019_B13395,0,22,53,75,2019
2022_A13396,90,78,23,191,2022
2019_B13397,46,52,36,134,2019
2019_A13398,77,63,58,198,2019
2019_B13399,45,20,40,105,2019
2019_A13400,36,40,66,142,2019
2022_B13401,34,68,81,183,2022
2019_A13402,9,18,91,118,2019
2021_B13403,9,52,22,83,2021
2021_C13404,7,15,79,101,2021
2022_B13405,60,52,99,211,2022
2019_B13406,22,23,27,72,2019
2021_B13407,45,88,41,174,2021
2021_B13408,37,18,93,148,2021
2021_A13409,5,42,84,131,2021
2019_C13410,86,62,81,229,2019
2021_B13411,72,91,85,248,2021
2022_C13412,77,95,65,237,2022
2022_C13413,69,97,93,259,2022
2021_A13414,22,36,81,139,2021
2019_A13415,33,35,97,165,2019
2019_C13416,44,55,27,126,2019
2021_A13417,38,56,82,176,2021
2022_B13418,32,75,53,160,2022
2022_A13419,72,88,81,241,2022
2022_A13420,10,72,75,157,2022
2021_A13421,90,77,42,209,2021
2019_B13422,12,16,79,107,2019
2019_A13423,82,95,79,256,2019
2022_A13424,69,41,64,174,2022
2019_B13425,46,37,27,110,2019
2022_B13426,4,32,80,116,2022
2021_A13427,23,29,98,150,2021
2021_B13428,10,72,86,168,2021
2022_B13429,48,76,26,150,2022
2019_A13430,54,91,86,231,2019
2019_C13431,60,95,28,183,2019
2019_B13432,9,38,42,89,2019
2022_B13433,40,24,25,89,2022
2019_B13434,77,86,91,254,2019
2022_A13435,15,27,94,136,2022
2021_C13436,42,80,30,152,2021
2021_B13437,35,21,73,129,2021
2021_B13438,18,29,40,87,2021
2021_A13439,80,17,81,178,2021
2022_A13440,23,56,21,100,2022
2022_B13441,74,51,47,172,2022
2019_A13442,30,44,92,166,2019
2022_A13443,38,63,98,199,2022
2022_C13444,62,45,46,153,2022
2019_C13445,90,31,72,193,2019
2019_C13446,91,85,29,205,2019
2021_B13447,43,76,88,207,2021
2019_A13448,53,97,54,204,2019
2019_C13449,94,73,21,188,2019
2019_B13450,39,62,39,140,2019
2021_A13451,46,66,96,208,2021
2022_A13452,96,39,33,168,2022
2019_A13453,10,96,99,205,2019
2019_C13454,97,58,67,222,2019
2022_C13455,43,16,43,102,2022
2019_B13456,78,15,95,188,2019
2021_B13457,30,22,38,90,2021
2019_A13458,30,16,68,114,2019
2019_B13459,19,52,26,97,2019
2019_A13460,27,39,90,156,2019
2021_A13461,42,56,25,123,2021
2019_B13462,97,26,74,197,2019
2019_B13463,19,41,75,135,2019
2022_C13464,48,69,76,193,2022
2021_C13465,66,71,50,187,2021
2021_B13466,37,61,85,183,2021
2021_A13467,66,40,71,177,2021
2022_B13468,75,66,71,212,2022
2019_C13469,87,94,74,255,2019
2022_C13470,78,90,43,211,2022
2022_C13471,72,75,38,185,2022
2022_B13472,57,47,83,187,2022
2022_C13473,97,66,70,233,2022
2021_B13474,93,66,34,193,2021
2019_B13475,77,67,75,219,2019
2019_A13476,76,20,46,142,2019
2019_B13477,28,14,97,139,2019
2021_C13478,76,94,27,197,2021
2021_A13479,97,34,87,218,2021
2022_B13480,36,20,84,140,2022
2022_B13481,81,89,47,217,2022
2021_C13482,83,32,33,148,2021
2022_B13483,90,48,47,185,2022
2022_B13484,60,84,88,232,2022
2021_B13485,75,77,27,179,2021
2022_C13486,18,55,32,105,2022
2022_B13487,81,89,52,222,2022
2019_C13488,44,91,97,232,2019
2021_A13489,9,21,49,79,2021
2019_A13490,79,70,30,179,2019
2019_A13491,36,32,66,134,2019
2019_C13492,32,66,85,183,2019
2021_A13493,34,59,26,119,2021
2022_A13494,66,61,65,192,2022
2019_A13495,73,65,23,161,2019
2021_A13496,55,74,37,166,2021
2022_C13497,76,19,27,122,2022
2022_B13498,55,87,60,202,2022
2021_B13499,62,70,29,161,2021
2021_C13500,35,71,25,131,2021
2021_B13501,100,19,26,145,2021
2021_B13502,47,97,32,176,2021
2019_B13503,26,80,43,149,2019
2022_C13504,29,83,28,140,2022
2022_B13505,41,89,67,197,2022
2021_A13506,64,11,68,143,2021
2022_B13507,1,50,82,133,2022
2019_B13508,36,26,27,89,2019
2019_C13509,12,49,23,84,2019
2019_A13510,17,73,83,173,2019
2022_B13511,67,47,75,189,2022
2022_C13512,19,66,61,146,2022
2022_C13513,17,30,47,94,2022
2019_C13514,21,38,50,109,2019
2021_B13515,35,68,46,149,2021
2022_B13516,10,76,58,144,2022
2019_C13517,73,42,31,146,2019
2021_A13518,38,72,40,150,2021
2022_C13519,78,21,55,154,2022
2022_B13520,71,55,96,222,2022
2019_C13521,21,15,33,69,2019
2022_A13522,91,48,79,218,2022
2022_B13523,39,76,87,202,2022
2019_A13524,0,35,81,116,2019
2019_B13525,42,68,32,142,2019
2022_C13526,6,17,55,78,2022
2021_C13527,75,32,86,193,2021
2019_B13528,55,78,47,180,2019
2022_B13529,87,95,56,238,2022
2021_B13530,99,28,83,210,2021
2022_C13531,97,83,83,263,2022
2022_C13532,15,50,69,134,2022
2019_A13533,6,15,56,77,2019
2021_A13534,50,86,24,160,2021
2022_C13535,30,19,77,126,2022
2019_B13536,28,48,44,120,2019
2021_C13537,40,31,82,153,2021
2019_A13538,27,72,45,144,2019
2019_A13539,64,50,38,152,2019
2019_B13540,67,31,78,176,2019
2022_A13541,77,59,22,158,2022
2021_B13542,55,66,46,167,2021
2019_C13543,38,91,73,202,2019
2021_C13544,28,37,40,105,2021
2021_C13545,2,31,84,117,2021
2022_A13546,80,14,30,124,2022
2021_A13547,33,27,21,81,2021
2022_B13548,17,72,53,142,2022
2021_B13549,43,34,86,163,2021
2022_C13550,15,51,46,112,2022
2019_B13551,70,66,65,201,2019
2022_B13552,59,78,63,200,2022
2022_B13553,3,71,25,99,2022
2022_A13554,53,36,55,144,2022
2019_A13555,38,35,70,143,2019
2021_C13556,35,30,82,147,2021
2021_B13557,41,20,58,119,2021
2019_B13558,70,41,65,176,2019
2021_A13559,81,78,68,227,2021
2019_A13560,83,64,64,211,2019
2021_B13561,24,42,38,104,2021
2022_B13562,66,56,68,190,2022
2021_B13563,86,96,91,273,2021
2019_B13564,90,74,61,225,2019
2019_A13565,4,77,27,108,2019
2021_A13566,74,83,50,207,2021
2022_B13567,83,57,75,215,2022
2022_A13568,3,27,40,70,2022
2021_A13569,15,58,39,112,2021
2022_A13570,89,14,74,177,2022
2021_C13571,33,15,21,69,2021
2021_B13572,3,19,89,111,2021
2021_B13573,100,53,24,177,2021
2019_A13574,43,29,89,161,2019
2019_A13575,60,90,90,240,2019
2021_A13576,24,83,30,137,2021
2022_B13577,64,45,76,185,2022
2022_B13578,72,24,38,134,2022
2022_A13579,67,87,21,175,2022
2019_C13580,96,52,64,212,2019
2022_A13581,51,92,36,179,2022
2019_C13582,0,41,96,137,2019
2019_C13583,35,84,62,181,2019
2021_C13584,11,45,71,127,2021
2022_A13585,27,11,98,136,2022
2019_A13586,45,73,82,200,2019
2022_B13587,60,74,49,183,2022
2022_B13588,76,25,63,164,2022
2022_B13589,65,72,47,184,2022
2022_B13590,49,17,68,134,2022
2022_C13591,36,61,32,129,2022
2019_C13592,70,55,21,146,2019
2021_C13593,8,24,25,57,2021
2019_B13594,38,90,87,215,2019
2022_B13595,68,12,39,119,2022
2021_A13596,4,54,49,107,2021
2021_B13597,96,13,22,131,2021
2022_C13598,76,24,27,127,2022
2022_A13599,12,69,40,121,2022
2022_C13600,71,69,59,199,2022
2019_B13601,28,71,72,171,2019
2019_B13602,65,44,27,136,2019
2022_B13603,85,53,67,205,2022
2022_B13604,2,90,79,171,2022
2021_A13605,17,57,27,101,2021
2022_B13606,81,40,53,174,2022
2019_B13607,58,77,88,223,2019
2022_C13608,38,76,41,155,2022
2019_A13609,87,79,65,231,2019
2022_B13610,60,77,33,170,2022
2021_C13611,52,97,59,208,2021
2019_B13612,88,39,48,175,2019
2019_B13613,89,86,45,220,2019
2021_A13614,37,22,44,103,2021
2022_A13615,7,92,93,192,2022
2022_B13616,2,96,87,185,2022
2021_B13617,80,18,29,127,2021
2019_C13618,37,11,59,107,2019
2022_A13619,32,18,81,131,2022
2021_C13620,89,33,26,148,2021
2019_C13621,79,24,69,172,2019
2022_B13622,30,57,77,164,2022
2019_B13623,42,56,76,174,2019
2019_A13624,42,45,48,135,2019
2019_C13625,25,64,30,119,2019
2022_C13626,6,22,83,111,2022
2022_C13627,14,49,24,87,2022
2022_B13628,72,71,84,227,2022
2019_A13629,99,66,93,258,2019
2019_A13630,23,34,39,96,2019
2022_B13631,6,16,71,93,2022
2021_C13632,39,12,76,127,2021
2021_B13633,57,25,50,132,2021
2019_A13634,66,20,77,163,2019
2021_B13635,17,26,83,126,2021
2021_A13636,91,32,98,221,2021
2021_A13637,96,36,96,228,2021
2021_B13638,60,85,54,199,2021
2019_A13639,87,50,77,214,2019
2019_B13640,1,91,55,147,2019
2019_B13641,50,83,90,223,2019
2019_A13642,25,21,99,145,2019
2019_A13643,10,43,36,89,2019
2022_C13644,45,25,61,131,2022
2019_B13645,99,22,46,167,2019
2021_B13646,97,26,65,188,2021
2019_C13647,98,80,90,268,2019
2019_A13648,6,67,62,135,2019
2019_A13649,85,37,46,168,2019
2019_A13650,84,73,69,226,2019
2022_B13651,31,84,59,174,2022
2021_C13652,48,38,75,161,2021
2021_A13653,96,65,53,214,2021
2019_C13654,27,30,26,83,2019
2022_C13655,93,56,47,196,2022
2019_C13656,11,43,37,91,2019
2022_B13657,65,30,94,189,2022
2019_B13658,31,19,37,87,2019
2021_A13659,64,61,59,184,2021
2019_B13660,100,31,76,207,2019
2021_C13661,80,35,68,183,2021
2019_C13662,56,96,58,210,2019
2021_C13663,40,62,32,134,2021
2021_B13664,29,37,95,161,2021
2019_B13665,25,49,89,163,2019
2019_C13666,75,56,21,152,2019
2022_A13667,40,83,50,173,2022
2022_B13668,23,60,30,113,2022
2021_C13669,29,68,80,177,2021
2019_C13670,43,41,26,110,2019
2021_A13671,21,64,94,179,2021
2021_A13672,91,33,24,148,2021
2022_C13673,93,44,57,194,2022
2022_C13674,71,61,68,200,2022
2021_A13675,96,17,68,181,2021
2022_A13676,47,84,65,196,2022
2021_C13677,89,78,72,239,2021
2021_C13678,30,66,52,148,2021
2022_A13679,88,36,89,213,2022
2022_C13680,58,82,76,216,2022
2022_B13681,91,63,23,177,2022
2022_A13682,18,14,88,120,2022
2021_C13683,74,25,82,181,2021
2019_B13684,20,96,45,161,2019
2022_A13685,85,61,22,168,2022
2019_A13686,63,14,39,116,2019
2019_B13687,74,16,54,144,2019
2022_C13688,52,50,92,194,2022
2021_B13689,38,34,41,113,2021
2021_A13690,52,94,40,186,2021
2022_B13691,100,56,72,228,2022
2019_A13692,88,53,63,204,2019
2021_A13693,30,36,64,130,2021
2021_A13694,15,48,42,105,2021
2019_C13695,1,81,90,172,2019
2022_A13696,85,46,66,197,2022
2022_A13697,85,14,67,166,2022
2021_B13698,41,30,77,148,2021
2022_C13699,12,57,29,98,2022
2021_A13700,49,16,37,102,2021
2019_A13701,39,22,64,125,2019
2022_B13702,28,50,76,154,2022
2019_C13703,27,60,31,118,2019
2022_B13704,6,95,97,198,2022
2021_C13705,34,70,61,165,2021
2019_B13706,76,26,54,156,2019
2022_B13707,80,36,96,212,2022
2019_A13708,83,27,95,205,2019
2019_B13709,19,11,75,105,2019
2021_A13710,90,32,76,198,2021
2019_C13711,61,52,61,174,2019
2022_C13712,93,53,82,228,2022
2022_B13713,84,29,74,187,2022
2019_C13714,38,69,84,191,2019
2022_C13715,5,53,82,140,2022
2022_C13716,28,32,48,108,2022
2019_B13717,27,67,94,188,2019
2022_A13718,85,65,22,172,2022
2019_A13719,74,18,47,139,2019
2022_B13720,51,87,92,230,2022
2019_B13721,49,12,84,145,2019
2019_C13722,5,81,76,162,2019
2021_A13723,99,62,29,190,2021
2022_A13724,58,46,58,162,2022
2022_B13725,72,13,31,116,2022
2022_A13726,76,34,63,173,2022
2022_C13727,35,89,40,164,2022
2021_B13728,84,63,36,183,2021
2021_A13729,22,17,90,129,2021
2019_A13730,54,27,82,163,2019
2022_B13731,42,15,85,142,2022
2019_A13732,74,56,72,202,2019
2022_B13733,32,92,95,219,2022
2022_C13734,11,59,74,144,2022
2019_A13735,87,77,44,208,2019
2022_C13736,34,60,94,188,2022
2022_A13737,11,21,23,55,2022
2019_A13738,94,41,23,158,2019
2019_C13739,53,89,63,205,2019
2019_B13740,37,55,47,139,2019
2019_B13741,87,43,52,182,2019
2022_B13742,52,81,32,165,2022
2019_A13743,42,65,63,170,2019
2021_C13744,12,95,40,147,2021
2022_A13745,23,32,81,136,2022
2019_B13746,80,20,80,180,2019
2019_A13747,88,84,48,220,2019
2019_B13748,47,85,42,174,2019
2022_A13749,78,20,80,178,2022
2021_C13750,83,19,53,155,2021
2022_C13751,14,71,41,126,2022
2019_B13752,89,30,74,193,2019
2021_B13753,5,31,32,68,2021
2022_C13754,43,80,86,209,2022
2019_A13755,57,69,41,167,2019
2019_C13756,5,31,92,128,2019
2021_A13757,44,21,32,97,2021
2021_A13758,12,41,72,125,2021
2021_C13759,20,25,49,94,2021
2021_A13760,39,34,24,97,2021
2022_B13761,48,35,44,127,2022
2021_C13762,50,75,67,192,2021
2021_A13763,54,81,96,231,2021
2021_B13764,12,60,70,142,2021
2022_B13765,77,63,54,194,2022
2019_A13766,52,62,91,205,2019
2021_B13767,87,60,98,245,2021
2022_A13768,27,12,75,114,2022
2021_B13769,42,57,47,146,2021
2019_C13770,15,37,72,124,2019
2019_B13771,93,39,33,165,2019
2021_C13772,23,61,47,131,2021
2021_C13773,17,77,94,188,2021
2019_A13774,9,56,77,142,2019
2021_A13775,99,84,63,246,2021
2021_A13776,2,30,80,112,2021
2021_A13777,83,11,87,181,2021
2022_B13778,94,57,25,176,2022
2019_A13779,99,87,93,279,2019
2019_B13780,97,25,55,177,2019
2022_A13781,67,20,84,171,2022
2021_C13782,7,77,73,157,2021
2022_C13783,28,77,83,188,2022
2019_C13784,37,22,85,144,2019
2022_C13785,29,75,73,177,2022
2021_B13786,56,21,22,99,2021
2019_C13787,52,48,40,140,2019
2021_B13788,70,91,54,215,2021
2021_A13789,55,97,58,210,2021
2021_C13790,94,97,38,229,2021
2021_B13791,36,20,53,109,2021
2022_C13792,10,30,63,103,2022
2022_A13793,61,75,58,194,2022
2019_B13794,89,78,67,234,2019
2022_C13795,32,24,67,123,2022
2019_A13796,42,20,84,146,2019
2019_A13797,6,50,60,116,2019
2022_B13798,1,95,42,138,2022
2021_A13799,56,92,99,247,2021
2022_C13800,74,96,47,217,2022
2022_B13801,91,55,21,167,2022
2021_C13802,10,44,37,91,2021
2021_C13803,30,37,64,131,2021
2021_C13804,90,33,80,203,2021
2022_B13805,39,16,80,135,2022
2021_B13806,6,94,29,129,2021
2019_A13807,6,16,64,86,2019
2022_A13808,5,58,48,111,2022
2019_A13809,27,55,65,147,2019
2021_C13810,29,87,85,201,2021
2019_A13811,63,11,76,150,2019
2022_A13812,81,31,25,137,2022
2022_B13813,77,39,84,200,2022
2021_B13814,74,89,49,212,2021
2019_B13815,55,93,56,204,2019
2021_B13816,66,88,98,252,2021
2022_B13817,7,91,50,148,2022
2021_B13818,44,62,74,180,2021
2021_B13819,13,45,99,157,2021
2022_C13820,55,86,50,191,2022
2022_A13821,58,71,87,216,2022
2021_B13822,50,54,47,151,2021
2021_B13823,40,61,60,161,2021
2019_A13824,77,25,37,139,2019
2021_C13825,38,82,41,161,2021
2021_B13826,16,82,46,144,2021
2021_C13827,75,51,69,195,2021
2022_C13828,49,84,90,223,2022
2019_C13829,72,52,44,168,2019
2021_B13830,41,42,41,124,2021
2021_A13831,86,48,88,222,2021
2021_A13832,77,17,85,179,2021
2019_B13833,11,81,62,154,2019
2022_A13834,83,93,33,209,2022
2021_A13835,1,50,35,86,2021
2019_B13836,92,41,85,218,2019
2019_C13837,77,96,85,258,2019
2021_A13838,47,21,68,136,2021
2021_B13839,50,73,89,212,2021
2021_A13840,96,25,57,178,2021
2021_A13841,32,95,99,226,2021
2019_A13842,14,29,25,68,2019
2021_B13843,28,47,78,153,2021
2022_A13844,88,89,41,218,2022
2022_B13845,15,52,56,123,2022
2019_A13846,9,22,57,88,2019
2022_A13847,41,15,51,107,2022
2019_B13848,82,73,78,233,2019
2021_C13849,67,73,89,229,2021
2019_B13850,91,11,57,159,2019
2019_C13851,31,49,59,139,2019
2021_B13852,26,51,99,176,2021
2019_C13853,91,35,22,148,2019
2022_A13854,13,87,53,153,2022
2019_C13855,43,76,70,189,2019
2019_A13856,80,11,64,155,2019
2021_A13857,32,53,94,179,2021
2022_B13858,55,45,24,124,2022
2019_B13859,95,56,72,223,2019
2022_A13860,84,40,48,172,2022
2022_B13861,97,85,35,217,2022
2021_C13862,74,89,35,198,2021
2022_A13863,42,52,90,184,2022
2022_B13864,78,77,89,244,2022
2022_A13865,49,12,59,120,2022
2022_A13866,36,35,35,106,2022
2022_B13867,27,49,70,146,2022
2022_C13868,11,51,91,153,2022
2021_C13869,5,56,99,160,2021
2019_C13870,54,54,67,175,2019
2019_A13871,72,44,97,213,2019
2019_C13872,55,32,84,171,2019
2019_B13873,48,75,33,156,2019
2019_A13874,92,89,71,252,2019
2021_A13875,65,74,56,195,2021
2021_A13876,40,54,58,152,2021
2021_A13877,20,91,78,189,2021
2022_B13878,74,24,99,197,2022
2021_B13879,46,24,34,104,2021
2022_A13880,9,26,85,120,2022
2019_B13881,43,81,69,193,2019
2019_C13882,69,22,84,175,2019
2021_B13883,44,73,51,168,2021
2019_B13884,81,95,26,202,2019
2022_B13885,75,94,54,223,2022
2019_A13886,98,52,59,209,2019
2022_A13887,86,30,57,173,2022
2021_C13888,58,96,43,197,2021
2021_C13889,73,81,91,245,2021
2019_A13890,72,26,64,162,2019
2022_A13891,42,83,81,206,2022
2019_C13892,63,51,64,178,2019
2019_B13893,69,70,66,205,2019
2021_C13894,59,90,50,199,2021
2021_B13895,78,85,96,259,2021
2019_A13896,23,20,96,139,2019
2021_B13897,49,92,37,178,2021
2021_C13898,92,17,92,201,2021
2019_C13899,54,89,94,237,2019
2021_B13900,4,25,70,99,2021
2022_B13901,84,57,53,194,2022
2019_B13902,15,81,64,160,2019
2019_C13903,53,25,40,118,2019
2021_B13904,36,44,41,121,2021
2019_B13905,56,85,49,190,2019
2021_A13906,6,41,23,70,2021
2019_A13907,1,76,58,135,2019
2022_A13908,6,41,23,70,2022
2022_B13909,37,21,51,109,2022
2019_C13910,72,26,43,141,2019
2021_C13911,9,41,34,84,2021
2019_B13912,92,49,27,168,2019
2021_B13913,24,20,95,139,2021
2021_A13914,62,37,74,173,2021
2019_C13915,35,83,62,180,2019
2022_C13916,68,54,70,192,2022
2019_A13917,39,70,64,173,2019
2019_C13918,41,83,34,158,2019
2022_A13919,25,96,55,176,2022
2021_A13920,95,46,47,188,2021
2021_B13921,31,81,24,136,2021
2021_C13922,97,84,51,232,2021
2022_B13923,84,69,90,243,2022
2021_C13924,60,81,72,213,2021
2019_B13925,10,21,62,93,2019
2022_A13926,74,82,97,253,2022
2022_C13927,89,64,39,192,2022
2021_A13928,73,65,66,204,2021
2019_A13929,48,75,54,177,2019
2021_C13930,18,19,55,92,2021
2021_A13931,31,18,61,110,2021
2022_B13932,26,91,54,171,2022
2019_A13933,73,45,46,164,2019
2019_B13934,32,63,41,136,2019
2019_A13935,73,21,62,156,2019
2022_A13936,91,48,79,218,2022
2021_B13937,75,86,72,233,2021
2019_B13938,87,66,84,237,2019
2019_A13939,78,53,74,205,2019
2021_B13940,42,11,84,137,2021
2021_C13941,38,36,23,97,2021
2019_A13942,91,22,62,175,2019
2021_A13943,36,78,88,202,2021
2019_A13944,92,44,61,197,2019
2022_A13945,46,18,52,116,2022
2019_B13946,59,18,79,156,2019
2019_B13947,8,57,71,136,2019
2022_A13948,31,53,87,171,2022
2019_C13949,71,95,93,259,2019
2019_B13950,22,13,95,130,2019
2019_A13951,46,62,32,140,2019
2021_B13952,87,35,23,145,2021
2019_A13953,37,68,82,187,2019
2019_B13954,13,53,61,127,2019
2022_A13955,51,15,22,88,2022
2019_C13956,10,64,71,145,2019
2022_A13957,78,67,78,223,2022
2019_C13958,90,90,73,253,2019
2019_B13959,51,77,59,187,2019
2022_C13960,68,90,57,215,2022
2021_B13961,18,69,70,157,2021
2019_B13962,65,73,99,237,2019
2019_C13963,6,82,83,171,2019
2022_C13964,7,97,68,172,2022
2019_A13965,30,25,23,78,2019
2022_C13966,53,64,47,164,2022
2022_B13967,7,22,26,55,2022
2019_B13968,46,42,60,148,2019
2019_B13969,91,35,71,197,2019
2022_B13970,38,15,23,76,2022
2021_A13971,79,84,38,201,2021
2019_B13972,91,39,92,222,2019
2022_B13973,36,46,40,122,2022
2022_B13974,19,95,47,161,2022
2022_C13975,64,65,23,152,2022
2019_B13976,93,83,37,213,2019
2019_B13977,59,19,56,134,2019
2019_A13978,71,83,29,183,2019
2019_B13979,22,58,60,140,2019
2019_B13980,60,30,49,139,2019
2022_A13981,29,62,68,159,2022
2021_B13982,84,31,88,203,2021
2019_A13983,56,21,45,122,2019
2022_C13984,2,22,94,118,2022
2022_C13985,31,37,46,114,2022
2019_B13986,67,52,73,192,2019
2022_A13987,16,23,43,82,2022
2022_B13988,75,83,95,253,2022
2022_A13989,97,71,74,242,2022
2022_C13990,100,37,67,204,2022
2019_B13991,91,63,88,242,2019
2019_C13992,20,38,88,146,2019
2021_C13993,14,65,32,111,2021
2021_A13994,74,65,79,218,2021
2021_C13995,34,83,46,163,2021
2019_B13996,3,84,75,162,2019
2021_B13997,49,56,78,183,2021
2022_C13998,51,70,73,194,2022
2019_B13999,60,57,26,143,2019
2019_A14000,46,94,33,173,2019
2019_A14001,92,59,90,241,2019
2019_B14002,25,17,47,89,2019
2021_A14003,94,53,35,182,2021
2019_B14004,79,19,51,149,2019
2019_C14005,42,85,27,154,2019
2019_A14006,95,31,81,207,2019
2019_B14007,79,58,46,183,2019
2019_C14008,3,13,46,62,2019
2021_B14009,45,45,75,165,2021
2019_C14010,100,48,45,193,2019
2019_C14011,8,80,65,153,2019
2021_C14012,62,89,67,218,2021
2021_B14013,64,24,28,116,2021
2022_B14014,34,75,55,164,2022
2022_C14015,36,63,42,141,2022
2019_C14016,45,54,61,160,2019
2019_A14017,77,86,78,241,2019
2019_A14018,48,13,36,97,2019
2021_C14019,65,91,49,205,2021
2021_C14020,31,84,93,208,2021
2021_A14021,10,28,37,75,2021
2022_B14022,28,78,44,150,2022
2021_B14023,86,52,85,223,2021
2019_A14024,4,20,30,54,2019
2021_B14025,70,62,24,156,2021
2019_B14026,93,24,23,140,2019
2019_A14027,87,87,71,245,2019
2022_A14028,58,91,93,242,2022
2022_C14029,11,13,30,54,2022
2019_C14030,8,59,38,105,2019
2022_B14031,10,48,56,114,2022
2022_A14032,45,47,29,121,2022
2022_B14033,40,92,48,180,2022
2019_A14034,100,66,54,220,2019
2021_A14035,10,63,25,98,2021
2021_B14036,96,81,74,251,2021
2021_C14037,0,70,93,163,2021
2019_A14038,80,41,98,219,2019
2021_B14039,42,63,49,154,2021
2022_C14040,19,61,24,104,2022
2019_C14041,67,83,87,237,2019
2019_A14042,21,61,66,148,2019
2021_A14043,22,26,50,98,2021
2021_A14044,39,33,51,123,2021
2021_C14045,77,41,39,157,2021
2021_B14046,31,75,42,148,2021
2021_A14047,65,86,51,202,2021
2022_C14048,18,33,63,114,2022
2021_C14049,70,63,81,214,2021
2022_A14050,7,52,42,101,2022
2022_C14051,29,32,66,127,2022
2022_C14052,18,94,21,133,2022
2021_C14053,32,91,34,157,2021
2022_A14054,2,85,30,117,2022
2022_B14055,18,32,44,94,2022
2021_C14056,45,58,93,196,2021
2019_C14057,73,17,86,176,2019
2022_C14058,24,64,68,156,2022
2021_B14059,78,35,60,173,2021
2022_A14060,30,37,57,124,2022
2022_B14061,61,69,71,201,2022
2022_B14062,29,21,42,92,2022
2019_C14063,37,91,49,177,2019
2019_A14064,36,33,71,140,2019
2019_C14065,64,25,77,166,2019
2022_B14066,21,43,53,117,2022
2021_B14067,67,51,72,190,2021
2019_B14068,96,57,88,241,2019
2019_B14069,54,55,28,137,2019
2021_B14070,37,51,71,159,2021
2021_C14071,95,35,90,220,2021
2021_B14072,94,70,70,234,2021
2022_A14073,7,38,56,101,2022
2019_A14074,14,78,47,139,2019
2022_B14075,9,42,26,77,2022
2022_A14076,68,67,92,227,2022
2021_B14077,86,24,75,185,2021
2022_A14078,30,58,77,165,2022
2021_C14079,91,32,91,214,2021
2019_C14080,44,91,21,156,2019
2021_A14081,47,87,36,170,2021
2021_B14082,24,37,96,157,2021
2022_A14083,27,71,30,128,2022
2022_B14084,12,11,54,77,2022
2022_A14085,40,11,96,147,2022
2021_B14086,32,32,84,148,2021
2021_C14087,80,43,56,179,2021
2021_B14088,3,72,32,107,2021
2019_A14089,49,38,29,116,2019
2022_A14090,75,41,94,210,2022
2019_A14091,92,20,88,200,2019
2019_C14092,64,27,24,115,2019
2021_B14093,11,88,90,189,2021
2019_C14094,40,11,81,132,2019
2019_C14095,88,65,67,220,2019
2021_C14096,8,55,23,86,2021
2019_A14097,52,62,22,136,2019
2021_C14098,28,47,73,148,2021
2019_A14099,36,14,78,128,2019
2019_B14100,74,71,98,243,2019
2022_C14101,67,18,54,139,2022
2021_B14102,0,75,69,144,2021
2019_C14103,69,46,96,211,2019
2019_B14104,29,32,65,126,2019
2019_A14105,81,15,55,151,2019
2021_A14106,60,41,36,137,2021
2021_C14107,77,39,68,184,2021
2019_B14108,39,69,21,129,2019
2022_B14109,24,11,84,119,2022
2022_B14110,53,72,65,190,2022
2019_B14111,91,49,82,222,2019
2019_B14112,19,49,49,117,2019
2022_C14113,32,15,79,126,2022
2019_B14114,9,59,26,94,2019
2021_C14115,15,79,87,181,2021
2019_C14116,46,78,55,179,2019
2019_A14117,8,94,43,145,2019
2019_C14118,45,91,88,224,2019
2019_C14119,32,81,28,141,2019
2019_B14120,68,76,38,182,2019
2019_B14121,56,40,47,143,2019
2019_A14122,35,31,67,133,2019
2019_A14123,79,68,56,203,2019
2019_A14124,56,78,29,163,2019
2022_A14125,82,49,73,204,2022
2019_C14126,47,11,58,116,2019
2019_A14127,58,61,26,145,2019
2022_C14128,4,22,98,124,2022
2019_C14129,40,50,32,122,2019
2022_C14130,71,12,76,159,2022
2022_C14131,66,80,34,180,2022
2022_A14132,71,40,52,163,2022
2022_A14133,28,94,23,145,2022
2021_C14134,43,96,87,226,2021
2019_B14135,38,23,91,152,2019
2021_C14136,75,40,85,200,2021
2021_C14137,4,67,63,134,2021
2019_A14138,62,58,34,154,2019
2021_C14139,3,43,69,115,2021
2021_C14140,55,82,51,188,2021
2019_B14141,99,33,49,181,2019
2021_C14142,67,76,59,202,2021
2021_A14143,51,94,52,197,2021
2019_C14144,71,37,80,188,2019
2022_C14145,38,62,31,131,2022
2019_C14146,94,54,44,192,2019
2019_C14147,10,21,90,121,2019
2019_C14148,56,19,82,157,2019
2022_A14149,63,46,55,164,2022
2019_B14150,68,49,33,150,2019
2022_A14151,91,17,73,181,2022
2022_C14152,76,28,85,189,2022
2022_C14153,8,78,46,132,2022
2022_B14154,28,51,37,116,2022
2022_B14155,63,14,93,170,2022
2019_B14156,49,63,22,134,2019
2021_A14157,50,33,27,110,2021
2019_A14158,98,69,81,248,2019
2021_C14159,65,78,72,215,2021
2021_B14160,48,78,77,203,2021
2022_B14161,25,67,72,164,2022
2021_A14162,24,85,54,163,2021
2019_A14163,99,37,47,183,2019
2022_C14164,68,63,27,158,2022
2021_A14165,30,37,41,108,2021
2021_C14166,93,77,50,220,2021
2022_C14167,99,94,30,223,2022
2021_A14168,40,16,90,146,2021
2021_B14169,67,85,38,190,2021
2019_A14170,50,19,91,160,2019
2022_A14171,85,91,92,268,2022
2022_C14172,17,18,36,71,2022
2021_B14173,83,85,92,260,2021
2022_B14174,96,15,43,154,2022
2022_C14175,52,33,41,126,2022
2022_A14176,33,89,83,205,2022
2022_A14177,91,16,34,141,2022
2022_C14178,90,57,82,229,2022
2021_B14179,8,32,22,62,2021
2021_C14180,58,41,25,124,2021
2021_B14181,28,24,23,75,2021
2021_B14182,51,45,86,182,2021
2022_A14183,3,69,82,154,2022
2021_B14184,14,97,21,132,2021
2022_A14185,53,75,74,202,2022
2019_A14186,65,59,60,184,2019
2019_C14187,61,69,61,191,2019
2022_A14188,49,14,35,98,2022
2022_A14189,36,29,27,92,2022
2021_A14190,68,39,57,164,2021
2021_A14191,73,75,33,181,2021
2022_B14192,85,40,57,182,2022
2022_B14193,51,27,73,151,2022
2021_C14194,69,40,34,143,2021
2021_B14195,28,76,46,150,2021
2021_B14196,19,36,46,101,2021
2022_C14197,1,46,29,76,2022
2019_A14198,9,23,71,103,2019
2019_B14199,81,43,87,211,2019
2022_B14200,31,61,49,141,2022
2022_A14201,100,70,68,238,2022
2022_B14202,62,27,92,181,2022
2022_B14203,40,48,39,127,2022
2021_B14204,15,32,90,137,2021
2021_B14205,78,36,33,147,2021
2022_B14206,87,64,22,173,2022
2019_C14207,36,43,59,138,2019
2021_B14208,8,11,94,113,2021
2021_C14209,16,53,81,150,2021
2019_A14210,99,65,82,246,2019
2022_C14211,56,51,88,195,2022
2019_C14212,38,82,45,165,2019
2019_B14213,74,15,38,127,2019
2021_C14214,3,70,52,125,2021
2019_A14215,73,82,63,218,2019
2019_C14216,39,70,27,136,2019
2022_A14217,30,20,74,124,2022
2022_A14218,44,25,90,159,2022
2021_B14219,97,48,28,173,2021
2021_B14220,90,95,47,232,2021
2019_A14221,29,84,94,207,2019
2022_C14222,2,21,58,81,2022
2021_C14223,86,81,28,195,2021
2021_C14224,64,93,41,198,2021
2022_B14225,27,55,39,121,2022
2019_C14226,78,19,26,123,2019
2019_B14227,42,28,48,118,2019
2021_C14228,85,12,55,152,2021
2021_A14229,20,34,64,118,2021
2021_B14230,77,93,68,238,2021
2022_A14231,14,70,54,138,2022
2019_A14232,11,90,68,169,2019
2022_C14233,12,86,75,173,2022
2022_A14234,68,65,68,201,2022
2019_B14235,49,90,52,191,2019
2019_B14236,98,68,77,243,2019
2022_B14237,80,40,90,210,2022
2019_B14238,56,76,74,206,2019
2021_A14239,80,44,67,191,2021
2021_B14240,21,74,75,170,2021
2021_B14241,70,77,90,237,2021
2019_C14242,98,22,32,152,2019
2022_A14243,33,40,87,160,2022
2022_A14244,54,42,61,157,2022
2021_C14245,37,64,75,176,2021
2022_A14246,20,31,99,150,2022
2019_B14247,21,91,65,177,2019
2021_A14248,56,16,69,141,2021
2021_B14249,1,24,68,93,2021
2021_B14250,89,40,21,150,2021
2021_C14251,30,46,47,123,2021
2021_C14252,8,40,36,84,2021
2021_A14253,94,92,49,235,2021
2022_A14254,67,14,80,161,2022
2021_C14255,79,77,54,210,2021
2021_A14256,58,54,37,149,2021
2021_C14257,31,79,32,142,2021
2022_B14258,30,72,61,163,2022
2019_B14259,20,54,47,121,2019
2022_A14260,10,86,64,160,2022
2022_C14261,53,95,28,176,2022
2022_C14262,39,64,56,159,2022
2021_A14263,1,25,78,104,2021
2019_A14264,74,77,46,197,2019
2022_A14265,8,17,80,105,2022
2019_A14266,46,75,45,166,2019
2022_C14267,82,22,46,150,2022
2021_B14268,37,67,37,141,2021
2019_A14269,4,55,29,88,2019
2019_C14270,51,81,95,227,2019
2019_A14271,11,42,72,125,2019
2021_A14272,23,22,72,117,2021
2021_C14273,32,39,81,152,2021
2022_B14274,12,21,35,68,2022
2021_A14275,33,27,79,139,2021
2022_B14276,40,24,54,118,2022
2022_C14277,82,54,51,187,2022
2022_C14278,40,37,74,151,2022
2019_C14279,16,29,66,111,2019
2022_C14280,100,60,58,218,2022
2019_B14281,57,77,29,163,2019
2021_A14282,28,43,32,103,2021
2022_A14283,12,91,68,171,2022
2019_B14284,81,83,36,200,2019
2019_B14285,45,11,89,145,2019
2022_A14286,27,27,43,97,2022
2022_A14287,26,76,30,132,2022
2021_B14288,86,44,92,222,2021
2021_B14289,52,80,48,180,2021
2019_B14290,64,58,30,152,2019
2022_A14291,88,77,83,248,2022
2021_A14292,87,31,44,162,2021
2019_C14293,85,50,90,225,2019
2019_B14294,37,66,71,174,2019
2019_C14295,87,58,52,197,2019
2021_C14296,2,58,92,152,2021
2021_B14297,28,71,76,175,2021
2021_C14298,64,66,64,194,2021
2019_C14299,90,17,97,204,2019
2019_C14300,30,22,65,117,2019
2022_A14301,15,94,91,200,2022
2019_B14302,2,61,29,92,2019
2019_A14303,21,16,58,95,2019
2022_B14304,20,55,37,112,2022
2021_A14305,18,84,95,197,2021
2021_A14306,71,68,70,209,2021
2022_B14307,69,60,58,187,2022
2021_A14308,9,45,45,99,2021
2019_B14309,70,74,66,210,2019
2019_B14310,27,89,74,190,2019
2019_C14311,41,79,46,166,2019
2022_B14312,34,22,92,148,2022
2022_C14313,84,76,71,231,2022
2021_A14314,36,37,93,166,2021
2021_B14315,16,46,67,129,2021
2019_B14316,73,62,47,182,2019
2022_A14317,61,43,38,142,2022
2021_B14318,62,17,53,132,2021
2019_A14319,57,93,56,206,2019
2021_B14320,57,61,78,196,2021
2021_C14321,11,31,48,90,2021
2021_B14322,27,76,56,159,2021
2022_C14323,66,17,73,156,2022
2019_B14324,88,30,97,215,2019
2022_B14325,13,32,22,67,2022
2021_A14326,90,27,49,166,2021
2019_A14327,44,57,33,134,2019
2021_B14328,91,19,65,175,2021
2019_B14329,81,42,34,157,2019
2022_A14330,53,11,68,132,2022
2019_C14331,73,23,45,141,2019
2019_C14332,78,80,56,214,2019
2022_B14333,50,63,23,136,2022
2022_B14334,62,12,40,114,2022
2019_B14335,50,82,60,192,2019
2021_C14336,48,32,37,117,2021
2022_B14337,11,85,77,173,2022
2019_C14338,67,44,47,158,2019
2022_B14339,13,24,28,65,2022
2022_C14340,82,46,83,211,2022
2022_B14341,36,71,98,205,2022
2019_C14342,89,39,84,212,2019
2021_B14343,10,40,41,91,2021
2021_A14344,23,82,70,175,2021
2022_A14345,50,30,44,124,2022
2021_C14346,46,87,22,155,2021
2019_C14347,92,57,80,229,2019
2019_B14348,77,65,44,186,2019
2022_C14349,78,33,90,201,2022
2022_B14350,93,91,75,259,2022
2019_B14351,78,52,68,198,2019
2021_A14352,98,90,82,270,2021
2019_A14353,54,87,46,187,2019
2022_A14354,88,20,63,171,2022
2019_B14355,55,67,34,156,2019
2021_C14356,36,94,58,188,2021
2019_B14357,99,97,45,241,2019
2021_C14358,68,91,88,247,2021
2021_C14359,73,92,48,213,2021
2022_A14360,88,71,47,206,2022
2022_A14361,53,40,70,163,2022
2021_A14362,16,20,47,83,2021
2021_A14363,28,72,23,123,2021
2019_A14364,50,48,44,142,2019
2021_C14365,2,78,22,102,2021
2022_C14366,42,51,28,121,2022
2019_C14367,73,96,72,241,2019
2022_A14368,22,86,22,130,2022
2022_A14369,27,72,92,191,2022
2021_C14370,93,68,84,245,2021
2019_A14371,42,56,70,168,2019
2019_C14372,3,18,98,119,2019
2019_B14373,40,40,56,136,2019
2022_B14374,2,35,33,70,2022
2022_B14375,37,65,79,181,2022
2022_C14376,45,86,74,205,2022
2022_B14377,98,70,86,254,2022
2021_B14378,0,83,34,117,2021
2022_C14379,86,75,52,213,2022
2021_A14380,5,60,28,93,2021
2022_A14381,28,47,34,109,2022
2022_A14382,5,46,26,77,2022
2021_B14383,87,89,31,207,2021
2021_A14384,36,35,68,139,2021
2019_C14385,46,33,66,145,2019
2022_A14386,7,27,70,104,2022
2022_A14387,48,44,85,177,2022
2022_A14388,22,53,57,132,2022
2022_B14389,43,16,65,124,2022
2022_B14390,59,80,35,174,2022
2022_A14391,20,41,87,148,2022
2021_C14392,40,64,38,142,2021
2021_B14393,7,72,95,174,2021
2021_A14394,52,44,93,189,2021
2022_A14395,29,19,57,105,2022
2019_C14396,27,74,76,177,2019
2019_B14397,79,63,48,190,2019
2022_A14398,55,77,43,175,2022
2019_A14399,77,69,64,210,2019
2019_A14400,60,75,37,172,2019
2019_B14401,85,29,88,202,2019
2021_B14402,71,74,39,184,2021
2022_A14403,17,89,95,201,2022
2019_A14404,24,30,33,87,2019
2022_C14405,36,44,93,173,2022
2021_C14406,27,70,26,123,2021
2019_C14407,97,27,93,217,2019
2022_B14408,42,64,94,200,2022
2021_C14409,28,34,40,102,2021
2022_A14410,16,90,93,199,2022
2021_A14411,26,19,99,144,2021
2021_C14412,93,40,77,210,2021
2022_C14413,18,76,63,157,2022
2022_A14414,84,50,99,233,2022
2021_A14415,94,15,38,147,2021
2021_A14416,89,77,62,228,2021
2022_C14417,11,54,75,140,2022
2021_C14418,34,43,67,144,2021
2022_B14419,92,24,99,215,2022
2022_A14420,59,19,56,134,2022
2022_B14421,22,19,86,127,2022
2019_C14422,57,86,77,220,2019
2021_B14423,78,62,37,177,2021
2021_B14424,48,21,21,90,2021
2021_C14425,84,29,50,163,2021
2022_A14426,7,18,30,55,2022
2019_C14427,45,21,25,91,2019
2022_B14428,6,47,43,96,2022
2019_B14429,54,34,61,149,2019
2022_C14430,14,50,74,138,2022
2019_A14431,84,19,58,161,2019
2019_A14432,41,22,61,124,2019
2022_B14433,53,41,49,143,2022
2022_C14434,56,56,62,174,2022
2021_C14435,61,27,45,133,2021
2022_B14436,51,65,76,192,2022
2019_B14437,54,44,32,130,2019
2021_B14438,66,22,75,163,2021
2022_B14439,78,71,51,200,2022
2021_B14440,62,56,25,143,2021
2019_C14441,35,30,90,155,2019
2019_A14442,65,51,89,205,2019
2021_B14443,30,63,89,182,2021
2022_B14444,80,80,90,250,2022
2021_B14445,73,82,54,209,2021
2022_C14446,88,42,85,215,2022
2021_C14447,66,95,41,202,2021
2021_B14448,5,37,42,84,2021
2022_A14449,41,73,83,197,2022
2022_C14450,9,23,74,106,2022
2019_A14451,43,73,31,147,2019
2019_B14452,90,61,69,220,2019
2022_A14453,39,81,68,188,2022
2022_A14454,45,80,62,187,2022
2019_A14455,60,14,89,163,2019
2021_B14456,38,88,30,156,2021
2021_A14457,28,66,78,172,2021
2021_B14458,52,42,25,119,2021
2019_A14459,88,22,22,132,2019
2022_A14460,62,55,36,153,2022
2021_A14461,77,54,70,201,2021
2022_C14462,12,43,89,144,2022
2021_C14463,67,60,44,171,2021
2022_C14464,75,22,31,128,2022
2022_C14465,58,65,83,206,2022
2019_C14466,60,76,84,220,2019
2022_C14467,0,81,65,146,2022
2022_A14468,100,58,29,187,2022
2022_B14469,45,23,81,149,2022
2019_A14470,82,45,34,161,2019
2021_B14471,92,21,21,134,2021
2022_B14472,61,63,99,223,2022
2019_B14473,9,30,51,90,2019
2019_C14474,90,87,97,274,2019
2019_B14475,46,70,25,141,2019
2022_C14476,11,16,25,52,2022
2019_B14477,91,19,65,175,2019
2022_B14478,56,32,57,145,2022
2019_C14479,11,82,59,152,2019
2021_B14480,35,91,36,162,2021
2019_C14481,76,15,76,167,2019
2021_C14482,98,12,83,193,2021
2022_A14483,42,32,28,102,2022
2021_B14484,4,45,39,88,2021
2021_B14485,38,80,54,172,2021
2019_C14486,58,84,34,176,2019
2021_B14487,3,88,41,132,2021
2022_C14488,14,38,38,90,2022
2022_B14489,14,75,62,151,2022
2022_B14490,79,54,86,219,2022
2019_A14491,19,72,82,173,2019
2019_C14492,86,55,96,237,2019
2021_A14493,6,52,96,154,2021
2021_A14494,98,47,98,243,2021
2022_A14495,19,41,50,110,2022
2019_C14496,9,67,24,100,2019
2019_B14497,10,54,32,96,2019
2019_C14498,33,20,83,136,2019
2021_A14499,37,52,43,132,2021
2022_A14500,56,71,97,224,2022
2021_A14501,60,39,23,122,2021
2021_B14502,67,11,79,157,2021
2019_C14503,68,44,44,156,2019
2021_A14504,64,46,62,172,2021
2019_A14505,32,52,45,129,2019
2019_A14506,1,76,66,143,2019
2022_A14507,73,72,87,232,2022
2019_B14508,87,59,72,218,2019
2022_B14509,91,47,42,180,2022
2019_C14510,30,97,21,148,2019
2022_A14511,31,12,22,65,2022
2021_B14512,56,17,31,104,2021
2019_B14513,93,37,33,163,2019
2021_B14514,33,17,96,146,2021
2021_C14515,89,49,28,166,2021
2019_C14516,34,42,76,152,2019
2021_B14517,31,59,82,172,2021
2019_C14518,91,55,97,243,2019
2022_B14519,88,33,94,215,2022
2022_A14520,12,55,87,154,2022
2021_A14521,83,15,79,177,2021
2019_C14522,75,41,64,180,2019
2021_B14523,55,11,65,131,2021
2021_A14524,99,12,72,183,2021
2019_B14525,71,54,39,164,2019
2021_A14526,27,96,64,187,2021
2021_A14527,86,59,83,228,2021
2021_B14528,82,95,87,264,2021
2019_B14529,80,67,35,182,2019
2019_B14530,41,93,35,169,2019
2021_C14531,27,55,33,115,2021
2019_A14532,46,55,27,128,2019
2021_B14533,96,90,93,279,2021
2019_C14534,68,11,32,111,2019
2021_A14535,48,38,85,171,2021
2019_B14536,7,66,38,111,2019
2022_A14537,58,88,90,236,2022
2022_A14538,94,62,31,187,2022
2021_C14539,68,51,35,154,2021
2022_C14540,8,28,50,86,2022
2019_B14541,13,82,83,178,2019
2021_A14542,12,16,36,64,2021
2022_B14543,96,57,56,209,2022
2019_C14544,7,28,88,123,2019
2019_B14545,92,20,58,170,2019
2021_C14546,30,93,69,192,2021
2019_B14547,9,29,65,103,2019
2021_B14548,23,49,23,95,2021
2019_C14549,53,79,46,178,2019
2019_B14550,26,32,43,101,2019
2021_A14551,24,45,48,117,2021
2019_B14552,79,38,83,200,2019
2021_C14553,54,19,65,138,2021
2022_A14554,74,96,38,208,2022
2022_B14555,67,11,40,118,2022
2019_C14556,82,65,97,244,2019
2022_C14557,91,97,75,263,2022
2021_C14558,32,73,24,129,2021
2019_C14559,30,13,57,100,2019
2019_A14560,25,63,30,118,2019
2019_C14561,84,41,56,181,2019
2019_B14562,0,65,54,119,2019
2022_A14563,40,17,24,81,2022
2021_C14564,12,71,68,151,2021
2021_A14565,48,29,21,98,2021
2022_A14566,41,20,47,108,2022
2021_C14567,33,60,75,168,2021
2021_C14568,13,33,96,142,2021
2019_A14569,87,69,91,247,2019
2022_B14570,87,47,50,184,2022
2019_C14571,87,22,42,151,2019
2021_B14572,35,39,48,122,2021
2021_A14573,62,31,56,149,2021
2019_C14574,39,27,34,100,2019
2019_B14575,22,75,58,155,2019
2022_C14576,84,78,97,259,2022
2021_A14577,98,19,82,199,2021
2022_A14578,57,86,80,223,2022
2021_A14579,91,26,28,145,2021
2022_A14580,2,68,47,117,2022
2021_B14581,63,56,30,149,2021
2019_B14582,39,46,79,164,2019
2022_B14583,23,46,89,158,2022
2022_B14584,47,78,73,198,2022
2019_C14585,50,52,79,181,2019
2021_C14586,88,71,87,246,2021
2022_A14587,57,36,36,129,2022
2021_B14588,48,26,37,111,2021
2021_B14589,48,97,32,177,2021
2022_B14590,14,22,35,71,2022
2019_A14591,57,82,93,232,2019
2022_C14592,26,66,75,167,2022
2022_A14593,12,20,73,105,2022
2022_B14594,98,43,78,219,2022
2019_C14595,88,75,33,196,2019
2021_A14596,23,48,35,106,2021
2022_B14597,44,78,43,165,2022
2022_B14598,42,85,74,201,2022
2022_B14599,89,48,82,219,2022
2019_A14600,55,35,57,147,2019
2019_A14601,80,24,91,195,2019
2022_A14602,68,38,47,153,2022
2019_B14603,66,22,76,164,2019
2019_A14604,36,30,27,93,2019
2021_B14605,8,58,55,121,2021
2022_C14606,87,81,63,231,2022
2022_A14607,79,55,44,178,2022
2019_A14608,78,76,61,215,2019
2021_C14609,15,48,73,136,2021
2019_B14610,26,39,68,133,2019
2019_C14611,27,88,62,177,2019
2019_A14612,62,23,87,172,2019
2019_C14613,30,31,45,106,2019
2019_A14614,43,64,96,203,2019
2021_B14615,93,56,51,200,2021
2022_A14616,90,57,39,186,2022
2022_B14617,30,90,88,208,2022
2019_B14618,96,36,61,193,2019
2022_B14619,74,13,80,167,2022
2019_A14620,61,47,65,173,2019
2019_A14621,96,70,42,208,2019
2019_A14622,26,52,41,119,2019
2021_A14623,29,74,87,190,2021
2022_A14624,56,45,74,175,2022
2021_B14625,31,51,30,112,2021
2019_B14626,41,83,51,175,2019
2021_C14627,45,61,64,170,2021
2022_A14628,20,80,69,169,2022
2022_B14629,22,53,39,114,2022
2021_B14630,60,88,69,217,2021
2021_B14631,53,56,45,154,2021
2021_B14632,49,65,43,157,2021
2022_C14633,67,59,52,178,2022
2019_A14634,87,17,56,160,2019
2019_C14635,30,37,25,92,2019
2022_C14636,92,65,21,178,2022
2021_A14637,75,15,27,117,2021
2021_A14638,55,63,32,150,2021
2021_A14639,61,16,64,141,2021
2019_B14640,80,11,27,118,2019
2021_C14641,20,20,81,121,2021
2022_C14642,48,59,50,157,2022
2019_A14643,23,71,30,124,2019
2019_B14644,3,78,80,161,2019
2021_C14645,31,39,26,96,2021
2019_A14646,56,19,21,96,2019
2021_A14647,33,29,85,147,2021
2019_A14648,80,66,40,186,2019
2019_B14649,1,71,77,149,2019
2022_C14650,17,55,77,149,2022
2019_A14651,6,60,38,104,2019
2019_A14652,62,73,89,224,2019
2019_B14653,57,23,26,106,2019
2019_B14654,5,85,76,166,2019
2019_C14655,44,15,40,99,2019
2019_A14656,20,18,59,97,2019
2019_A14657,20,11,91,122,2019
2021_C14658,45,22,35,102,2021
2021_C14659,3,21,23,47,2021
2019_B14660,66,35,98,199,2019
2021_C14661,54,78,85,217,2021
2019_A14662,37,97,92,226,2019
2022_B14663,41,27,87,155,2022
2021_A14664,89,23,74,186,2021
2019_B14665,72,20,29,121,2019
2022_A14666,23,11,53,87,2022
2019_B14667,65,25,97,187,2019
2019_A14668,37,90,88,215,2019
2021_B14669,60,56,61,177,2021
2022_C14670,86,70,81,237,2022
2022_B14671,16,49,42,107,2022
2021_B14672,42,47,21,110,2021
2022_A14673,58,49,87,194,2022
2021_B14674,52,61,48,161,2021
2022_A14675,61,30,30,121,2022
2019_C14676,89,80,60,229,2019
2019_A14677,38,54,49,141,2019
2021_A14678,71,39,89,199,2021
2022_B14679,95,87,57,239,2022
2019_B14680,86,39,56,181,2019
2019_B14681,60,59,98,217,2019
2021_A14682,79,49,85,213,2021
2022_A14683,18,83,49,150,2022
2022_C14684,94,52,46,192,2022
2021_C14685,33,11,89,133,2021
2021_C14686,62,23,70,155,2021
2021_A14687,59,16,49,124,2021
2019_B14688,32,67,50,149,2019
2019_B14689,87,73,93,253,2019
2019_C14690,55,25,56,136,2019
2021_C14691,22,51,47,120,2021
2019_C14692,53,28,88,169,2019
2019_B14693,11,97,56,164,2019
2021_A14694,63,56,66,185,2021
2021_B14695,80,57,61,198,2021
2019_C14696,23,71,52,146,2019
2021_C14697,31,83,31,145,2021
2021_C14698,91,29,63,183,2021
2021_A14699,80,28,24,132,2021
2019_A14700,26,49,94,169,2019
2019_A14701,76,18,54,148,2019
2021_C14702,48,85,79,212,2021
2022_A14703,16,66,38,120,2022
2021_C14704,43,25,34,102,2021
2022_C14705,63,12,41,116,2022
2019_A14706,48,76,64,188,2019
2019_B14707,84,59,88,231,2019
2021_C14708,48,52,75,175,2021
2021_B14709,55,55,56,166,2021
2022_A14710,58,30,75,163,2022
2021_B14711,58,88,26,172,2021
2019_A14712,91,32,72,195,2019
2019_C14713,19,52,39,110,2019
2019_C14714,25,37,83,145,2019
2021_A14715,50,71,88,209,2021
2022_A14716,11,83,73,167,2022
2022_B14717,84,32,54,170,2022
2019_C14718,22,80,62,164,2019
2019_B14719,95,24,33,152,2019
2019_C14720,30,37,45,112,2019
2019_C14721,70,70,46,186,2019
2019_B14722,4,76,40,120,2019
2019_B14723,94,51,83,228,2019
2021_B14724,50,43,80,173,2021
2019_C14725,58,22,70,150,2019
2019_A14726,81,19,99,199,2019
2021_B14727,82,92,32,206,2021
2022_B14728,1,94,63,158,2022
2019_A14729,78,85,38,201,2019
2022_B14730,16,57,51,124,2022
2019_A14731,74,50,77,201,2019
2019_A14732,22,22,51,95,2019
2021_B14733,65,34,70,169,2021
2022_A14734,15,11,79,105,2022
2021_A14735,21,28,90,139,2021
2019_B14736,5,62,45,112,2019
2021_B14737,8,92,46,146,2021
2022_B14738,34,64,53,151,2022
2021_B14739,50,47,95,192,2021
2022_A14740,15,55,71,141,2022
2019_C14741,13,84,47,144,2019
2019_C14742,81,75,81,237,2019
2019_C14743,86,59,41,186,2019
2021_C14744,20,66,67,153,2021
2022_A14745,41,52,79,172,2022
2019_A14746,10,43,44,97,2019
2019_B14747,48,29,84,161,2019
2021_B14748,67,63,42,172,2021
2021_B14749,34,26,47,107,2021
2019_C14750,98,71,80,249,2019
2019_A14751,72,37,36,145,2019
2022_C14752,80,36,75,191,2022
2021_B14753,2,97,70,169,2021
2021_A14754,48,46,64,158,2021
2022_A14755,72,20,44,136,2022
2022_B14756,10,79,51,140,2022
2019_A14757,73,20,92,185,2019
2021_B14758,56,41,88,185,2021
2022_A14759,11,87,40,138,2022
2021_B14760,69,97,78,244,2021
2021_A14761,1,74,90,165,2021
2019_C14762,58,92,31,181,2019
2021_B14763,75,55,44,174,2021
2021_B14764,45,30,21,96,2021
2021_B14765,85,86,33,204,2021
2022_A14766,75,35,55,165,2022
2022_B14767,52,97,55,204,2022
2019_B14768,51,38,23,112,2019
2019_C14769,72,79,21,172,2019
2022_B14770,10,71,78,159,2022
2019_C14771,13,33,82,128,2019
2021_C14772,84,68,91,243,2021
2022_C14773,10,12,46,68,2022
2019_C14774,11,35,97,143,2019
2022_A14775,34,86,61,181,2022
2022_B14776,77,67,98,242,2022
2022_C14777,48,46,93,187,2022
2019_B14778,88,52,59,199,2019
2022_B14779,21,91,41,153,2022
2019_B14780,65,18,34,117,2019
2019_B14781,59,16,96,171,2019
2021_A14782,21,44,69,134,2021
2022_A14783,51,51,64,166,2022
2021_C14784,8,77,68,153,2021
2022_A14785,77,81,44,202,2022
2022_C14786,66,20,93,179,2022
2021_A14787,28,45,64,137,2021
2019_A14788,24,67,34,125,2019
2022_C14789,18,60,74,152,2022
2022_C14790,49,72,49,170,2022
2019_C14791,80,40,42,162,2019
2022_A14792,94,33,52,179,2022
2022_C14793,26,26,23,75,2022
2019_B14794,19,35,76,130,2019
2019_B14795,55,51,40,146,2019
2021_B14796,69,21,23,113,2021
2022_B14797,97,88,63,248,2022
2021_A14798,18,82,34,134,2021
2022_B14799,42,70,87,199,2022
2021_A14800,31,49,26,106,2021
2022_B14801,27,79,36,142,2022
2021_B14802,78,35,50,163,2021
2022_B14803,17,85,43,145,2022
2021_A14804,57,14,83,154,2021
2022_C14805,57,89,43,189,2022
2021_B14806,21,29,63,113,2021
2022_B14807,50,54,25,129,2022
2021_A14808,64,44,76,184,2021
2021_A14809,12,61,31,104,2021
2022_C14810,9,91,29,129,2022
2022_B14811,45,56,35,136,2022
2022_C14812,76,97,71,244,2022
2019_A14813,81,12,33,126,2019
2019_A14814,37,48,37,122,2019
2021_A14815,94,37,69,200,2021
2019_C14816,36,52,40,128,2019
2019_C14817,92,88,99,279,2019
2019_A14818,4,94,30,128,2019
2019_B14819,50,74,50,174,2019
2019_A14820,43,11,59,113,2019
2021_C14821,15,33,71,119,2021
2021_A14822,64,20,93,177,2021
2021_A14823,4,34,74,112,2021
2021_A14824,76,18,56,150,2021
2021_A14825,19,75,75,169,2021
2022_A14826,6,33,55,94,2022
2022_C14827,80,79,51,210,2022
2019_C14828,78,66,91,235,2019
2019_B14829,7,25,37,69,2019
2022_A14830,24,49,53,126,2022
2019_C14831,80,62,73,215,2019
2022_A14832,61,46,81,188,2022
2019_B14833,20,75,95,190,2019
2021_C14834,39,92,86,217,2021
2021_C14835,62,75,26,163,2021
2021_C14836,75,30,96,201,2021
2022_A14837,60,71,58,189,2022
2021_C14838,100,24,30,154,2021
2021_B14839,47,14,39,100,2021
2021_A14840,56,81,89,226,2021
2021_A14841,51,61,40,152,2021
2022_A14842,29,38,52,119,2022
2019_A14843,30,75,30,135,2019
2021_B14844,55,80,21,156,2021
2022_C14845,95,11,32,138,2022
2022_B14846,51,59,60,170,2022
2021_B14847,80,18,75,173,2021
2019_B14848,72,91,64,227,2019
2022_C14849,70,26,23,119,2022
2019_C14850,86,82,91,259,2019
2019_A14851,2,30,95,127,2019
2022_C14852,92,17,96,205,2022
2019_B14853,96,13,24,133,2019
2019_C14854,98,79,63,240,2019
2022_B14855,86,24,78,188,2022
2022_C14856,83,93,26,202,2022
2022_C14857,69,14,31,114,2022
2019_C14858,51,31,75,157,2019
2021_A14859,49,40,62,151,2021
2021_A14860,48,47,48,143,2021
2019_B14861,71,83,46,200,2019
2022_C14862,10,50,51,111,2022
2022_A14863,47,97,68,212,2022
2021_B14864,16,11,27,54,2021
2022_B14865,45,70,91,206,2022
2021_B14866,35,63,45,143,2021
2022_A14867,87,31,29,147,2022
2021_C14868,42,14,26,82,2021
2021_A14869,16,60,81,157,2021
2019_C14870,38,85,36,159,2019
2021_B14871,5,26,34,65,2021
2022_C14872,54,90,43,187,2022
2019_A14873,93,60,39,192,2019
2019_A14874,1,17,55,73,2019
2019_C14875,48,92,71,211,2019
2021_B14876,84,11,87,182,2021
2019_C14877,63,72,79,214,2019
2022_C14878,51,12,41,104,2022
2021_A14879,19,26,29,74,2021
2022_A14880,89,18,23,130,2022
2019_A14881,18,46,31,95,2019
2019_B14882,5,82,97,184,2019
2022_C14883,60,42,64,166,2022
2021_A14884,77,42,56,175,2021
2022_A14885,85,25,46,156,2022
2021_A14886,54,28,82,164,2021
2021_B14887,77,50,90,217,2021
2021_A14888,49,38,51,138,2021
2021_B14889,12,55,40,107,2021
2019_B14890,27,37,27,91,2019
2019_C14891,5,52,82,139,2019
2019_B14892,62,76,62,200,2019
2021_B14893,51,67,96,214,2021
2021_A14894,100,46,43,189,2021
2019_B14895,38,12,49,99,2019
2021_A14896,99,54,58,211,2021
2022_C14897,99,88,71,258,2022
2019_C14898,10,51,86,147,2019
2019_A14899,15,15,44,74,2019
2021_C14900,60,44,64,168,2021
2021_A14901,40,31,22,93,2021
2021_C14902,66,25,70,161,2021
2019_A14903,64,22,80,166,2019
2019_B14904,12,24,42,78,2019
2021_B14905,48,14,49,111,2021
2022_A14906,21,94,27,142,2022
2021_B14907,31,69,61,161,2021
2022_A14908,86,91,31,208,2022
2021_B14909,78,14,50,142,2021
2019_C14910,18,84,28,130,2019
2022_A14911,67,67,88,222,2022
2019_C14912,11,70,26,107,2019
2021_A14913,83,34,66,183,2021
2021_A14914,30,91,47,168,2021
2021_C14915,50,52,59,161,2021
2021_C14916,71,11,37,119,2021
2022_A14917,46,55,36,137,2022
2019_C14918,86,21,69,176,2019
2021_C14919,40,96,68,204,2021
2019_C14920,0,80,86,166,2019
2022_A14921,48,40,44,132,2022
2022_A14922,35,88,45,168,2022
2019_A14923,86,25,33,144,2019
2022_C14924,6,71,26,103,2022
2019_C14925,95,41,62,198,2019
2021_A14926,13,88,35,136,2021
2022_A14927,18,86,92,196,2022
2021_B14928,39,77,81,197,2021
2019_B14929,38,44,81,163,2019
2022_B14930,9,32,99,140,2022
2022_C14931,41,71,56,168,2022
2021_C14932,62,31,26,119,2021
2019_A14933,97,69,86,252,2019
2019_C14934,99,61,73,233,2019
2022_C14935,14,42,57,113,2022
2019_B14936,55,47,56,158,2019
2021_A14937,31,32,62,125,2021
2021_A14938,54,55,76,185,2021
2021_C14939,37,21,68,126,2021
2019_C14940,55,89,74,218,2019
2019_A14941,60,72,94,226,2019
2019_C14942,81,89,95,265,2019
2022_C14943,28,22,51,101,2022
2019_B14944,96,81,38,215,2019
2022_B14945,77,97,80,254,2022
2021_C14946,86,94,25,205,2021
2019_A14947,41,68,73,182,2019
2021_B14948,52,30,83,165,2021
2022_C14949,34,55,85,174,2022
2019_B14950,100,45,91,236,2019
2019_B14951,27,57,64,148,2019
2021_B14952,72,79,50,201,2021
2021_C14953,71,76,53,200,2021
2019_C14954,95,20,81,196,2019
2022_A14955,83,72,36,191,2022
2019_B14956,74,95,68,237,2019
2021_C14957,100,94,22,216,2021
2019_A14958,82,31,82,195,2019
2019_B14959,0,72,92,164,2019
2021_C14960,59,24,95,178,2021
2021_B14961,22,47,61,130,2021
2022_B14962,33,41,63,137,2022
2019_A14963,61,57,97,215,2019
2021_C14964,33,18,79,130,2021
2022_C14965,93,66,88,247,2022
2021_C14966,37,36,26,99,2021
2019_A14967,34,97,70,201,2019
2019_A14968,63,90,30,183,2019
2022_C14969,96,15,97,208,2022
2022_B14970,16,84,27,127,2022
2019_A14971,44,22,34,100,2019
2021_A14972,70,40,90,200,2021
2022_B14973,16,66,42,124,2022
2022_A14974,28,57,53,138,2022
2021_C14975,46,63,69,178,2021
2022_C14976,27,84,75,186,2022
2019_C14977,25,15,48,88,2019
2019_C14978,31,47,28,106,2019
2021_B14979,62,19,40,121,2021
2021_B14980,88,22,50,160,2021
2019_B14981,24,71,70,165,2019
2022_A14982,57,23,64,144,2022
2019_A14983,50,32,53,135,2019
2021_B14984,75,28,99,202,2021
2019_A14985,34,16,32,82,2019
2019_B14986,92,54,56,202,2019
2021_B14987,23,70,31,124,2021
2022_C14988,7,71,69,147,2022
2019_A14989,14,46,87,147,2019
2021_B14990,14,49,65,128,2021
2021_C14991,23,27,99,149,2021
2021_A14992,52,27,71,150,2021
2021_A14993,33,78,58,169,2021
2021_B14994,64,64,90,218,2021
2022_C14995,91,96,84,271,2022
2022_B14996,22,74,47,143,2022
2022_C14997,25,34,54,113,2022
2022_C14998,20,33,32,85,2022
2022_C14999,98,20,98,216,2022
2021_C15000,25,31,33,89,2021
2022_C15001,51,83,62,196,2022
2022_B15002,84,44,49,177,2022
2019_A15003,7,97,36,140,2019
2019_C15004,10,13,72,95,2019
2021_A15005,56,95,84,235,2021
2022_A15006,5,41,66,112,2022
2019_A15007,83,95,83,261,2019
2019_B15008,28,75,32,135,2019
2022_C15009,74,80,77,231,2022
2022_C15010,75,25,95,195,2022
2021_C15011,48,89,59,196,2021
2021_C15012,21,67,73,161,2021
2019_C15013,56,44,81,181,2019
2019_A15014,43,12,43,98,2019
2021_B15015,92,92,76,260,2021
2021_C15016,97,72,54,223,2021
2021_A15017,52,29,72,153,2021
2019_A15018,59,45,87,191,2019
2021_A15019,50,61,35,146,2021
2021_C15020,68,53,31,152,2021
2022_A15021,22,44,94,160,2022
2019_A15022,91,93,66,250,2019
2019_C15023,5,20,68,93,2019
2021_C15024,85,13,75,173,2021
2019_A15025,49,64,74,187,2019
2019_C15026,64,51,65,180,2019
2019_C15027,90,22,48,160,2019
2019_C15028,96,36,63,195,2019
2022_B15029,14,90,27,131,2022
2022_B15030,13,43,53,109,2022
2021_C15031,45,81,83,209,2021
2021_B15032,44,68,63,175,2021
2021_C15033,11,27,45,83,2021
2021_A15034,99,84,88,271,2021
2022_C15035,37,74,69,180,2022
2022_A15036,48,79,44,171,2022
2019_A15037,68,92,30,190,2019
2021_A15038,17,43,62,122,2021
2022_A15039,35,37,80,152,2022
2021_A15040,88,67,68,223,2021
2022_A15041,10,79,77,166,2022
2022_A15042,70,41,84,195,2022
2022_C15043,73,43,73,189,2022
2019_B15044,15,88,50,153,2019
2021_B15045,82,86,88,256,2021
2019_B15046,60,26,57,143,2019
2019_B15047,19,23,59,101,2019
2022_C15048,90,55,56,201,2022
2019_C15049,20,60,69,149,2019
2021_C15050,42,48,40,130,2021
2019_C15051,13,24,84,121,2019
2019_C15052,77,27,76,180,2019
2022_C15053,14,41,74,129,2022
2022_A15054,38,32,65,135,2022
2022_B15055,98,53,81,232,2022
2019_A15056,78,95,81,254,2019
2021_B15057,29,78,26,133,2021
2021_A15058,79,89,91,259,2021
2021_C15059,20,45,82,147,2021
2019_C15060,69,49,99,217,2019
2022_C15061,47,76,90,213,2022
2022_A15062,85,97,64,246,2022
2019_C15063,44,41,80,165,2019
2022_B15064,91,37,80,208,2022
2021_A15065,4,63,42,109,2021
2022_C15066,55,68,28,151,2022
2019_C15067,67,78,74,219,2019
2022_B15068,41,61,66,168,2022
2019_C15069,30,34,82,146,2019
2019_A15070,98,64,86,248,2019
2022_C15071,65,31,36,132,2022
2021_B15072,79,93,57,229,2021
2021_A15073,20,61,51,132,2021
2019_B15074,24,41,23,88,2019
2021_C15075,65,68,67,200,2021
2022_A15076,59,29,37,125,2022
2022_C15077,97,29,47,173,2022
2019_A15078,91,95,59,245,2019
2021_C15079,29,47,74,150,2021
2021_C15080,19,69,54,142,2021
2022_C15081,54,97,48,199,2022
2022_A15082,54,15,91,160,2022
2021_B15083,99,28,51,178,2021
2022_B15084,3,38,58,99,2022
2021_C15085,33,62,74,169,2021
2022_A15086,82,61,41,184,2022
2019_B15087,75,64,33,172,2019
2019_A15088,71,54,64,189,2019
2019_C15089,91,28,25,144,2019
2022_A15090,37,26,27,90,2022
2021_B15091,0,84,95,179,2021
2019_C15092,27,19,88,134,2019
2021_B15093,71,79,69,219,2021
2019_C15094,78,72,99,249,2019
2021_B15095,97,24,46,167,2021
2022_B15096,6,67,60,133,2022
2022_A15097,14,15,82,111,2022
2021_A15098,3,41,21,65,2021
2022_B15099,84,11,65,160,2022
2021_A15100,18,27,74,119,2021
2019_C15101,24,48,69,141,2019
2022_A15102,89,11,39,139,2022
2019_C15103,47,75,93,215,2019
2019_C15104,70,42,71,183,2019
2021_A15105,68,32,95,195,2021
2022_B15106,97,18,98,213,2022
2021_B15107,17,14,83,114,2021
2022_A15108,67,68,68,203,2022
2019_A15109,34,92,65,191,2019
2022_A15110,7,97,23,127,2022
2019_C15111,61,64,71,196,2019
2022_B15112,85,46,49,180,2022
2019_C15113,64,19,99,182,2019
2019_A15114,73,13,68,154,2019
2021_A15115,80,65,21,166,2021
2019_C15116,43,87,49,179,2019
2019_B15117,54,44,63,161,2019
2022_A15118,91,40,35,166,2022
2022_C15119,75,73,93,241,2022
2021_C15120,100,94,93,287,2021
2022_B15121,39,91,68,198,2022
2021_A15122,39,13,80,132,2021
2021_C15123,18,75,34,127,2021
2022_B15124,46,29,84,159,2022
2021_B15125,69,12,77,158,2021
2019_B15126,44,52,94,190,2019
2021_A15127,14,27,86,127,2021
2021_C15128,74,72,37,183,2021
2021_B15129,74,94,86,254,2021
2022_C15130,22,96,26,144,2022
2021_A15131,14,69,49,132,2021
2021_A15132,44,39,91,174,2021
2022_C15133,35,44,34,113,2022
2021_B15134,9,17,23,49,2021
2021_B15135,78,14,78,170,2021
2022_A15136,52,49,21,122,2022
2022_C15137,99,61,46,206,2022
2019_A15138,19,64,25,108,2019
2021_B15139,65,68,53,186,2021
2022_A15140,40,33,57,130,2022
2019_A15141,19,30,96,145,2019
2021_B15142,46,57,63,166,2021
2022_A15143,100,62,96,258,2022
2022_C15144,38,68,35,141,2022
2021_C15145,35,11,72,118,2021
2021_B15146,62,45,25,132,2021
2019_A15147,17,14,69,100,2019
2022_A15148,46,22,23,91,2022
2019_A15149,62,43,83,188,2019
2019_C15150,1,24,55,80,2019
2022_C15151,4,28,46,78,2022
2019_A15152,72,83,47,202,2019
2022_A15153,2,34,52,88,2022
2021_C15154,45,56,21,122,2021
2019_A15155,58,72,65,195,2019
2022_B15156,13,46,88,147,2022
2019_C15157,63,61,32,156,2019
2022_B15158,83,56,83,222,2022
2021_A15159,71,18,86,175,2021
2021_B15160,10,41,73,124,2021
2019_A15161,56,24,55,135,2019
2021_A15162,72,14,50,136,2021
2022_A15163,14,58,75,147,2022
2021_C15164,2,73,68,143,2021
2022_C15165,26,56,45,127,2022
2021_B15166,18,16,91,125,2021
2019_C15167,0,32,47,79,2019
2022_A15168,19,17,57,93,2022
2022_B15169,81,79,53,213,2022
2021_C15170,6,75,31,112,2021
2019_B15171,42,92,71,205,2019
2021_C15172,33,60,45,138,2021
2021_A15173,28,71,38,137,2021
2022_C15174,34,15,97,146,2022
2021_A15175,7,60,94,161,2021
2022_B15176,64,19,34,117,2022
2021_C15177,14,21,66,101,2021
2019_A15178,87,88,80,255,2019
2021_B15179,93,35,77,205,2021
2022_A15180,99,81,46,226,2022
2019_C15181,18,67,96,181,2019
2019_A15182,93,44,22,159,2019
2019_B15183,78,74,34,186,2019
2021_A15184,44,88,23,155,2021
2022_B15185,39,20,80,139,2022
2021_B15186,100,80,51,231,2021
2021_B15187,69,89,88,246,2021
2019_B15188,23,25,99,147,2019
2019_A15189,100,80,60,240,2019
2022_A15190,86,62,93,241,2022
2022_B15191,93,97,46,236,2022
2019_B15192,61,18,87,166,2019
2019_A15193,61,64,46,171,2019
2022_A15194,81,22,91,194,2022
2022_C15195,94,44,30,168,2022
2021_B15196,45,62,29,136,2021
2021_B15197,85,25,70,180,2021
2022_C15198,47,13,78,138,2022
2021_C15199,84,13,26,123,2021
2022_A15200,37,81,51,169,2022
2019_A15201,51,34,37,122,2019
2019_A15202,58,28,30,116,2019
2022_C15203,98,59,73,230,2022
2022_B15204,16,21,50,87,2022
2021_C15205,18,43,49,110,2021
2019_C15206,28,49,68,145,2019
2019_C15207,23,56,31,110,2019
2021_C15208,30,62,24,116,2021
2022_A15209,53,56,99,208,2022
2022_C15210,36,19,31,86,2022
2021_B15211,32,65,40,137,2021
2022_B15212,20,37,36,93,2022
2021_C15213,45,64,24,133,2021
2022_B15214,93,32,98,223,2022
2019_C15215,73,19,64,156,2019
2022_A15216,5,57,84,146,2022
2019_A15217,55,39,98,192,2019
2019_A15218,50,96,92,238,2019
2021_A15219,32,55,72,159,2021
2022_B15220,22,85,61,168,2022
2021_C15221,6,64,51,121,2021
2021_A15222,74,53,69,196,2021
2019_B15223,43,20,49,112,2019
2022_A15224,60,35,54,149,2022
2021_A15225,76,66,74,216,2021
2021_A15226,34,37,99,170,2021
2019_A15227,7,27,83,117,2019
2022_C15228,78,42,84,204,2022
2021_B15229,19,14,56,89,2021
2019_A15230,9,89,82,180,2019
2021_B15231,77,83,36,196,2021
2019_C15232,43,47,46,136,2019
2019_B15233,4,67,52,123,2019
2022_B15234,45,53,28,126,2022
2019_A15235,99,74,48,221,2019
2021_C15236,30,72,86,188,2021
2019_B15237,63,23,73,159,2019
2022_A15238,28,16,52,96,2022
2021_A15239,36,37,35,108,2021
2022_C15240,98,32,97,227,2022
2022_C15241,49,27,88,164,2022
2022_A15242,37,89,45,171,2022
2021_C15243,66,92,67,225,2021
2021_A15244,99,34,63,196,2021
2021_C15245,6,59,97,162,2021
2021_C15246,77,97,31,205,2021
2021_B15247,6,54,49,109,2021
2022_C15248,4,25,73,102,2022
2022_A15249,99,47,59,205,2022
2022_B15250,41,73,42,156,2022
2021_B15251,29,39,34,102,2021
2021_B15252,27,83,49,159,2021
2021_C15253,49,38,80,167,2021
2019_A15254,95,14,79,188,2019
2021_A15255,45,55,62,162,2021
2022_C15256,3,23,53,79,2022
2022_C15257,59,51,71,181,2022
2021_B15258,80,53,68,201,2021
2019_A15259,22,92,47,161,2019
2022_B15260,53,33,85,171,2022
2022_A15261,65,60,32,157,2022
2022_B15262,18,76,88,182,2022
2019_B15263,53,51,51,155,2019
2019_B15264,0,66,37,103,2019
2022_C15265,21,31,88,140,2022
2022_A15266,96,56,29,181,2022
2022_B15267,50,78,88,216,2022
2019_A15268,24,12,94,130,2019
2022_A15269,76,42,83,201,2022
2022_B15270,85,79,44,208,2022
2022_C15271,19,94,42,155,2022
2019_B15272,13,31,54,98,2019
2021_A15273,28,88,36,152,2021
2022_A15274,48,68,92,208,2022
2022_C15275,0,97,27,124,2022
2022_B15276,55,41,77,173,2022
2021_C15277,85,19,94,198,2021
2019_A15278,76,69,63,208,2019
2022_B15279,56,71,99,226,2022
2021_B15280,84,49,44,177,2021
2019_A15281,93,23,89,205,2019
2019_A15282,16,65,36,117,2019
2021_B15283,54,85,96,235,2021
2021_A15284,41,43,94,178,2021
2022_B15285,53,12,90,155,2022
2022_A15286,14,16,27,57,2022
2021_A15287,64,50,43,157,2021
2021_C15288,1,47,37,85,2021
2021_A15289,6,36,26,68,2021
2021_C15290,99,59,98,256,2021
2021_B15291,37,64,48,149,2021
2019_C15292,49,17,81,147,2019
2021_B15293,25,87,48,160,2021
2022_C15294,48,95,74,217,2022
2019_C15295,38,90,86,214,2019
2022_C15296,54,15,53,122,2022
2022_C15297,4,56,61,121,2022
2019_C15298,88,46,22,156,2019
2022_B15299,67,52,71,190,2022
2021_B15300,49,87,44,180,2021
2022_C15301,82,57,23,162,2022
2022_C15302,94,14,66,174,2022
2021_B15303,3,17,63,83,2021
2019_A15304,32,60,41,133,2019
2021_B15305,18,73,31,122,2021
2022_A15306,21,80,65,166,2022
2022_C15307,35,78,26,139,2022
2019_A15308,93,31,70,194,2019
2019_C15309,78,72,58,208,2019
2021_B15310,63,59,54,176,2021
2019_C15311,59,81,57,197,2019
2021_B15312,39,94,91,224,2021
2021_C15313,6,21,83,110,2021
2019_A15314,46,66,94,206,2019
2022_B15315,70,34,44,148,2022
2021_B15316,76,55,31,162,2021
2022_A15317,100,34,84,218,2022
2019_B15318,90,46,98,234,2019
2019_B15319,30,70,71,171,2019
2021_B15320,55,31,82,168,2021
2022_B15321,63,56,48,167,2022
2021_C15322,99,62,30,191,2021
2022_C15323,60,27,23,110,2022
2019_A15324,64,49,57,170,2019
2022_B15325,29,87,47,163,2022
2022_A15326,6,61,39,106,2022
2019_B15327,45,11,86,142,2019
2022_C15328,41,14,53,108,2022
2021_B15329,40,30,26,96,2021
2022_C15330,35,25,38,98,2022
2021_C15331,28,14,55,97,2021
2019_B15332,18,75,42,135,2019
2019_B15333,88,14,83,185,2019
2019_C15334,79,87,94,260,2019
2022_B15335,27,45,55,127,2022
2021_B15336,70,58,94,222,2021
2019_B15337,46,89,44,179,2019
2019_A15338,25,20,79,124,2019
2021_B15339,7,80,57,144,2021
2021_C15340,90,68,30,188,2021
2019_C15341,32,46,49,127,2019
2021_C15342,44,21,28,93,2021
2019_C15343,97,23,36,156,2019
2021_C15344,55,80,23,158,2021
2019_B15345,40,13,88,141,2019
2021_B15346,23,29,98,150,2021
2021_B15347,45,55,65,165,2021
2022_A15348,81,12,48,141,2022
2022_A15349,16,38,78,132,2022
2019_C15350,58,79,46,183,2019
2019_C15351,53,75,95,223,2019
2022_C15352,60,50,48,158,2022
2021_A15353,67,50,93,210,2021
2022_C15354,58,72,79,209,2022
2022_A15355,62,78,54,194,2022
2021_C15356,0,14,46,60,2021
2022_A15357,5,16,66,87,2022
2021_B15358,89,95,90,274,2021
2021_A15359,15,30,54,99,2021
2019_B15360,83,16,48,147,2019
2019_A15361,0,89,47,136,2019
2021_B15362,18,25,66,109,2021
2021_C15363,6,55,75,136,2021
2021_B15364,8,21,96,125,2021
2019_A15365,21,71,53,145,2019
2019_A15366,86,60,94,240,2019
2019_B15367,97,56,31,184,2019
2021_B15368,7,83,23,113,2021
2022_A15369,7,19,90,116,2022
2022_C15370,59,82,51,192,2022
2019_A15371,55,36,66,157,2019
2021_A15372,97,87,74,258,2021
2021_A15373,43,14,66,123,2021
2022_B15374,0,28,46,74,2022
2019_A15375,39,15,34,88,2019
2022_C15376,46,50,43,139,2022
2021_B15377,71,32,90,193,2021
2021_B15378,39,42,52,133,2021
2021_B15379,49,90,69,208,2021
2021_A15380,91,87,70,248,2021
2019_C15381,62,84,73,219,2019
2019_C15382,25,12,42,79,2019
2022_B15383,24,49,31,104,2022
2021_B15384,5,86,27,118,2021
2021_A15385,40,43,37,120,2021
2021_B15386,78,97,97,272,2021
2022_A15387,37,47,31,115,2022
2019_A15388,98,56,41,195,2019
2019_B15389,53,25,65,143,2019
2022_A15390,17,80,97,194,2022
2022_A15391,2,66,48,116,2022
2021_C15392,37,17,81,135,2021
2019_A15393,97,57,78,232,2019
2022_B15394,31,23,80,134,2022
2022_A15395,47,43,91,181,2022
2019_A15396,32,96,98,226,2019
2021_C15397,29,92,23,144,2021
2021_B15398,5,34,93,132,2021
2022_A15399,43,63,30,136,2022
2022_B15400,89,74,77,240,2022
2019_B15401,95,92,22,209,2019
2019_B15402,42,50,32,124,2019
2019_B15403,99,30,51,180,2019
2019_C15404,10,91,72,173,2019
2021_A15405,74,88,32,194,2021
2021_C15406,31,33,94,158,2021
2019_C15407,27,26,82,135,2019
2019_C15408,15,81,84,180,2019
2019_B15409,72,95,75,242,2019
2019_C15410,68,91,31,190,2019
2021_B15411,46,22,32,100,2021
2021_A15412,39,31,74,144,2021
2021_A15413,29,61,68,158,2021
2022_A15414,81,42,84,207,2022
2021_B15415,93,31,21,145,2021
2022_B15416,95,34,98,227,2022
2022_C15417,90,74,31,195,2022
2022_C15418,43,91,91,225,2022
2022_C15419,80,27,28,135,2022
2022_B15420,79,72,48,199,2022
2019_B15421,81,56,67,204,2019
2021_C15422,82,74,25,181,2021
2022_B15423,62,82,57,201,2022
2021_C15424,91,86,43,220,2021
2022_C15425,83,43,49,175,2022
2019_A15426,27,40,80,147,2019
2022_A15427,52,81,87,220,2022
2019_B15428,72,12,38,122,2019
2021_C15429,8,47,58,113,2021
2022_B15430,34,24,70,128,2022
2022_C15431,65,47,72,184,2022
2022_B15432,80,20,56,156,2022
2019_B15433,63,45,61,169,2019
2021_B15434,21,59,41,121,2021
2022_C15435,39,15,85,139,2022
2022_A15436,23,88,27,138,2022
2022_B15437,63,46,62,171,2022
2019_A15438,82,16,76,174,2019
2021_A15439,91,41,98,230,2021
2022_C15440,40,82,51,173,2022
2021_C15441,23,80,68,171,2021
2021_C15442,76,95,73,244,2021
2021_B15443,3,65,24,92,2021
2021_B15444,79,55,64,198,2021
2022_C15445,0,12,22,34,2022
2022_A15446,75,49,53,177,2022
2022_A15447,98,23,85,206,2022
2019_A15448,82,67,70,219,2019
2022_C15449,84,56,88,228,2022
2021_A15450,20,16,38,74,2021
2019_C15451,3,96,86,185,2019
2021_B15452,39,70,91,200,2021
2022_C15453,48,64,23,135,2022
2019_B15454,92,52,45,189,2019
2019_A15455,63,42,66,171,2019
2021_B15456,62,42,90,194,2021
2021_B15457,21,54,29,104,2021
2021_A15458,95,65,93,253,2021
2019_B15459,62,21,41,124,2019
2019_B15460,30,94,99,223,2019
2021_C15461,65,91,85,241,2021
2019_A15462,13,14,62,89,2019
2022_B15463,89,87,69,245,2022
2022_B15464,74,24,22,120,2022
2021_B15465,61,30,80,171,2021
2019_B15466,6,64,28,98,2019
2022_A15467,11,55,97,163,2022
2022_C15468,10,57,48,115,2022
2019_A15469,54,73,31,158,2019
2021_A15470,73,47,58,178,2021
2019_B15471,63,13,84,160,2019
2021_B15472,60,11,89,160,2021
2019_C15473,65,13,51,129,2019
2022_B15474,3,65,36,104,2022
2021_C15475,51,49,69,169,2021
2019_C15476,16,46,29,91,2019
2021_C15477,85,47,98,230,2021
2021_C15478,4,11,45,60,2021
2019_C15479,55,66,81,202,2019
2022_A15480,3,87,89,179,2022
2019_A15481,49,35,21,105,2019
2022_A15482,41,63,73,177,2022
2019_C15483,97,33,22,152,2019
2022_C15484,78,39,69,186,2022
2021_B15485,84,96,71,251,2021
2021_A15486,29,38,84,151,2021
2021_C15487,5,76,22,103,2021
2019_C15488,67,32,81,180,2019
2021_C15489,83,75,89,247,2021
2019_C15490,33,23,34,90,2019
2019_A15491,53,94,96,243,2019
2019_C15492,48,57,74,179,2019
2022_C15493,98,44,27,169,2022
2021_B15494,93,41,33,167,2021
2021_A15495,19,74,56,149,2021
2021_A15496,3,58,76,137,2021
2022_A15497,87,83,64,234,2022
2019_A15498,6,51,56,113,2019
2019_C15499,87,74,41,202,2019
2022_C15500,34,42,23,99,2022
2019_B15501,29,70,34,133,2019
2019_A15502,8,18,98,124,2019
2022_C15503,42,90,92,224,2022
2019_C15504,42,72,56,170,2019
2022_C15505,39,55,63,157,2022
2019_B15506,59,45,97,201,2019
2021_B15507,39,66,81,186,2021
2019_A15508,14,93,27,134,2019
2021_A15509,38,60,39,137,2021
2022_B15510,74,78,27,179,2022
2022_C15511,29,49,70,148,2022
2019_A15512,41,73,59,173,2019
2019_C15513,90,27,93,210,2019
2022_C15514,89,20,62,171,2022
2019_A15515,67,37,67,171,2019
2022_B15516,78,11,54,143,2022
2022_C15517,33,59,80,172,2022
2022_C15518,3,85,61,149,2022
2022_B15519,74,42,59,175,2022
2022_C15520,2,12,39,53,2022
2019_C15521,94,53,99,246,2019
2022_A15522,33,31,96,160,2022
2022_C15523,56,66,38,160,2022
2021_A15524,83,36,91,210,2021
2021_B15525,10,48,90,148,2021
2019_A15526,26,86,96,208,2019
2021_C15527,72,27,79,178,2021
2021_B15528,3,62,74,139,2021
2021_C15529,40,29,70,139,2021
2019_A15530,7,89,56,152,2019
2022_A15531,94,83,35,212,2022
2021_B15532,26,85,74,185,2021
2019_A15533,89,29,25,143,2019
2022_C15534,40,62,90,192,2022
2021_B15535,81,75,68,224,2021
2019_A15536,8,33,98,139,2019
2019_B15537,84,79,66,229,2019
2021_B15538,92,56,71,219,2021
2019_B15539,64,18,98,180,2019
2022_B15540,6,59,99,164,2022
2022_C15541,43,57,47,147,2022
2019_A15542,65,94,66,225,2019
2021_C15543,62,19,35,116,2021
2019_A15544,25,58,22,105,2019
2019_B15545,14,26,74,114,2019
2021_C15546,88,24,22,134,2021
2019_A15547,75,70,24,169,2019
2019_C15548,13,44,73,130,2019
2022_A15549,95,47,69,211,2022
2019_C15550,51,65,65,181,2019
2019_C15551,45,26,35,106,2019
2021_A15552,11,29,66,106,2021
2022_B15553,41,40,56,137,2022
2021_B15554,70,29,64,163,2021
2019_B15555,4,77,72,153,2019
2022_B15556,32,17,43,92,2022
2019_A15557,93,34,93,220,2019
2022_A15558,100,80,58,238,2022
2022_C15559,40,34,74,148,2022
2022_A15560,15,24,76,115,2022
2022_B15561,66,18,80,164,2022
2021_A15562,9,29,59,97,2021
2022_C15563,54,84,56,194,2022
2019_A15564,85,23,78,186,2019
2019_C15565,47,64,91,202,2019
2021_A15566,4,14,35,53,2021
2022_C15567,49,32,86,167,2022
2022_C15568,74,72,83,229,2022
2021_C15569,84,33,39,156,2021
2019_C15570,40,89,83,212,2019
2021_B15571,88,42,95,225,2021
2021_B15572,84,58,22,164,2021
2022_B15573,37,23,35,95,2022
2022_B15574,61,52,85,198,2022
2019_B15575,2,31,24,57,2019
2019_B15576,34,12,58,104,2019
2021_B15577,64,62,56,182,2021
2019_C15578,77,17,62,156,2019
2019_B15579,84,46,86,216,2019
2019_A15580,44,56,97,197,2019
2021_B15581,72,96,56,224,2021
2021_A15582,76,37,91,204,2021
2021_C15583,90,43,88,221,2021
2022_B15584,70,83,38,191,2022
2019_B15585,41,22,99,162,2019
2019_B15586,20,76,54,150,2019
2022_B15587,29,16,95,140,2022
2021_B15588,15,22,60,97,2021
2019_B15589,97,31,35,163,2019
2022_A15590,71,55,46,172,2022
2019_A15591,98,96,34,228,2019
2022_C15592,17,40,47,104,2022
2019_A15593,7,34,75,116,2019
2019_B15594,69,66,97,232,2019
2022_A15595,96,27,49,172,2022
2019_C15596,37,25,67,129,2019
2022_A15597,19,34,90,143,2022
2019_A15598,14,49,73,136,2019
2022_A15599,83,54,33,170,2022
2022_C15600,27,91,23,141,2022
2022_A15601,43,35,35,113,2022
2022_C15602,55,60,74,189,2022
2022_A15603,13,78,94,185,2022
2021_A15604,24,55,57,136,2021
2021_C15605,59,73,47,179,2021
2022_C15606,38,54,39,131,2022
2022_C15607,16,96,78,190,2022
2019_B15608,17,93,83,193,2019
2019_B15609,81,40,80,201,2019
2021_B15610,92,16,46,154,2021
2021_A15611,39,18,40,97,2021
2021_B15612,31,50,26,107,2021
2022_A15613,20,15,88,123,2022
2019_A15614,41,79,28,148,2019
2019_C15615,78,22,42,142,2019
2019_C15616,52,57,75,184,2019
2019_B15617,75,57,51,183,2019
2019_A15618,37,33,28,98,2019
2019_B15619,22,96,33,151,2019
2019_C15620,61,74,97,232,2019
2021_C15621,5,63,35,103,2021
2019_C15622,38,78,40,156,2019
2019_C15623,2,75,68,145,2019
2021_B15624,63,75,46,184,2021
2022_C15625,96,54,55,205,2022
2022_B15626,71,46,91,208,2022
2019_A15627,76,52,22,150,2019
2022_C15628,45,79,41,165,2022
2019_A15629,12,94,43,149,2019
2022_B15630,88,41,60,189,2022
2021_C15631,35,46,39,120,2021
2022_B15632,89,26,41,156,2022
2021_C15633,59,57,49,165,2021
2021_B15634,3,81,93,177,2021
2022_A15635,22,90,89,201,2022
2022_C15636,76,84,64,224,2022
2019_B15637,26,53,50,129,2019
2019_A15638,98,59,57,214,2019
2021_A15639,10,20,55,85,2021
2019_C15640,100,32,42,174,2019
2019_B15641,76,13,84,173,2019
2021_C15642,98,90,84,272,2021
2021_C15643,35,40,53,128,2021
2021_C15644,10,92,29,131,2021
2019_C15645,95,28,38,161,2019
2019_A15646,63,83,53,199,2019
2022_B15647,7,84,57,148,2022
2019_C15648,23,57,91,171,2019
2019_A15649,40,25,31,96,2019
2022_C15650,54,13,53,120,2022
2021_C15651,19,19,39,77,2021
2021_A15652,59,75,89,223,2021
2021_C15653,71,92,91,254,2021
2021_A15654,31,87,66,184,2021
2022_A15655,24,75,28,127,2022
2021_B15656,12,81,35,128,2021
2019_A15657,46,86,58,190,2019
2022_C15658,69,43,70,182,2022
2019_A15659,83,94,50,227,2019
2021_C15660,69,34,72,175,2021
2021_A15661,94,38,96,228,2021
2022_A15662,52,45,58,155,2022
2019_B15663,24,50,41,115,2019
2022_C15664,40,73,63,176,2022
2021_C15665,78,24,37,139,2021
2019_A15666,40,54,91,185,2019
2021_C15667,69,53,72,194,2021
2021_A15668,29,66,22,117,2021
2022_B15669,82,50,57,189,2022
2021_C15670,32,95,84,211,2021
2021_A15671,11,82,82,175,2021
2021_C15672,76,92,59,227,2021
2022_A15673,66,54,59,179,2022
2019_B15674,5,32,33,70,2019
2019_C15675,8,93,93,194,2019
2019_A15676,36,67,87,190,2019
2022_B15677,89,37,56,182,2022
2021_C15678,65,49,21,135,2021
2019_B15679,78,92,93,263,2019
2022_B15680,45,60,54,159,2022
2022_B15681,22,24,51,97,2022
2021_B15682,75,89,49,213,2021
2021_C15683,81,28,65,174,2021
2019_C15684,79,21,89,189,2019
2022_A15685,55,62,29,146,2022
2022_C15686,66,33,54,153,2022
2019_B15687,56,85,74,215,2019
2022_B15688,36,34,30,100,2022
2021_B15689,96,61,58,215,2021
2019_C15690,31,55,33,119,2019
2019_B15691,51,86,93,230,2019
2019_B15692,28,90,38,156,2019
2022_A15693,0,52,88,140,2022
2019_C15694,50,55,89,194,2019
2019_B15695,74,92,43,209,2019
2019_C15696,67,58,49,174,2019
2019_B15697,34,30,94,158,2019
2019_B15698,46,87,65,198,2019
2019_C15699,44,86,28,158,2019
2022_C15700,94,81,80,255,2022
2019_C15701,77,48,26,151,2019
2021_B15702,79,47,33,159,2021
2021_C15703,47,97,69,213,2021
2022_A15704,65,40,65,170,2022
2022_A15705,11,27,86,124,2022
2019_C15706,62,31,21,114,2019
2019_C15707,88,87,96,271,2019
2021_C15708,49,92,85,226,2021
2021_A15709,98,53,51,202,2021
2022_B15710,39,53,84,176,2022
2019_B15711,97,44,21,162,2019
2019_C15712,43,82,71,196,2019
2019_C15713,5,38,62,105,2019
2019_C15714,18,62,78,158,2019
2022_A15715,29,31,41,101,2022
2022_B15716,56,48,27,131,2022
2019_B15717,80,67,25,172,2019
2021_C15718,20,69,97,186,2021
2019_B15719,28,95,48,171,2019
2022_B15720,48,23,45,116,2022
2021_B15721,5,62,91,158,2021
2022_B15722,64,23,51,138,2022
2021_B15723,77,41,32,150,2021
2019_A15724,94,76,24,194,2019
2021_B15725,46,38,38,122,2021
2022_C15726,9,46,82,137,2022
2022_C15727,92,77,49,218,2022
2022_A15728,59,46,67,172,2022
2019_A15729,21,25,79,125,2019
2021_A15730,11,21,72,104,2021
2019_B15731,33,72,93,198,2019
2019_B15732,85,91,99,275,2019
2022_C15733,64,20,95,179,2022
2022_A15734,15,67,94,176,2022
2022_A15735,49,41,29,119,2022
2022_C15736,14,13,49,76,2022
2021_A15737,86,90,36,212,2021
2019_A15738,31,58,79,168,2019
2019_C15739,80,79,76,235,2019
2019_C15740,85,76,66,227,2019
2019_B15741,97,57,93,247,2019
2022_C15742,72,59,24,155,2022
2022_A15743,80,80,48,208,2022
2021_C15744,46,43,38,127,2021
2022_B15745,34,58,49,141,2022
2022_C15746,68,36,97,201,2022
2019_C15747,95,56,39,190,2019
2021_A15748,22,95,77,194,2021
2019_C15749,64,32,76,172,2019
2022_C15750,39,50,46,135,2022
2022_A15751,15,92,40,147,2022
2022_B15752,90,89,54,233,2022
2019_B15753,57,60,33,150,2019
2022_C15754,58,21,39,118,2022
2019_B15755,23,44,61,128,2019
2021_B15756,37,50,73,160,2021
2019_B15757,8,63,84,155,2019
2022_B15758,14,66,33,113,2022
2021_A15759,90,28,28,146,2021
2022_A15760,83,56,62,201,2022
2022_C15761,65,30,69,164,2022
2019_B15762,43,36,24,103,2019
2019_C15763,54,44,25,123,2019
2019_C15764,47,89,96,232,2019
2022_A15765,50,24,54,128,2022
2022_A15766,50,93,96,239,2022
2019_C15767,5,28,28,61,2019
2022_A15768,13,56,45,114,2022
2021_A15769,21,42,75,138,2021
2022_C15770,81,83,21,185,2022
2021_B15771,0,86,97,183,2021
2021_C15772,74,46,51,171,2021
2022_C15773,24,85,60,169,2022
2022_B15774,55,36,87,178,2022
2021_B15775,28,12,49,89,2021
2019_A15776,0,48,73,121,2019
2022_B15777,44,65,98,207,2022
2021_C15778,23,65,83,171,2021
2019_A15779,61,39,87,187,2019
2021_A15780,7,73,23,103,2021
2021_A15781,30,55,70,155,2021
2022_C15782,15,66,75,156,2022
2019_C15783,87,51,46,184,2019
2021_B15784,87,49,22,158,2021
2022_A15785,84,83,69,236,2022
2019_B15786,86,31,45,162,2019
2022_C15787,54,37,35,126,2022
2019_A15788,22,23,28,73,2019
2021_B15789,38,34,55,127,2021
2022_C15790,52,66,27,145,2022
2021_A15791,44,80,83,207,2021
2022_B15792,45,96,99,240,2022
2019_B15793,22,22,43,87,2019
2021_B15794,41,74,22,137,2021
2021_C15795,58,24,95,177,2021
2021_A15796,76,27,39,142,2021
2019_C15797,95,54,53,202,2019
2021_C15798,58,74,99,231,2021
2022_C15799,52,42,57,151,2022
2019_B15800,87,14,90,191,2019
2022_C15801,19,17,30,66,2022
2019_A15802,80,25,48,153,2019
2022_A15803,79,17,90,186,2022
2019_B15804,93,59,37,189,2019
2022_B15805,65,70,52,187,2022
2022_B15806,27,17,38,82,2022
2021_A15807,44,85,51,180,2021
2021_B15808,0,65,87,152,2021
2021_B15809,53,77,76,206,2021
2022_A15810,98,67,75,240,2022
2021_A15811,59,32,37,128,2021
2022_C15812,65,38,94,197,2022
2022_A15813,75,36,79,190,2022
2019_A15814,19,32,71,122,2019
2022_B15815,62,92,30,184,2022
2021_B15816,23,38,61,122,2021
2021_C15817,81,86,57,224,2021
2019_A15818,30,65,29,124,2019
2021_B15819,83,58,88,229,2021
2019_A15820,24,27,68,119,2019
2022_C15821,20,27,73,120,2022
2021_A15822,48,59,66,173,2021
2019_A15823,17,57,80,154,2019
2022_A15824,97,14,59,170,2022
2021_A15825,42,43,29,114,2021
2021_B15826,11,84,69,164,2021
2022_C15827,2,86,92,180,2022
2021_B15828,76,55,44,175,2021
2022_C15829,33,55,74,162,2022
2019_A15830,98,31,92,221,2019
2022_A15831,71,52,81,204,2022
2019_C15832,18,19,24,61,2019
2019_C15833,9,64,89,162,2019
2022_B15834,72,33,35,140,2022
2019_C15835,4,33,35,72,2019
2022_C15836,31,66,53,150,2022
2019_A15837,7,64,43,114,2019
2021_B15838,45,61,99,205,2021
2021_A15839,86,27,39,152,2021
2019_C15840,40,65,69,174,2019
2019_C15841,21,32,45,98,2019
2021_A15842,3,65,76,144,2021
2021_A15843,8,11,44,63,2021
2021_C15844,4,35,41,80,2021
2019_A15845,50,85,50,185,2019
2021_B15846,71,12,65,148,2021
2022_A15847,13,17,41,71,2022
2021_C15848,67,83,90,240,2021
2021_B15849,26,59,51,136,2021
2021_B15850,16,23,63,102,2021
2021_B15851,71,88,86,245,2021
2019_B15852,57,14,74,145,2019
2022_B15853,66,71,73,210,2022
2021_C15854,84,49,79,212,2021
2022_B15855,57,44,51,152,2022
2019_C15856,66,75,49,190,2019
2021_B15857,87,50,56,193,2021
2019_B15858,21,95,75,191,2019
2021_A15859,22,46,38,106,2021
2021_B15860,30,64,48,142,2021
2019_C15861,14,75,61,150,2019
2019_B15862,2,39,65,106,2019
2019_A15863,33,69,58,160,2019
2022_A15864,81,42,29,152,2022
2021_B15865,35,11,95,141,2021
2019_C15866,11,24,47,82,2019
2021_C15867,64,95,65,224,2021
2019_C15868,39,31,59,129,2019
2019_B15869,65,68,44,177,2019
2019_A15870,66,36,91,193,2019
2021_C15871,95,57,67,219,2021
2022_C15872,85,76,29,190,2022
2022_C15873,76,28,61,165,2022
2019_B15874,61,49,57,167,2019
2021_B15875,55,86,37,178,2021
2022_C15876,77,38,22,137,2022
2019_A15877,17,44,52,113,2019
2019_B15878,35,53,37,125,2019
2019_B15879,80,56,95,231,2019
2021_B15880,70,72,83,225,2021
2021_C15881,43,38,21,102,2021
2021_C15882,98,15,74,187,2021
2021_C15883,25,68,68,161,2021
2021_C15884,61,54,87,202,2021
2022_C15885,73,54,30,157,2022
2019_C15886,72,38,22,132,2019
2022_B15887,78,78,60,216,2022
2019_B15888,5,16,40,61,2019
2019_A15889,24,71,23,118,2019
2021_A15890,15,66,52,133,2021
2021_A15891,45,38,79,162,2021
2022_A15892,45,18,24,87,2022
2021_C15893,70,40,91,201,2021
2021_A15894,51,67,53,171,2021
2019_A15895,50,94,77,221,2019
2021_B15896,56,26,79,161,2021
2021_A15897,31,93,54,178,2021
2019_C15898,26,71,97,194,2019
2019_B15899,79,42,71,192,2019
2019_A15900,16,55,89,160,2019
2022_A15901,29,16,67,112,2022
2021_B15902,37,61,51,149,2021
2021_A15903,60,52,32,144,2021
2022_A15904,15,82,58,155,2022
2021_B15905,33,97,47,177,2021
2022_B15906,47,94,89,230,2022
2021_A15907,66,37,51,154,2021
2022_C15908,10,73,66,149,2022
2019_C15909,95,66,41,202,2019
2021_C15910,84,66,48,198,2021
2021_B15911,42,52,29,123,2021
2019_C15912,43,73,94,210,2019
2021_B15913,12,44,41,97,2021
2019_C15914,79,31,58,168,2019
2019_A15915,81,21,23,125,2019
2022_C15916,56,96,36,188,2022
2022_A15917,32,95,76,203,2022
2022_A15918,77,46,67,190,2022
2022_B15919,87,30,72,189,2022
2021_C15920,68,12,51,131,2021
2022_A15921,63,69,99,231,2022
2021_C15922,52,13,24,89,2021
2019_B15923,35,74,90,199,2019
2019_A15924,5,57,62,124,2019
2019_A15925,3,50,32,85,2019
2019_B15926,6,84,57,147,2019
2019_C15927,5,24,35,64,2019
2022_C15928,70,94,48,212,2022
2019_C15929,100,44,73,217,2019
2021_B15930,88,91,39,218,2021
2021_B15931,35,58,57,150,2021
2019_B15932,3,17,57,77,2019
2022_B15933,42,49,93,184,2022
2019_A15934,41,38,56,135,2019
2022_A15935,87,81,76,244,2022
2021_B15936,74,27,76,177,2021
2019_B15937,10,43,53,106,2019
2022_B15938,38,91,96,225,2022
2021_B15939,26,96,65,187,2021
2019_A15940,13,13,79,105,2019
2022_B15941,21,62,54,137,2022
2019_B15942,96,23,72,191,2019
2022_C15943,86,55,58,199,2022
2019_A15944,64,54,48,166,2019
2021_A15945,63,73,29,165,2021
2021_B15946,79,33,97,209,2021
2019_A15947,23,34,99,156,2019
2022_A15948,6,78,85,169,2022
2019_C15949,59,78,70,207,2019
2022_C15950,52,96,87,235,2022
2022_C15951,25,48,52,125,2022
2022_B15952,77,67,51,195,2022
2022_A15953,26,58,96,180,2022
2022_C15954,31,26,45,102,2022
2022_C15955,87,29,25,141,2022
2021_B15956,55,12,98,165,2021
2021_C15957,81,51,80,212,2021
2021_B15958,17,71,75,163,2021
2022_A15959,80,41,94,215,2022
2019_B15960,79,83,96,258,2019
2021_C15961,48,67,27,142,2021
2021_C15962,12,36,96,144,2021
2019_B15963,42,85,78,205,2019
2019_A15964,37,55,21,113,2019
2021_A15965,98,44,99,241,2021
2021_A15966,95,71,86,252,2021
2022_A15967,79,60,26,165,2022
2022_A15968,71,53,65,189,2022
2022_B15969,9,51,68,128,2022
2022_C15970,12,74,45,131,2022
2022_C15971,35,49,50,134,2022
2019_C15972,38,19,47,104,2019
2022_B15973,53,50,49,152,2022
2021_C15974,22,76,49,147,2021
2021_B15975,84,37,41,162,2021
2019_C15976,37,74,51,162,2019
2019_B15977,65,81,55,201,2019
2021_C15978,45,32,90,167,2021
2021_B15979,5,81,54,140,2021
2022_B15980,3,25,33,61,2022
2022_C15981,0,42,80,122,2022
2019_A15982,66,63,73,202,2019
2022_C15983,84,72,75,231,2022
2019_B15984,20,75,52,147,2019
2021_B15985,77,55,73,205,2021
2019_C15986,36,76,25,137,2019
2022_C15987,26,86,67,179,2022
2022_C15988,19,61,60,140,2022
2019_C15989,9,12,25,46,2019
2022_C15990,20,42,36,98,2022
2021_B15991,80,22,46,148,2021
2022_C15992,78,70,87,235,2022
2022_A15993,33,66,47,146,2022
2019_B15994,17,75,25,117,2019
2019_A15995,98,55,63,216,2019
2019_C15996,87,67,46,200,2019
2022_A15997,5,74,29,108,2022
2021_B15998,0,72,88,160,2021
2021_B15999,33,83,97,213,2021
2021_C16000,59,11,70,140,2021
2021_A16001,43,55,87,185,2021
2022_B16002,78,30,33,141,2022
2022_A16003,19,80,84,183,2022
2021_C16004,43,23,22,88,2021
2019_B16005,40,77,49,166,2019
2021_A16006,72,87,78,237,2021
2022_B16007,67,27,59,153,2022
2022_A16008,65,28,88,181,2022
2019_C16009,59,34,74,167,2019
2021_A16010,7,72,60,139,2021
2021_A16011,66,13,78,157,2021
2022_B16012,63,78,62,203,2022
2021_B16013,90,77,81,248,2021
2022_B16014,35,76,61,172,2022
2019_C16015,34,20,70,124,2019
2022_A16016,80,72,85,237,2022
2021_A16017,41,48,25,114,2021
2021_A16018,51,32,83,166,2021
2021_A16019,100,81,26,207,2021
2019_A16020,17,39,39,95,2019
2019_B16021,49,17,46,112,2019
2021_A16022,61,30,94,185,2021
2021_C16023,43,90,71,204,2021
2021_A16024,14,69,92,175,2021
2021_A16025,86,73,35,194,2021
2022_B16026,14,97,44,155,2022
2019_C16027,52,24,28,104,2019
2022_A16028,0,73,75,148,2022
2019_C16029,55,84,62,201,2019
2021_B16030,33,68,43,144,2021
2022_A16031,60,13,96,169,2022
2022_B16032,85,36,89,210,2022
2021_A16033,82,45,26,153,2021
2019_B16034,30,79,98,207,2019
2019_A16035,69,77,66,212,2019
2019_B16036,37,90,89,216,2019
2022_A16037,11,19,58,88,2022
2021_B16038,76,46,61,183,2021
2022_B16039,92,90,93,275,2022
2022_A16040,12,31,61,104,2022
2022_B16041,95,44,88,227,2022
2019_C16042,90,72,78,240,2019
2022_C16043,15,14,83,112,2022
2021_A16044,50,91,76,217,2021
2022_B16045,66,59,61,186,2022
2022_B16046,52,58,66,176,2022
2021_C16047,82,87,33,202,2021
2021_B16048,51,18,33,102,2021
2022_C16049,77,42,45,164,2022
2021_B16050,31,37,49,117,2021
2021_A16051,35,24,74,133,2021
2021_B16052,87,48,97,232,2021
2021_C16053,97,79,43,219,2021
2021_A16054,51,65,85,201,2021
2021_B16055,62,55,23,140,2021
2021_A16056,75,91,72,238,2021
2019_A16057,18,21,83,122,2019
2022_A16058,18,40,47,105,2022
2022_C16059,79,33,50,162,2022
2021_B16060,91,94,93,278,2021
2021_B16061,17,71,36,124,2021
2019_A16062,34,95,64,193,2019
2022_C16063,31,78,27,136,2022
2021_B16064,21,73,93,187,2021
2019_C16065,84,62,52,198,2019
2022_B16066,99,36,48,183,2022
2021_A16067,99,73,28,200,2021
2021_C16068,34,56,40,130,2021
2019_B16069,18,22,27,67,2019
2019_A16070,72,92,71,235,2019
2019_C16071,7,50,23,80,2019
2021_A16072,10,24,46,80,2021
2022_C16073,8,88,55,151,2022
2021_A16074,50,23,59,132,2021
2021_B16075,53,37,34,124,2021
2021_C16076,49,55,72,176,2021
2019_B16077,36,28,37,101,2019
2022_B16078,7,81,90,178,2022
2021_C16079,49,64,85,198,2021
2019_A16080,87,84,77,248,2019
2019_A16081,70,92,91,253,2019
2021_A16082,55,85,50,190,2021
2022_C16083,59,32,53,144,2022
2022_A16084,74,20,25,119,2022
2022_C16085,32,23,28,83,2022
2021_B16086,53,65,42,160,2021
2019_A16087,64,76,95,235,2019
2021_C16088,95,73,60,228,2021
2019_A16089,18,53,48,119,2019
2019_C16090,5,21,24,50,2019
2021_C16091,19,76,71,166,2021
2021_A16092,65,75,46,186,2021
2021_B16093,84,23,47,154,2021
2019_A16094,6,59,34,99,2019
2019_A16095,100,30,75,205,2019
2019_C16096,11,50,35,96,2019
2022_A16097,100,45,72,217,2022
2022_A16098,99,80,75,254,2022
2021_A16099,90,67,22,179,2021
2021_C16100,72,75,47,194,2021
2021_B16101,31,75,35,141,2021
2021_A16102,29,15,47,91,2021
2019_A16103,26,39,78,143,2019
2021_A16104,3,94,44,141,2021
2021_C16105,35,30,29,94,2021
2021_C16106,22,57,82,161,2021
2021_C16107,75,87,77,239,2021
2019_A16108,55,85,49,189,2019
2022_C16109,12,56,90,158,2022
2021_B16110,76,24,30,130,2021
2021_B16111,4,41,73,118,2021
2022_C16112,36,31,42,109,2022
2021_B16113,82,23,66,171,2021
2021_B16114,69,53,40,162,2021
2022_C16115,33,11,60,104,2022
2019_B16116,7,66,28,101,2019
2021_A16117,81,20,97,198,2021
2019_A16118,20,29,91,140,2019
2019_C16119,76,78,57,211,2019
2021_C16120,29,38,33,100,2021
2019_B16121,41,96,86,223,2019
2022_A16122,73,38,92,203,2022
2021_A16123,50,69,55,174,2021
2022_C16124,60,37,65,162,2022
2019_C16125,89,32,95,216,2019
2021_C16126,28,73,74,175,2021
2022_C16127,19,18,46,83,2022
2021_C16128,24,67,88,179,2021
2019_C16129,96,70,84,250,2019
2019_B16130,70,21,35,126,2019
2022_B16131,9,31,53,93,2022
2019_C16132,19,71,75,165,2019
2021_C16133,57,51,32,140,2021
2022_A16134,59,47,53,159,2022
2019_A16135,63,59,48,170,2019
2022_B16136,72,89,48,209,2022
2019_C16137,20,18,80,118,2019
2022_B16138,5,29,97,131,2022
2021_A16139,25,96,79,200,2021
2021_A16140,19,49,23,91,2021
2019_B16141,87,51,46,184,2019
2019_A16142,98,76,76,250,2019
2022_B16143,39,27,29,95,2022
2019_A16144,81,45,86,212,2019
2022_B16145,88,30,37,155,2022
2019_B16146,32,23,57,112,2019
2021_C16147,71,65,63,199,2021
2022_B16148,43,25,87,155,2022
2021_C16149,57,46,29,132,2021
2021_A16150,85,78,40,203,2021
2019_A16151,80,67,52,199,2019
2022_B16152,65,34,67,166,2022
2021_A16153,100,80,57,237,2021
2022_B16154,22,55,42,119,2022
2022_B16155,35,35,35,105,2022
2022_C16156,96,90,81,267,2022
2021_C16157,46,13,64,123,2021
2021_A16158,1,62,53,116,2021
2019_A16159,8,39,91,138,2019
2019_A16160,35,35,81,151,2019
2022_B16161,40,42,80,162,2022
2019_C16162,38,11,60,109,2019
2019_A16163,18,66,67,151,2019
2022_C16164,22,78,67,167,2022
2019_B16165,74,11,50,135,2019
2019_C16166,74,22,47,143,2019
2021_A16167,60,46,29,135,2021
2021_C16168,84,79,59,222,2021
2021_B16169,59,27,55,141,2021
2019_C16170,46,41,91,178,2019
2021_B16171,12,71,58,141,2021
2022_B16172,85,75,32,192,2022
2019_B16173,7,88,43,138,2019
2021_A16174,57,35,90,182,2021
2021_C16175,79,51,56,186,2021
2021_C16176,40,72,45,157,2021
2019_C16177,57,19,56,132,2019
2022_B16178,86,39,59,184,2022
2022_B16179,20,93,79,192,2022
2022_A16180,41,56,50,147,2022
2019_A16181,25,57,90,172,2019
2021_C16182,37,18,35,90,2021
2019_B16183,31,84,56,171,2019
2019_C16184,32,69,40,141,2019
2019_A16185,38,13,96,147,2019
2021_C16186,18,67,79,164,2021
2022_C16187,92,39,56,187,2022
2021_A16188,36,29,65,130,2021
2021_C16189,30,67,66,163,2021
2021_C16190,79,14,80,173,2021
2022_B16191,35,29,91,155,2022
2019_A16192,87,50,58,195,2019
2022_C16193,82,89,98,269,2022
2019_C16194,63,16,95,174,2019
2019_C16195,7,49,68,124,2019
2022_C16196,77,82,64,223,2022
2019_C16197,71,11,45,127,2019
2022_A16198,62,51,35,148,2022
2022_C16199,77,30,53,160,2022
2021_C16200,97,50,63,210,2021
2019_A16201,10,13,31,54,2019
2019_B16202,84,82,52,218,2019
2019_C16203,54,96,71,221,2019
2021_C16204,27,69,32,128,2021
2021_C16205,14,21,59,94,2021
2021_C16206,15,62,38,115,2021
2022_C16207,55,52,95,202,2022
2022_B16208,49,82,95,226,2022
2022_C16209,9,52,35,96,2022
2019_C16210,43,59,59,161,2019
2019_C16211,11,13,58,82,2019
2022_A16212,47,20,64,131,2022
2022_B16213,88,63,37,188,2022
2021_B16214,20,33,38,91,2021
2022_C16215,7,23,80,110,2022
2022_A16216,83,49,36,168,2022
2019_A16217,59,66,95,220,2019
2019_B16218,17,22,69,108,2019
2021_A16219,22,16,74,112,2021
2021_A16220,19,69,83,171,2021
2022_C16221,84,13,48,145,2022
2019_C16222,3,43,64,110,2019
2019_C16223,19,76,86,181,2019
2022_B16224,45,22,65,132,2022
2021_C16225,15,86,52,153,2021
2021_C16226,90,47,75,212,2021
2021_C16227,18,93,63,174,2021
2019_B16228,81,92,75,248,2019
2022_C16229,20,25,95,140,2022
2022_A16230,36,51,98,185,2022
2022_C16231,52,80,62,194,2022
2021_B16232,87,82,77,246,2021
2022_B16233,46,68,64,178,2022
2019_C16234,45,29,56,130,2019
2022_B16235,27,55,47,129,2022
2022_A16236,23,79,42,144,2022
2021_C16237,57,46,67,170,2021
2021_B16238,73,67,69,209,2021
2022_B16239,97,74,88,259,2022
2022_A16240,53,21,30,104,2022
2022_C16241,52,37,95,184,2022
2021_A16242,73,74,92,239,2021
2021_A16243,4,33,35,72,2021
2021_A16244,81,26,88,195,2021
2021_C16245,60,88,53,201,2021
2021_A16246,21,34,66,121,2021
2022_B16247,25,24,89,138,2022
2022_B16248,87,12,62,161,2022
2019_A16249,9,49,65,123,2019
2019_B16250,69,17,91,177,2019
2021_A16251,83,18,47,148,2021
2021_C17000,90,87,40,217,2021
2022_A17001,96,71,54,221,2022
2021_B17002,91,55,36,182,2021
2019_A17003,72,81,56,209,2019
2022_B17004,91,96,76,263,2022
2021_B17005,79,80,68,227,2021
2022_B17006,74,56,55,185,2022
2019_C17007,79,68,46,193,2019
2019_A17008,74,92,77,243,2019
2019_A17009,82,93,71,246,2019
2022_B17010,88,63,58,209,2022
2019_B17011,93,79,43,215,2019
2022_A17012,94,85,45,224,2022
2021_B17013,84,82,76,242,2021
2019_B17014,87,57,40,184,2019
2022_B17015,87,61,62,210,2022
2021_A17016,83,84,53,220,2021
2022_A17017,80,57,61,198,2022
2019_B17018,72,53,40,165,2019
2022_C17019,76,85,37,198,2022
2021_A17020,96,46,54,196,2021
2021_C17021,95,69,69,233,2021
2021_C17022,90,93,78,261,2021
2022_A17023,76,75,71,222,2022
2022_A17024,76,82,75,233,2022
2021_B17025,86,61,49,196,2021
2022_C17026,88,59,51,198,2022
2021_C17027,97,92,44,233,2021
2022_A17028,96,66,66,228,2022
2019_A17029,83,55,52,190,2019
2022_A17030,87,45,79,211,2022
2019_B17031,77,85,71,233,2019
2022_A17032,95,85,66,246,2022
2019_A17033,82,82,44,208,2019
2022_A17034,77,54,64,195,2022
2022_B17035,93,85,55,233,2022
2021_C17036,73,47,73,193,2021
2022_A17037,95,47,35,177,2022
2019_B17038,84,67,40,191,2019
2021_C17039,95,81,48,224,2021
2021_A17040,95,64,69,228,2021
2021_A17041,84,62,42,188,2021
2022_A17042,80,80,69,229,2022
2022_B17043,85,79,54,218,2022
2021_C17044,93,69,44,206,2021
2019_C17045,97,72,74,243,2019
2019_C17046,83,61,37,181,2019
2022_C17047,82,75,35,192,2022
2022_B17048,71,59,52,182,2022
2022_B17049,86,82,72,240,2022
2022_B17050,76,56,62,194,2022
2022_A17051,78,90,63,231,2022
2021_A17052,72,58,70,200,2021
2019_C17053,76,47,73,196,2019
2022_C17054,72,82,78,232,2022
2022_B17055,71,45,60,176,2022
2022_C17056,82,50,70,202,2022
2021_C17057,97,87,77,261,2021
2021_C17058,75,69,38,182,2021
2019_B17059,85,55,78,218,2019
2019_C17060,85,50,47,182,2019
2022_C17061,87,61,53,201,2022
2022_A17062,93,47,50,190,2022
2021_C17063,82,87,35,204,2021
2022_B17064,90,50,57,197,2022
2021_A17065,77,77,52,206,2021
2019_C17066,81,82,50,213,2019
2019_B17067,85,68,36,189,2019
2022_C17068,73,45,48,166,2022
2021_A17069,94,87,37,218,2021
2019_C17070,83,56,55,194,2019
2021_C17071,82,45,71,198,2021
2019_A17072,80,50,42,172,2019
2021_C17073,93,90,36,219,2021
2021_B17074,90,67,71,228,2021
2021_B17075,84,90,79,253,2021
2022_C17076,73,82,46,201,2022
2019_B17077,74,94,55,223,2019
2019_B17078,91,89,71,251,2019
2022_A17079,73,60,46,179,2022
2019_C17080,83,50,41,174,2019
2019_A17081,90,86,46,222,2019
2021_C17082,79,83,36,198,2021
2019_B17083,72,70,35,177,2019
2019_C17084,84,95,56,235,2019
2021_B17085,94,80,59,233,2021
2021_A17086,92,66,62,220,2021
2021_C17087,91,51,48,190,2021
2019_B17088,83,78,53,214,2019
2022_A17089,93,82,66,241,2022
2022_B17090,96,70,66,232,2022
2021_A17091,88,56,62,206,2021
2019_A17092,86,73,36,195,2019
2021_B17093,81,90,39,210,2021
2022_C17094,93,81,52,226,2022
2022_B17095,78,93,78,249,2022
2022_A17096,80,93,39,212,2022
2021_A17097,87,77,54,218,2021
2019_C17098,86,70,69,225,2019
2019_C17099,72,84,68,224,2019
2021_B17100,94,46,71,211,2021
2019_C17101,92,87,46,225,2019
2021_B17102,75,78,53,206,2021
2021_A17103,77,96,74,247,2021
2022_A17104,74,91,39,204,2022
2021_A17105,94,71,78,243,2021
2019_C17106,84,51,68,203,2019
2021_C17107,72,95,59,226,2021
2019_A17108,71,52,35,158,2019
2019_A17109,85,64,56,205,2019
2021_A17110,84,81,65,230,2021
2021_A17111,73,80,57,210,2021
2021_C17112,73,91,68,232,2021
2021_C17113,72,52,69,193,2021
2019_C17114,87,88,59,234,2019
2022_C17115,83,64,41,188,2022
2022_A17116,74,64,67,205,2022
2019_A17117,79,77,58,214,2019
2022_A17118,72,85,66,223,2022
2021_C17119,97,74,46,217,2021
2021_A17120,82,88,62,232,2021
2022_B17121,91,58,58,207,2022
2019_A17122,86,85,60,231,2019
2022_A17123,83,46,45,174,2022
2022_B17124,88,56,78,222,2022
2019_B17125,76,96,51,223,2019
2021_A17126,73,57,62,192,2021
2022_B17127,77,63,54,194,2022
2022_B17128,94,68,61,223,2022
2021_A17129,75,52,39,166,2021
2021_B17130,80,78,40,198,2021
2022_C17131,97,70,49,216,2022
2019_B17132,95,77,45,217,2019
2019_A17133,74,61,48,183,2019
2021_A17134,77,80,52,209,2021
2022_A17135,93,83,61,237,2022
2022_A17136,80,83,52,215,2022
2022_C17137,86,96,58,240,2022
2019_C17138,86,63,59,208,2019
2022_A17139,71,84,68,223,2022
2021_B17140,89,69,60,218,2021
2019_C17141,77,59,63,199,2019
2022_B17142,79,84,68,231,2022
2021_C17143,79,91,62,232,2021
2019_A17144,80,55,76,211,2019
2022_A17145,94,90,72,256,2022
2021_C17146,76,75,55,206,2021
2019_B17147,97,87,49,233,2019
2019_A17148,83,74,65,222,2019
2019_C17149,76,58,48,182,2019
2019_C17150,96,85,46,227,2019
2022_C17151,96,58,75,229,2022
2019_C17152,83,95,72,250,2019
2019_C17153,89,77,55,221,2019
2022_B17154,73,62,56,191,2022
2019_C17155,83,62,75,220,2019
2021_B17156,75,93,58,226,2021
2021_C17157,97,79,54,230,2021
2021_A17158,76,75,73,224,2021
2021_A17159,81,93,61,235,2021
2022_C17160,93,48,75,216,2022
2019_A17161,94,82,70,246,2019
2022_C17162,97,62,46,205,2022
2019_C17163,75,89,41,205,2019
2022_C17164,73,59,67,199,2022
2019_B17165,93,95,75,263,2019
2021_B17166,93,55,35,183,2021
2022_B17167,90,88,68,246,2022
2019_C17168,72,48,54,174,2019
2021_A17169,71,91,48,210,2021
2022_B17170,84,66,52,202,2022
2022_C17171,84,57,57,198,2022
2019_C17172,71,64,58,193,2019
2019_C17173,80,70,73,223,2019
2022_C17174,81,62,43,186,2022
2021_A17175,90,46,61,197,2021
2019_C17176,72,54,56,182,2019
2021_B17177,92,85,44,221,2021
2021_C17178,77,45,47,169,2021
2019_C17179,84,76,53,213,2019
2019_A17180,81,77,37,195,2019
2021_C17181,78,74,77,229,2021
2022_B17182,75,47,61,183,2022
2019_B17183,84,73,78,235,2019
2021_C17184,92,68,71,231,2021
2019_B17185,72,62,48,182,2019
2022_A17186,73,81,55,209,2022
2021_B17187,83,67,64,214,2021
2021_A17188,84,67,43,194,2021
2021_B17189,96,50,39,185,2021
2021_C17190,85,90,77,252,2021
2022_B17191,85,81,48,214,2022
2019_C17192,85,63,37,185,2019
2022_A17193,82,47,57,186,2022
2021_B17194,85,85,72,242,2021
2019_B17195,96,91,73,260,2019
2019_C17196,90,57,60,207,2019
2019_C17197,82,62,59,203,2019
2021_A17198,80,64,77,221,2021
2019_B17199,96,83,63,242,2019
2022_B17200,83,91,72,246,2022
2019_B17201,96,94,44,234,2019
2019_B17202,92,73,71,236,2019
2021_A17203,96,55,67,218,2021
2021_C17204,81,83,51,215,2021
2019_A17205,88,85,38,211,2019
2022_A17206,82,51,46,179,2022
2021_C17207,79,56,51,186,2021
2021_C17208,78,72,73,223,2021
2021_C17209,94,91,41,226,2021
2019_B17210,95,47,47,189,2019
2021_B17211,86,77,60,223,2021
2019_A17212,88,85,78,251,2019
2021_C17213,77,87,35,199,2021
2022_B17214,88,60,74,222,2022
2022_C17215,82,64,73,219,2022
2021_B17216,77,52,72,201,2021
2022_C17217,86,62,39,187,2022
2019_B17218,81,63,55,199,2019
2021_B17219,91,96,69,256,2021
2019_C17220,89,89,76,254,2019
2022_B17221,78,74,35,187,2022
2019_C17222,76,61,42,179,2019
2019_A17223,81,56,56,193,2019
2022_C17224,93,78,44,215,2022
2022_A17225,82,88,54,224,2022
2022_C17226,83,86,39,208,2022
2022_C17227,88,75,55,218,2022
2019_B17228,78,73,49,200,2019
2019_B17229,77,73,35,185,2019
2019_C17230,95,56,46,197,2019
2021_A17231,74,63,35,172,2021
2019_B17232,94,76,73,243,2019
2021_A17233,86,65,37,188,2021
2022_B17234,71,79,72,222,2022
2022_C17235,85,92,74,251,2022
2021_B17236,74,64,35,173,2021
2021_A17237,93,82,50,225,2021
2021_C17238,97,63,42,202,2021
2022_A17239,71,54,60,185,2022
2019_C17240,95,96,37,228,2019
2022_C17241,91,88,73,252,2022
2019_C17242,88,59,64,211,2019
2019_A17243,86,45,70,201,2019
2021_C17244,93,55,76,224,2021
2019_B17245,82,71,35,188,2019
2022_C17246,73,75,57,205,2022
2022_B17247,71,79,56,206,2022
2019_A17248,95,64,71,230,2019
2021_B17249,95,52,69,216,2021
2022_B17250,86,74,41,201,2022
2019_B17251,87,85,68,240,2019
2022_C17252,86,82,60,228,2022
2021_C17253,74,70,72,216,2021
2022_C17254,74,49,69,192,2022
2019_A17255,95,53,59,207,2019
2019_C17256,96,94,69,259,2019
2022_A17257,73,86,65,224,2022
2022_B17258,75,61,49,185,2022
2022_B17259,78,59,56,193,2022
2019_C17260,96,49,66,211,2019
2019_A17261,97,88,63,248,2019
2022_A17262,75,58,67,200,2022
2019_C17263,79,55,54,188,2019
2021_A17264,75,45,57,177,2021
2021_B17265,94,91,44,229,2021
2022_B17266,91,73,73,237,2022
2021_A17267,85,92,77,254,2021
2021_C17268,94,65,52,211,2021
2019_B17269,85,45,79,209,2019
2019_A17270,84,59,67,210,2019
2021_C17271,83,72,52,207,2021
2021_C17272,78,80,61,219,2021
2019_A17273,90,68,60,218,2019
2019_A17274,96,58,45,199,2019
2019_C17275,88,82,72,242,2019
2019_C17276,77,74,57,208,2019
2022_A17277,73,64,44,181,2022
2022_C17278,72,53,40,165,2022
2019_C17279,82,73,65,220,2019
2021_B17280,75,54,42,171,2021
2021_A17281,86,78,44,208,2021
2021_C17282,80,80,64,224,2021
2022_C17283,74,88,78,240,2022
2022_A17284,74,63,56,193,2022
2022_B17285,86,48,68,202,2022
2019_A17286,93,80,70,243,2019
2019_C17287,73,78,68,219,2019
2021_C17288,86,45,44,175,2021
2019_B17289,76,56,38,170,2019
2021_C17290,87,89,76,252,2021
2021_B17291,85,96,53,234,2021
2022_C17292,84,54,40,178,2022
2019_B17293,81,68,53,202,2019
2019_B17294,79,96,65,240,2019
2021_C17295,84,96,73,253,2021
2022_B17296,71,73,52,196,2022
2021_A17297,79,46,74,199,2021
2022_B17298,71,52,45,168,2022
2021_C17299,96,47,35,178,2021
2021_A17300,86,84,48,218,2021
2021_B17301,82,95,47,224,2021
2022_B17302,79,84,72,235,2022
2022_C17303,80,79,61,220,2022
2021_C17304,95,63,72,230,2021
2019_A17305,75,62,50,187,2019
2019_C17306,88,71,69,228,2019
2019_C17307,81,67,40,188,2019
2022_C17308,80,96,67,243,2022
2019_C17309,95,74,50,219,2019
2022_A17310,91,61,61,213,2022
2021_C17311,88,76,66,230,2021
2019_A17312,76,90,62,228,2019
2022_C17313,80,94,76,250,2022
2022_B17314,79,52,44,175,2022
2019_A17315,97,86,64,247,2019
2021_B17316,80,70,35,185,2021
2021_B17317,95,78,35,208,2021
2019_A17318,76,78,73,227,2019
2021_C17319,89,58,40,187,2021
2021_C17320,91,78,63,232,2021
2022_B17321,87,79,35,201,2022
2022_A17322,72,56,64,192,2022
2021_B17323,73,72,67,212,2021
2019_C17324,83,47,51,181,2019
2019_A17325,75,54,45,174,2019
2022_C17326,80,80,48,208,2022
2022_B17327,89,73,76,238,2022
2022_A17328,75,89,43,207,2022
2019_C17329,82,84,61,227,2019
2021_C17330,90,63,65,218,2021
2022_C17331,80,80,74,234,2022
2021_A17332,78,68,79,225,2021
2022_C17333,75,59,47,181,2022
2022_B17334,78,85,48,211,2022
2019_B17335,90,72,65,227,2019
2021_C17336,89,80,57,226,2021
2022_B17337,75,53,52,180,2022
2019_B17338,94,55,64,213,2019
2019_C17339,87,51,45,183,2019
2022_B17340,95,68,55,218,2022
2022_C17341,97,83,54,234,2022
2019_A17342,71,94,52,217,2019
2021_A17343,80,86,57,223,2021
2021_C17344,74,77,41,192,2021
2022_A17345,93,46,39,178,2022
2021_C17346,95,55,66,216,2021
2021_A17347,76,55,67,198,2021
2019_C17348,84,48,35,167,2019
2019_C17349,72,45,43,160,2019
2021_B17350,91,92,71,254,2021
2019_C17351,73,95,78,246,2019
2019_B17352,80,68,66,214,2019
2019_A17353,72,90,60,222,2019
2021_B17354,82,48,70,200,2021
2021_A17355,92,62,64,218,2021
2021_A17356,78,69,58,205,2021
2021_B17357,80,73,50,203,2021
2022_C17358,83,47,70,200,2022
2021_A17359,78,64,61,203,2021
2019_B17360,74,96,51,221,2019
2019_B17361,93,65,77,235,2019
2019_C17362,79,51,35,165,2019
2019_A17363,87,92,53,232,2019
2019_B17364,86,64,49,199,2019
2019_B17365,97,68,36,201,2019
2022_C17366,75,91,76,242,2022
2021_A17367,82,86,72,240,2021
2021_A17368,85,47,40,172,2021
2019_B17369,80,76,36,192,2019
2022_A17370,86,68,75,229,2022
2021_B17371,89,59,71,219,2021
2021_A17372,71,45,49,165,2021
2021_C17373,75,71,47,193,2021
2019_B17374,86,71,60,217,2019
2022_C17375,74,65,65,204,2022
2021_A17376,91,45,49,185,2021
2021_B17377,96,95,42,233,2021
2019_B17378,82,55,51,188,2019
2022_C17379,78,47,72,197,2022
2021_B17380,86,69,45,200,2021
2021_A17381,77,68,56,201,2021
2022_C17382,83,94,56,233,2022
2021_C17383,83,47,68,198,2021
2019_B17384,75,86,39,200,2019
2021_A17385,93,65,61,219,2021
2021_B17386,73,84,44,201,2021
2022_A17387,79,74,45,198,2022
2022_B17388,79,85,74,238,2022
2021_B17389,87,54,67,208,2021
2019_A17390,83,70,50,203,2019
2021_C17391,83,96,45,224,2021
2022_C17392,87,63,75,225,2022
2022_C17393,76,78,63,217,2022
2021_C17394,83,78,66,227,2021
2022_C17395,96,47,48,191,2022
2019_B17396,82,80,56,218,2019
2022_C17397,80,49,39,168,2022
2022_C17398,77,45,63,185,2022
2019_C17399,76,84,74,234,2019
2022_C17400,85,87,58,230,2022
2019_C17401,80,56,37,173,2019
2021_C17402,72,45,49,166,2021
2019_C17403,78,72,73,223,2019
2021_B17404,84,79,51,214,2021
2019_B17405,91,83,60,234,2019
2019_A17406,80,79,48,207,2019
2021_C17407,94,75,47,216,2021
2019_A17408,87,48,57,192,2019
2019_A17409,85,51,58,194,2019
2021_C17410,78,63,40,181,2021
2021_A17411,82,87,79,248,2021
2019_B17412,90,49,70,209,2019
2022_C17413,88,60,77,225,2022
2022_C17414,89,81,58,228,2022
2021_B17415,89,93,40,222,2021
2019_C17416,88,73,38,199,2019
2022_B17417,71,96,47,214,2022
2022_A17418,71,65,63,199,2022
2019_C17419,96,80,46,222,2019
2021_C17420,88,83,46,217,2021
2022_A17421,85,72,78,235,2022
2022_B17422,93,50,44,187,2022
2021_A17423,80,79,59,218,2021
2019_A17424,74,75,69,218,2019
2019_A17425,80,54,51,185,2019
2022_C17426,94,80,62,236,2022
2022_B17427,74,68,59,201,2022
2022_A17428,85,63,62,210,2022
2022_B17429,91,69,61,221,2022
2019_C17430,76,85,45,206,2019
2022_A17431,95,50,37,182,2022
2022_A17432,89,47,58,194,2022
2019_B17433,71,61,76,208,2019
2022_C17434,77,55,74,206,2022
2022_A17435,76,69,45,190,2022
2022_B17436,77,53,38,168,2022
2022_C17437,90,47,35,172,2022
2019_A17438,79,90,56,225,2019
2021_B17439,89,86,54,229,2021
2022_C17440,97,61,77,235,2022
2021_A17441,90,69,50,209,2021
2019_B17442,74,46,77,197,2019
2022_C17443,86,48,46,180,2022
2022_A17444,93,58,75,226,2022
2021_B17445,89,93,38,220,2021
2021_C17446,71,69,60,200,2021
2022_A17447,76,61,71,208,2022
2019_A17448,81,95,77,253,2019
2022_B17449,90,81,76,247,2022
2019_C17450,97,70,68,235,2019
2021_C17451,72,92,54,218,2021
2022_C17452,93,61,51,205,2022
2021_A17453,80,58,63,201,2021
2019_A17454,85,66,69,220,2019
2022_A17455,84,75,47,206,2022
2021_A17456,82,63,45,190,2021
2021_B17457,80,62,39,181,2021
2022_A17458,93,49,47,189,2022
2019_C17459,80,54,62,196,2019
2021_A17460,96,90,38,224,2021
2022_A17461,78,82,44,204,2022
2019_A17462,93,73,71,237,2019
2019_A17463,96,93,68,257,2019
2022_B17464,78,86,41,205,2022
2021_A17465,72,55,52,179,2021
2022_B17466,76,70,59,205,2022
2019_C17467,86,48,61,195,2019
2021_C17468,76,85,75,236,2021
2019_C17469,83,54,58,195,2019
2021_B17470,87,85,69,241,2021
2022_B17471,97,56,53,206,2022
2021_A17472,89,48,58,195,2021
2021_B17473,73,45,67,185,2021
2019_B17474,97,76,38,211,2019
2022_C17475,92,94,51,237,2022
2019_C17476,91,79,77,247,2019
2022_A17477,87,96,73,256,2022
2022_A17478,79,71,35,185,2022
2019_B17479,81,58,40,179,2019
2019_B17480,86,84,57,227,2019
2019_A17481,75,80,70,225,2019
2019_A17482,74,90,52,216,2019
2021_A17483,97,53,74,224,2021
2019_A17484,93,49,36,178,2019
2022_C17485,96,69,76,241,2022
2019_C17486,80,79,36,195,2019
2019_A17487,96,73,62,231,2019
2021_A17488,76,94,36,206,2021
2022_C17489,73,75,55,203,2022
2019_C17490,93,94,75,262,2019
2021_B17491,84,54,44,182,2021
2021_A17492,93,54,61,208,2021
2022_C17493,89,74,45,208,2022
2021_B17494,90,81,58,229,2021
2022_A17495,74,61,35,170,2022
2022_A17496,95,94,65,254,2022
2021_C17497,79,46,71,196,2021
2021_C17498,92,55,47,194,2021
2021_A17499,89,84,36,209,2021
2021_A17500,92,50,39,181,2021
2022_A17501,97,48,65,210,2022
2019_B17502,81,67,63,211,2019
2019_C17503,72,75,44,191,2019
2022_C17504,79,79,77,235,2022
2021_B17505,92,82,38,212,2021
2019_C17506,82,87,65,234,2019
2022_A17507,75,56,48,179,2022
2021_B17508,95,70,48,213,2021
2021_B17509,83,81,66,230,2021
2022_C17510,89,66,71,226,2022
2021_A17511,78,86,48,212,2021
2019_C17512,96,94,54,244,2019
2022_C17513,86,79,56,221,2022
2019_A17514,76,53,61,190,2019
2019_B17515,76,85,74,235,2019
2021_C17516,83,65,51,199,2021
2019_C17517,88,66,72,226,2019
2021_C17518,97,88,53,238,2021
2021_B17519,96,81,65,242,2021
2022_C17520,85,53,63,201,2022
2022_C17521,81,78,78,237,2022
2019_A17522,94,67,60,221,2019
2022_C17523,97,91,44,232,2022
2021_C17524,88,89,62,239,2021
2021_B17525,92,88,65,245,2021
2019_C17526,73,77,59,209,2019
2019_A17527,73,81,59,213,2019
2019_B17528,75,87,36,198,2019
2021_A17529,81,82,36,199,2021
2019_C17530,86,79,78,243,2019
2022_A17531,87,48,64,199,2022
2021_B17532,84,86,69,239,2021
2021_A17533,85,88,39,212,2021
2019_A17534,93,71,72,236,2019
2021_B17535,95,57,59,211,2021
2022_C17536,73,79,79,231,2022
2019_B17537,76,83,73,232,2019
2021_C17538,75,67,38,180,2021
2019_B17539,96,47,65,208,2019
2019_A17540,97,69,51,217,2019
2019_B17541,96,70,49,215,2019
2022_A17542,76,47,37,160,2022
2019_B17543,80,46,38,164,2019
2022_C17544,92,52,43,187,2022
2022_A17545,74,47,66,187,2022
2019_A17546,76,54,65,195,2019
2022_C17547,71,94,79,244,2022
2019_A17548,93,76,41,210,2019
2022_C17549,77,68,78,223,2022
2021_B17550,83,81,69,233,2021
2021_A17551,86,51,60,197,2021
2022_B17552,77,60,79,216,2022
2022_C17553,93,65,47,205,2022
2019_B17554,82,62,57,201,2019
2022_B17555,75,48,35,158,2022
2021_B17556,79,87,51,217,2021
2022_C17557,86,96,75,257,2022
2021_A17558,91,86,73,250,2021
2019_B17559,73,85,72,230,2019
2022_A17560,84,51,50,185,2022
2019_A17561,85,82,55,222,2019
2021_B17562,89,58,51,198,2021
2022_A17563,93,87,62,242,2022
2021_A17564,79,48,39,166,2021
2022_B17565,82,72,78,232,2022
2021_C17566,89,86,69,244,2021
2022_C17567,72,53,75,200,2022
2019_C17568,81,77,79,237,2019
2019_B17569,95,48,71,214,2019
2019_A17570,75,96,49,220,2019
2022_A17571,96,83,61,240,2022
2022_C17572,78,82,63,223,2022
2019_C17573,79,91,65,235,2019
2019_B17574,81,80,59,220,2019
2019_A17575,75,80,70,225,2019
2022_A17576,78,93,79,250,2022
2019_B17577,89,70,63,222,2019
2019_B17578,73,59,46,178,2019
2019_B17579,80,49,67,196,2019
2022_C17580,86,54,43,183,2022
2019_A17581,96,83,55,234,2019
2021_B17582,82,53,54,189,2021
2022_B17583,80,86,76,242,2022
2021_A17584,81,87,67,235,2021
2019_A17585,88,60,71,219,2019
2021_C17586,92,84,74,250,2021
2021_A17587,76,69,60,205,2021
2022_B17588,96,86,43,225,2022
2019_A17589,91,62,48,201,2019
2021_B17590,89,82,77,248,2021
2021_B17591,91,83,56,230,2021
2021_A17592,94,51,51,196,2021
2022_C17593,88,50,56,194,2022
2021_A17594,95,46,72,213,2021
2022_A17595,89,92,41,222,2022
2022_B17596,83,72,53,208,2022
2022_A17597,91,56,37,184,2022
2019_B17598,72,77,69,218,2019
2021_A17599,93,78,79,250,2021
2022_B17600,77,52,57,186,2022
2021_B17601,91,83,39,213,2021
2022_C17602,95,80,74,249,2022
2019_A17603,79,87,58,224,2019
2019_B17604,74,79,70,223,2019
2022_C17605,76,90,69,235,2022
2019_B17606,72,92,67,231,2019
2019_C17607,84,46,73,203,2019
2019_B17608,76,78,73,227,2019
2022_C17609,88,56,56,200,2022
2021_C17610,91,66,69,226,2021
2021_C17611,96,77,56,229,2021
2019_B17612,76,92,71,239,2019
2019_C17613,83,68,58,209,2019
2021_A17614,91,47,61,199,2021
2021_A17615,86,82,52,220,2021
2022_C17616,80,63,73,216,2022
2022_C17617,96,60,48,204,2022
2022_A17618,85,69,70,224,2022
2022_B17619,76,52,63,191,2022
2022_A17620,91,89,74,254,2022
2019_A17621,83,62,42,187,2019
2019_A17622,93,63,76,232,2019
2022_B17623,72,88,46,206,2022
2021_C17624,73,83,56,212,2021
2021_A17625,87,46,79,212,2021
2021_C17626,78,68,44,190,2021
2021_C17627,76,94,38,208,2021
2022_C17628,86,54,64,204,2022
2021_C17629,83,45,55,183,2021
2022_C17630,78,84,73,235,2022
2019_A17631,87,64,62,213,2019
2022_A17632,92,69,68,229,2022
2021_A17633,90,57,72,219,2021
2022_C17634,91,56,62,209,2022
2021_A17635,73,92,37,202,2021
2021_C17636,88,71,75,234,2021
2019_C17637,87,88,63,238,2019
2022_A17638,93,50,51,194,2022
2021_B17639,71,76,43,190,2021
2019_B17640,76,93,48,217,2019
2019_C17641,85,92,41,218,2019
2021_C17642,71,47,41,159,2021
2022_A17643,83,64,76,223,2022
2019_A17644,78,84,79,241,2019
2021_B17645,87,47,56,190,2021
2019_A17646,73,74,47,194,2019
2022_A17647,87,82,38,207,2022
2019_A17648,90,94,47,231,2019
2021_C17649,80,92,41,213,2021
2022_B17650,94,58,44,196,2022
2021_A17651,74,85,59,218,2021
2019_B17652,97,88,42,227,2019
2019_A17653,92,96,43,231,2019
2019_C17654,94,46,38,178,2019
2019_C17655,74,95,75,244,2019
2019_A17656,83,61,50,194,2019
2021_C17657,75,88,74,237,2021
2022_B17658,87,64,51,202,2022
2022_B17659,94,86,51,231,2022
2022_B17660,71,85,60,216,2022
2021_B17661,80,83,58,221,2021
2022_A17662,71,66,72,209,2022
2021_A17663,78,78,41,197,2021
2022_B17664,83,60,54,197,2022
2021_A17665,74,96,61,231,2021
2021_A17666,77,78,47,202,2021
2021_B17667,72,84,60,216,2021
2022_A17668,90,63,44,197,2022
2022_A17669,83,60,52,195,2022
2019_C17670,96,93,51,240,2019
2021_C17671,75,86,70,231,2021
2019_B17672,93,70,57,220,2019
2021_A17673,91,58,44,193,2021
2019_B17674,81,45,68,194,2019
2019_A17675,75,46,45,166,2019
2022_A17676,85,85,44,214,2022
2022_B17677,93,58,35,186,2022
2019_C17678,82,50,50,182,2019
2019_A17679,88,72,78,238,2019
2019_B17680,88,63,48,199,2019
2021_C17681,82,67,65,214,2021
2022_B17682,94,69,43,206,2022
2022_C17683,82,94,52,228,2022
2021_A17684,72,67,51,190,2021
2022_C17685,85,59,78,222,2022
2021_C17686,90,53,45,188,2021
2021_A17687,90,45,36,171,2021
2019_B17688,93,78,66,237,2019
2022_C17689,88,83,36,207,2022
2019_A17690,95,65,59,219,2019
2019_B17691,78,87,72,237,2019
2022_A17692,93,88,43,224,2022
2021_A17693,94,57,59,210,2021
2019_B17694,72,54,38,164,2019
2019_A17695,86,91,57,234,2019
2022_C17696,82,67,71,220,2022
2022_A17697,80,83,61,224,2022
2019_A17698,90,87,52,229,2019
2022_A17699,97,95,49,241,2022
2021_B17700,81,57,60,198,2021
2019_C17701,91,68,41,200,2019
2022_A17702,90,61,64,215,2022
2022_B17703,71,80,50,201,2022
2019_C17704,82,64,45,191,2019
2019_C17705,82,75,50,207,2019
2019_B17706,87,47,38,172,2019
2019_A17707,88,70,38,196,2019
2021_C17708,73,60,68,201,2021
2022_A17709,89,66,66,221,2022
2021_B17710,86,89,35,210,2021
2022_A17711,72,85,64,221,2022
2021_A17712,80,80,79,239,2021
2019_B17713,76,50,55,181,2019
2019_A17714,76,71,76,223,2019
2022_A17715,88,57,69,214,2022
2019_A17716,90,85,59,234,2019
2019_B17717,79,78,77,234,2019
2021_B17718,81,84,57,222,2021
2021_A17719,94,53,79,226,2021
2019_C17720,86,72,66,224,2019
2019_B17721,88,79,35,202,2019
2019_A17722,73,88,44,205,2019
2019_A17723,81,59,74,214,2019
2021_C17724,78,95,53,226,2021
2019_C17725,90,96,36,222,2019
2021_A17726,75,62,45,182,2021
2021_A17727,91,82,74,247,2021
2021_B17728,91,52,66,209,2021
2019_B17729,74,92,50,216,2019
2021_B17730,88,52,38,178,2021
2019_B17731,85,92,71,248,2019
2022_A17732,90,69,69,228,2022
2019_B17733,71,87,52,210,2019
2022_C17734,88,84,67,239,2022
2021_C17735,82,75,45,202,2021
2019_B17736,80,91,58,229,2019
2019_A17737,91,48,43,182,2019
2021_C17738,80,50,46,176,2021
2022_B17739,84,91,56,231,2022
2019_A17740,83,83,69,235,2019
2019_C17741,96,91,38,225,2019
2022_A17742,76,54,53,183,2022
2021_A17743,71,74,37,182,2021
2021_C17744,96,48,54,198,2021
2021_A17745,72,46,40,158,2021
2019_A17746,87,80,76,243,2019
2021_A17747,82,45,50,177,2021
2021_A17748,80,55,36,171,2021
2022_B17749,85,57,65,207,2022
2021_C17750,89,86,55,230,2021
2019_C17751,82,72,75,229,2019
2021_C17752,86,64,36,186,2021
2021_C17753,94,92,45,231,2021
2021_B17754,89,93,66,248,2021
2019_B17755,87,54,63,204,2019
2019_A17756,97,59,50,206,2019
2021_A17757,91,94,65,250,2021
2022_C17758,76,68,63,207,2022
2019_A17759,86,45,79,210,2019
2019_A17760,81,51,76,208,2019
2022_C17761,83,55,53,191,2022
2021_B17762,87,71,68,226,2021
2019_A17763,92,61,70,223,2019
2021_A17764,79,69,65,213,2021
2019_A17765,95,51,73,219,2019
2019_B17766,87,67,74,228,2019
2022_A17767,80,46,49,175,2022
2022_A17768,95,54,65,214,2022
2022_B17769,93,63,66,222,2022
2021_C17770,79,60,65,204,2021
2019_A17771,76,68,50,194,2019
2022_B17772,86,52,54,192,2022
2022_C17773,89,64,53,206,2022
2021_B17774,94,75,70,239,2021
2022_B17775,93,86,48,227,2022
2022_C17776,84,69,68,221,2022
2019_A17777,83,47,65,195,2019
2022_C17778,81,89,37,207,2022
2022_B17779,75,59,51,185,2022
2021_A17780,89,62,74,225,2021
2021_B17781,77,71,74,222,2021
2019_A17782,93,69,48,210,2019
2019_A17783,82,61,36,179,2019
2019_A17784,88,59,52,199,2019
2019_C17785,92,53,50,195,2019
2022_B17786,74,49,45,168,2022
2022_A17787,97,86,43,226,2022
2022_C17788,87,63,73,223,2022
2022_A17789,78,55,60,193,2022
2019_A17790,85,90,43,218,2019
2021_B17791,95,82,40,217,2021
2021_B17792,96,91,75,262,2021
2021_A17793,89,78,77,244,2021
2019_B17794,78,78,43,199,2019
2021_A17795,90,94,71,255,2021
2019_B17796,97,90,58,245,2019
2019_A17797,80,84,47,211,2019
2019_B17798,94,75,52,221,2019
2019_B17799,82,58,78,218,2019
2022_C17800,87,67,42,196,2022
2019_B17801,93,46,68,207,2019
2019_A17802,72,57,37,166,2019
2019_C17803,92,80,47,219,2019
2021_C17804,83,81,53,217,2021
2019_B17805,97,51,76,224,2019
2022_C17806,93,65,44,202,2022
2019_B17807,74,69,58,201,2019
2021_C17808,88,83,68,239,2021
2021_C17809,74,66,78,218,2021
2019_B17810,78,56,66,200,2019
2019_B17811,77,93,57,227,2019
2022_C17812,75,93,58,226,2022
2019_A17813,75,96,43,214,2019
2022_B17814,77,76,79,232,2022
2021_A17815,72,58,42,172,2021
2022_B17816,81,78,37,196,2022
2022_B17817,95,52,62,209,2022
2022_A17818,79,73,69,221,2022
2021_B17819,77,59,67,203,2021
2022_C17820,95,54,57,206,2022
2021_A17821,92,74,48,214,2021
2021_C17822,76,95,71,242,2021
2019_C17823,75,75,61,211,2019
2019_B17824,84,69,46,199,2019
2021_B17825,87,76,39,202,2021
2022_A17826,90,89,48,227,2022
2022_C17827,90,49,61,200,2022
2022_B17828,77,51,48,176,2022
2021_B17829,73,62,50,185,2021
2019_A17830,92,93,37,222,2019
2022_C17831,84,69,62,215,2022
2022_A17832,95,52,63,210,2022
2021_B17833,90,48,61,199,2021
2022_C17834,74,65,53,192,2022
2019_A17835,85,50,41,176,2019
2019_C17836,90,65,62,217,2019
2019_C17837,77,48,48,173,2019
2022_B17838,81,46,68,195,2022
2019_A17839,84,86,47,217,2019
2019_A17840,90,73,64,227,2019
2022_A17841,77,66,72,215,2022
2019_C17842,72,69,39,180,2019
2019_C17843,87,62,66,215,2019
2022_A17844,74,47,43,164,2022
2019_B17845,81,95,63,239,2019
2019_C17846,79,45,51,175,2019
2021_C17847,78,93,44,215,2021
2019_A17848,82,88,78,248,2019
2021_B17849,96,55,61,212,2021
2021_A17850,72,85,64,221,2021
2019_B17851,74,53,59,186,2019
2021_C17852,75,54,46,175,2021
2021_B17853,82,46,65,193,2021
2022_A17854,86,82,60,228,2022
2021_A17855,90,52,40,182,2021
2021_A17856,85,83,42,210,2021
2022_A17857,95,74,57,226,2022
2022_C17858,91,60,75,226,2022
2019_A17859,77,95,64,236,2019
2019_B17860,97,75,46,218,2019
2021_C17861,86,82,54,222,2021
2021_A17862,73,93,46,212,2021
2022_C17863,83,54,58,195,2022
2021_C17864,86,55,35,176,2021
2021_C17865,88,75,49,212,2021
2022_B17866,78,52,54,184,2022
2019_A17867,77,81,63,221,2019
2022_B17868,75,60,58,193,2022
2019_A17869,83,75,59,217,2019
2022_B17870,81,54,58,193,2022
2022_C17871,88,94,41,223,2022
2019_B17872,83,49,59,191,2019
2021_A17873,92,49,48,189,2021
2022_B17874,88,91,58,237,2022
2022_C17875,81,49,54,184,2022
2022_C17876,86,68,76,230,2022
2019_A17877,86,55,44,185,2019
2022_A17878,92,83,64,239,2022
2021_C17879,92,52,47,191,2021
2021_A17880,88,80,57,225,2021
2021_C17881,86,90,50,226,2021
2021_C17882,95,51,50,196,2021
2021_A17883,74,89,43,206,2021
2022_C17884,95,64,37,196,2022
2022_A17885,96,96,66,258,2022
2019_A17886,81,46,65,192,2019
2022_C17887,84,47,38,169,2022
2022_C17888,85,52,42,179,2022
2021_C17889,94,58,38,190,2021
2021_B17890,90,53,42,185,2021
2021_C17891,80,60,46,186,2021
2022_B17892,77,51,44,172,2022
2022_B17893,71,85,66,222,2022
2021_B17894,87,81,48,216,2021
2021_A17895,75,62,36,173,2021
2022_A17896,77,82,55,214,2022
2019_C17897,76,70,55,201,2019
2021_B17898,73,62,79,214,2021
2021_C17899,86,66,45,197,2021
2021_A17900,82,81,76,239,2021
2021_C17901,78,95,41,214,2021
2019_A17902,92,72,55,219,2019
2021_A17903,85,51,61,197,2021
2021_A17904,87,64,41,192,2021
2021_C17905,90,74,75,239,2021
2022_C17906,85,49,67,201,2022
2019_C17907,75,82,38,195,2019
2022_A17908,82,57,51,190,2022
2022_B17909,96,58,69,223,2022
2019_A17910,85,67,45,197,2019
2019_C17911,89,62,38,189,2019
2022_A17912,76,86,54,216,2022
2019_A17913,78,55,50,183,2019
2022_A17914,77,46,65,188,2022
2021_C17915,94,57,47,198,2021
2022_A17916,95,82,69,246,2022
2019_B17917,97,48,43,188,2019
2019_A17918,85,90,43,218,2019
2022_B17919,92,66,74,232,2022
2019_A17920,75,82,35,192,2019
2021_C17921,97,95,38,230,2021
2022_B17922,82,79,54,215,2022
2021_A17923,94,53,35,182,2021
2019_B17924,94,64,78,236,2019
2021_B17925,74,88,57,219,2021
2022_C17926,84,59,40,183,2022
2021_C17927,97,52,55,204,2021
2019_C17928,80,90,54,224,2019
2019_C17929,88,58,37,183,2019
2022_A17930,78,90,36,204,2022
2021_C17931,73,80,78,231,2021
2021_A17932,91,86,47,224,2021
2021_B17933,84,53,71,208,2021
2019_B17934,91,57,58,206,2019
2019_B17935,92,80,63,235,2019
2021_A17936,72,81,66,219,2021
2021_A17937,96,66,70,232,2021
2019_A17938,97,79,77,253,2019
2022_B17939,82,95,57,234,2022
2019_B17940,82,95,71,248,2019
2019_A17941,83,67,50,200,2019
2022_B17942,83,90,36,209,2022
2021_B17943,79,49,49,177,2021
2019_C17944,88,75,49,212,2019
2021_B17945,71,69,58,198,2021
2019_A17946,88,86,79,253,2019
2019_B17947,91,64,73,228,2019
2019_A17948,86,57,64,207,2019
2021_A17949,80,59,36,175,2021
2022_B17950,84,87,77,248,2022
2021_C17951,89,94,70,253,2021
2022_C17952,83,75,38,196,2022
2021_A17953,94,57,61,212,2021
2022_A17954,78,79,69,226,2022
2022_A17955,77,82,55,214,2022
2019_B17956,94,55,43,192,2019
2022_B17957,91,67,70,228,2022
2022_B17958,93,68,74,235,2022
2022_C17959,76,63,41,180,2022
2022_B17960,92,78,56,226,2022
2019_A17961,95,58,60,213,2019
2021_C17962,85,75,71,231,2021
2019_A17963,75,48,61,184,2019
2022_B17964,83,68,79,230,2022
2022_B17965,81,77,60,218,2022
2021_A17966,94,86,59,239,2021
2021_B17967,73,46,43,162,2021
2019_A17968,76,59,56,191,2019
2019_C17969,89,56,58,203,2019
2019_C17970,88,86,53,227,2019
2022_A17971,87,58,53,198,2022
2019_B17972,79,72,53,204,2019
2019_B17973,83,56,75,214,2019
2019_B17974,96,66,68,230,2019
2022_B17975,88,71,66,225,2022
2021_B17976,87,78,74,239,2021
2019_B17977,97,45,64,206,2019
2019_B17978,90,58,50,198,2019
2021_C17979,87,74,39,200,2021
2019_A17980,73,47,71,191,2019
2022_A17981,76,59,58,193,2022
2021_C17982,78,63,45,186,2021
2019_B17983,77,68,72,217,2019
2019_B17984,84,93,74,251,2019
2022_B17985,96,90,72,258,2022
2019_C17986,71,88,79,238,2019
2019_A17987,88,86,36,210,2019
2021_C17988,78,96,35,209,2021
2019_C17989,96,72,50,218,2019
2019_A17990,97,67,72,236,2019
2021_C17991,86,59,36,181,2021
2021_B17992,82,58,53,193,2021
2022_C17993,96,77,64,237,2022
2022_B17994,86,52,45,183,2022
2019_A17995,89,73,50,212,2019
2021_C17996,97,48,52,197,2021
2021_B17997,90,48,57,195,2021
2021_B17998,88,63,65,216,2021
2019_C17999,92,96,49,237,2019
2021_C18000,77,53,44,174,2021
2022_B18001,90,75,52,217,2022
2019_B18002,73,82,72,227,2019
2019_B18003,96,79,36,211,2019
2022_A18004,97,92,78,267,2022
2019_A18005,92,62,45,199,2019
2022_A18006,82,49,74,205,2022
2019_A18007,87,90,65,242,2019
2022_C18008,74,93,42,209,2022
2021_B18009,80,49,59,188,2021
2019_A18010,86,52,53,191,2019
2022_C18011,73,56,66,195,2022
2019_B18012,84,96,71,251,2019
2019_A18013,86,77,73,236,2019
2021_C18014,83,82,51,216,2021
2022_A18015,93,63,52,208,2022
2019_B18016,94,51,57,202,2019
2022_B18017,93,52,44,189,2022
2022_A18018,83,74,47,204,2022
2022_B18019,92,82,76,250,2022
2021_B18020,74,88,42,204,2021
2021_C18021,74,46,41,161,2021
2022_C18022,93,90,67,250,2022
2019_C18023,94,85,73,252,2019
2021_A18024,96,58,71,225,2021
2019_C18025,71,90,69,230,2019
2022_C18026,78,60,55,193,2022
2021_A18027,86,68,58,212,2021
2021_A18028,78,69,46,193,2021
2022_B18029,95,66,39,200,2022
2021_A18030,79,67,79,225,2021
2022_A18031,80,85,74,239,2022
2021_A18032,91,50,62,203,2021
2019_C18033,83,88,40,211,2019
2022_C18034,81,79,49,209,2022
2019_A18035,89,93,69,251,2019
2021_A18036,97,58,57,212,2021
2022_C18037,79,85,38,202,2022
2021_C18038,89,70,70,229,2021
2022_C18039,95,70,72,237,2022
2022_C18040,74,79,72,225,2022
2019_C18041,90,65,42,197,2019
2019_C18042,97,64,69,230,2019
2022_A18043,97,58,60,215,2022
2021_B18044,94,59,48,201,2021
2019_A18045,71,79,56,206,2019
2019_B18046,72,46,51,169,2019
2021_A18047,87,72,37,196,2021
2022_A18048,95,95,57,247,2022
2019_C18049,82,78,40,200,2019
2019_A18050,92,66,70,228,2019
2019_A18051,95,50,47,192,2019
2021_A18052,77,67,41,185,2021
2019_B18053,93,89,77,259,2019
2019_C18054,95,72,65,232,2019
2019_B18055,96,89,73,258,2019
2019_A18056,91,56,37,184,2019
2022_C18057,90,45,41,176,2022
2021_C18058,97,86,43,226,2021
2019_A18059,72,89,44,205,2019
2021_C18060,80,57,48,185,2021
2021_C18061,83,92,38,213,2021
2021_C18062,93,58,50,201,2021
2019_B18063,76,67,57,200,2019
2022_A18064,83,46,55,184,2022
2021_A18065,94,79,69,242,2021
2021_C18066,91,93,75,259,2021
2021_C18067,94,56,55,205,2021
2019_A18068,76,77,49,202,2019
2019_C18069,91,70,58,219,2019
2022_C18070,74,88,72,234,2022
2021_A18071,76,49,76,201,2021
2022_C18072,92,51,54,197,2022
2021_A18073,80,73,41,194,2021
2021_C18074,76,53,66,195,2021
2019_A18075,94,74,50,218,2019
2019_B18076,83,69,43,195,2019
2022_C18077,87,93,64,244,2022
2022_C18078,96,52,51,199,2022
2021_C18079,77,94,35,206,2021
2019_B18080,77,59,73,209,2019
2022_B18081,86,92,79,257,2022
2021_C18082,81,81,47,209,2021
2021_B18083,71,73,55,199,2021
2021_C18084,80,81,78,239,2021
2021_A18085,92,68,67,227,2021
2022_C18086,97,63,69,229,2022
2021_A18087,79,83,75,237,2021
2019_A18088,86,54,49,189,2019
2019_C18089,80,61,60,201,2019
2022_C18090,79,86,41,206,2022
2022_B18091,79,54,37,170,2022
2019_C18092,73,53,40,166,2019
2019_B18093,88,68,66,222,2019
2022_A18094,80,64,50,194,2022
2019_A18095,85,75,55,215,2019
2019_A18096,79,62,77,218,2019
2019_A18097,74,90,44,208,2019
2022_A18098,75,91,79,245,2022
2021_B18099,72,58,68,198,2021
2021_B18100,79,68,72,219,2021
2022_B18101,81,75,54,210,2022
2019_C18102,87,63,39,189,2019
2019_C18103,75,84,37,196,2019
2019_B18104,78,90,61,229,2019
2021_A18105,92,66,46,204,2021
2022_B18106,88,82,72,242,2022
2022_C18107,86,55,65,206,2022
2019_C18108,83,58,58,199,2019
2021_C18109,78,77,73,228,2021
2019_A18110,71,78,46,195,2019
2022_B18111,80,77,71,228,2022
2021_B18112,95,92,74,261,2021
2019_C18113,96,47,57,200,2019
2022_C18114,76,94,58,228,2022
2021_A18115,81,59,37,177,2021
2022_B18116,89,56,73,218,2022
2022_A18117,80,94,48,222,2022
2022_A18118,74,70,45,189,2022
2019_A18119,77,70,73,220,2019
2022_C18120,87,61,36,184,2022
2019_C18121,79,68,59,206,2019
2019_A18122,88,79,64,231,2019
2021_C18123,89,75,55,219,2021
2019_C18124,97,75,75,247,2019
2022_C18125,85,89,67,241,2022
2019_A18126,85,54,40,179,2019
2019_C18127,74,67,64,205,2019
2021_C18128,88,55,58,201,2021
2021_B18129,96,85,56,237,2021
2019_A18130,76,80,55,211,2019
2021_B18131,86,93,39,218,2021
2022_C18132,96,74,42,212,2022
2022_B18133,77,83,43,203,2022
2022_C18134,95,84,78,257,2022
2022_A18135,87,63,64,214,2022
2021_A18136,79,89,37,205,2021
2021_C18137,89,67,62,218,2021
2019_A18138,95,85,65,245,2019
2021_B18139,75,55,46,176,2021
2021_A18140,76,47,55,178,2021
2019_B18141,82,85,67,234,2019
2021_B18142,95,68,45,208,2021
2021_C18143,72,52,43,167,2021
2022_C18144,93,47,45,185,2022
2022_B18145,88,69,76,233,2022
2019_B18146,92,46,37,175,2019
2022_B18147,87,51,72,210,2022
2021_A18148,88,88,43,219,2021
2021_C18149,72,74,38,184,2021
2021_C18150,90,72,71,233,2021
2022_A18151,85,50,62,197,2022
2019_A18152,84,59,77,220,2019
2022_B18153,85,51,51,187,2022
2019_C18154,87,81,39,207,2019
2022_B18155,82,47,61,190,2022
2019_A18156,83,69,69,221,2019
2022_B18157,91,76,77,244,2022
2022_A18158,71,79,75,225,2022
2021_B18159,78,60,55,193,2021
2022_A18160,84,66,55,205,2022
2021_C18161,95,68,65,228,2021
2019_C18162,78,96,38,212,2019
2019_B18163,80,75,39,194,2019
2019_C18164,89,49,49,187,2019
2019_B18165,84,73,35,192,2019
2019_A18166,85,49,52,186,2019
2021_B18167,82,62,63,207,2021
2019_A18168,78,73,44,195,2019
2019_C18169,81,45,75,201,2019
2021_A18170,96,88,58,242,2021
2022_A18171,73,69,50,192,2022
2019_A18172,95,55,71,221,2019
2019_A18173,87,69,75,231,2019
2019_A18174,78,86,75,239,2019
2021_A18175,97,74,40,211,2021
2019_B18176,86,80,74,240,2019
2022_C18177,96,63,69,228,2022
2019_C18178,81,70,38,189,2019
2019_C18179,72,76,60,208,2019
2021_A18180,94,48,68,210,2021
2021_C18181,91,90,38,219,2021
2022_C18182,92,87,60,239,2022
2021_A18183,75,57,58,190,2021
2019_C18184,76,53,62,191,2019
2019_B18185,74,95,36,205,2019
2019_A18186,75,52,57,184,2019
2022_A18187,80,67,39,186,2022
2021_C18188,94,85,77,256,2021
2022_A18189,74,60,60,194,2022
2022_B18190,95,45,60,200,2022
2021_B18191,97,54,61,212,2021
2022_A18192,94,53,58,205,2022
2022_C18193,96,92,43,231,2022
2021_C18194,89,85,76,250,2021
2022_A18195,85,72,74,231,2022
2021_A18196,80,50,71,201,2021
2022_A18197,78,80,44,202,2022
2022_B18198,92,66,46,204,2022
2019_A18199,86,59,61,206,2019
2019_A18200,93,95,40,228,2019
2019_B18201,80,87,76,243,2019
2019_B18202,92,89,75,256,2019
2019_C18203,88,53,73,214,2019
2021_A18204,90,59,37,186,2021
2021_C18205,93,60,41,194,2021
2019_C18206,85,59,60,204,2019
2019_B18207,81,78,62,221,2019
2019_C18208,78,70,48,196,2019
2022_A18209,91,83,38,212,2022
2021_C18210,77,54,77,208,2021
2021_A18211,87,60,68,215,2021
2022_A18212,82,64,55,201,2022
2021_C18213,96,55,68,219,2021
2022_B18214,78,88,64,230,2022
2021_A18215,79,72,42,193,2021
2021_C18216,89,58,35,182,2021
2022_C18217,82,76,48,206,2022
2019_B18218,95,80,40,215,2019
2019_C18219,89,50,46,185,2019
2019_A18220,96,57,56,209,2019
2022_B18221,97,83,75,255,2022
2021_C18222,94,65,47,206,2021
2021_A18223,71,93,77,241,2021
2022_C18224,79,65,55,199,2022
2022_B18225,76,50,58,184,2022
2022_A18226,94,92,74,260,2022
2021_A18227,76,67,57,200,2021
2022_B18228,72,50,37,159,2022
2022_A18229,81,65,43,189,2022
2022_B18230,80,88,62,230,2022
2021_B18231,82,78,45,205,2021
2021_B18232,84,68,76,228,2021
2021_C18233,84,96,72,252,2021
2021_A18234,94,48,36,178,2021
2019_C18235,96,93,52,241,2019
2022_A18236,82,76,40,198,2022
2019_A18237,91,91,72,254,2019
2021_A18238,85,59,50,194,2021
2022_B18239,76,48,40,164,2022
2021_C18240,94,73,46,213,2021
2019_B18241,76,80,76,232,2019
2021_B18242,88,50,63,201,2021
2021_A18243,80,91,48,219,2021
2021_A18244,92,67,54,213,2021
2022_C18245,72,71,46,189,2022
2019_C18246,88,60,78,226,2019
2019_A18247,91,85,37,213,2019
2019_B18248,93,62,50,205,2019
2021_C18249,79,74,47,200,2021
2022_B18250,81,73,71,225,2022
2021_C18251,95,72,70,237,2021
2021_C18252,87,69,76,232,2021
2021_A18253,96,73,50,219,2021
2019_B18254,78,65,68,211,2019
2019_B18255,95,67,68,230,2019
2021_B18256,76,77,67,220,2021
2022_A18257,87,91,76,254,2022
2019_C18258,93,80,52,225,2019
2022_A18259,92,88,67,247,2022
2019_A18260,94,90,62,246,2019
2022_A18261,73,59,68,200,2022
2022_A18262,96,71,50,217,2022
2022_A18263,92,78,43,213,2022
2022_B18264,74,70,66,210,2022
2019_B18265,91,79,79,249,2019
2021_A18266,87,47,42,176,2021
2019_A18267,74,71,49,194,2019
2022_B18268,89,50,69,208,2022
2021_A18269,91,63,49,203,2021
2022_A18270,87,63,42,192,2022
2019_C18271,72,80,38,190,2019
2021_A18272,84,63,55,202,2021
2022_B18273,90,96,40,226,2022
2022_B18274,88,59,70,217,2022
2022_B18275,72,91,43,206,2022
2019_B18276,80,74,77,231,2019
2022_A18277,81,62,38,181,2022
2022_C18278,91,55,62,208,2022
2021_B18279,74,68,41,183,2021
2021_C18280,84,94,61,239,2021
2022_C18281,80,76,46,202,2022
2022_A18282,77,45,58,180,2022
2021_A18283,74,73,47,194,2021
2021_B18284,93,75,55,223,2021
2019_C18285,80,46,48,174,2019
2021_C18286,97,73,75,245,2021
2019_B18287,90,96,74,260,2019
2021_C18288,81,46,47,174,2021
2021_A18289,76,45,50,171,2021
2022_A18290,78,60,74,212,2022
2019_C18291,94,82,62,238,2019
2019_B18292,71,53,59,183,2019
2019_B18293,79,80,53,212,2019
2019_C18294,78,52,72,202,2019
2019_A18295,81,69,75,225,2019
2021_B18296,78,81,66,225,2021
2019_B18297,83,63,49,195,2019
2021_A18298,80,57,74,211,2021
2021_B18299,75,66,67,208,2021
2019_C18300,97,52,54,203,2019
2022_C18301,71,84,35,190,2022
2021_C18302,88,47,37,172,2021
2021_A18303,86,80,50,216,2021
2019_B18304,77,67,68,212,2019
2019_B18305,86,68,70,224,2019
2022_A18306,84,53,37,174,2022
2019_A18307,79,57,78,214,2019
2021_A18308,93,50,45,188,2021
2019_B18309,97,88,44,229,2019
2019_B18310,85,68,49,202,2019
2022_B18311,75,54,42,171,2022
2021_C18312,92,88,58,238,2021
2019_C18313,92,55,64,211,2019
2022_A18314,96,78,45,219,2022
2022_A18315,91,82,42,215,2022
2019_A18316,96,51,74,221,2019
2022_B18317,96,55,61,212,2022
2021_C18318,88,78,61,227,2021
2021_B18319,85,65,51,201,2021
2021_B18320,84,94,35,213,2021
2019_B18321,93,54,38,185,2019
2021_B18322,79,64,44,187,2021
2021_B18323,87,76,62,225,2021
2021_A18324,79,46,79,204,2021
2021_C18325,84,74,51,209,2021
2022_B18326,97,80,48,225,2022
2021_A18327,83,70,53,206,2021
2019_A18328,74,96,60,230,2019
2019_A18329,76,93,78,247,2019
2021_A18330,91,54,44,189,2021
2021_B18331,91,57,71,219,2021
2022_B18332,89,50,41,180,2022
2021_C18333,93,90,73,256,2021
2019_A18334,71,62,60,193,2019
2021_A18335,73,82,76,231,2021
2021_B18336,75,78,76,229,2021
2022_B18337,86,67,36,189,2022
2021_A18338,87,88,48,223,2021
2021_B18339,77,59,53,189,2021
2022_A18340,84,84,39,207,2022
2022_C18341,72,88,56,216,2022
2019_A18342,93,86,77,256,2019
2019_C18343,93,72,65,230,2019
2022_B18344,97,79,37,213,2022
2019_C18345,82,50,37,169,2019
2022_B18346,94,94,38,226,2022
2022_B18347,72,47,64,183,2022
2022_C18348,72,47,52,171,2022
2022_C18349,75,72,54,201,2022
2019_A18350,86,79,67,232,2019
2021_B18351,90,87,41,218,2021
2022_B18352,86,80,37,203,2022
2022_B18353,97,93,52,242,2022
2022_C18354,88,67,35,190,2022
2022_A18355,78,71,64,213,2022
2022_B18356,95,56,69,220,2022
2022_B18357,77,85,41,203,2022
2021_B18358,97,58,56,211,2021
2019_B18359,73,81,39,193,2019
2021_C18360,87,93,65,245,2021
2019_C18361,80,59,64,203,2019
2021_A18362,90,51,69,210,2021
2021_C18363,85,83,50,218,2021
2019_B18364,73,70,69,212,2019
2019_C18365,75,56,35,166,2019
2019_A18366,73,88,67,228,2019
2019_C18367,95,70,77,242,2019
2019_A18368,87,84,54,225,2019
2022_A18369,96,90,67,253,2022
2022_C18370,96,49,76,221,2022
2022_A18371,83,49,46,178,2022
2019_C18372,89,92,51,232,2019
2022_A18373,80,50,40,170,2022
2019_C18374,76,53,69,198,2019
2021_A18375,89,70,58,217,2021
2021_C18376,80,91,41,212,2021
2021_C18377,80,72,58,210,2021
2021_B18378,91,80,69,240,2021
2021_B18379,83,73,51,207,2021
2019_A18380,85,85,72,242,2019
2021_C18381,83,81,44,208,2021
2019_B18382,77,83,51,211,2019
2021_C18383,90,88,63,241,2021
2021_C18384,74,80,58,212,2021
2022_B18385,92,59,69,220,2022
2019_C18386,93,80,77,250,2019
2021_C18387,76,93,49,218,2021
2022_A18388,77,83,66,226,2022
2021_C18389,72,68,57,197,2021
2022_B18390,92,60,74,226,2022
2019_B18391,91,47,69,207,2019
2019_B18392,74,47,37,158,2019
2022_B18393,97,83,76,256,2022
2022_C18394,85,93,39,217,2022
2022_C18395,87,71,38,196,2022
2021_A18396,85,73,43,201,2021
2019_B18397,88,94,55,237,2019
2022_B18398,88,93,72,253,2022
2021_A18399,76,58,61,195,2021
2019_C18400,82,92,67,241,2019
2021_B18401,89,95,52,236,2021
2022_B18402,92,91,39,222,2022
2021_A18403,75,49,60,184,2021
2022_C18404,83,74,47,204,2022
2022_B18405,79,68,68,215,2022
2019_A18406,94,83,54,231,2019
2021_C18407,95,50,40,185,2021
2021_B18408,75,96,42,213,2021
2019_B18409,94,46,45,185,2019
2022_C18410,82,84,50,216,2022
2021_C18411,92,55,38,185,2021
2019_C18412,90,56,74,220,2019
2019_C18413,73,65,50,188,2019
2021_A18414,74,51,68,193,2021
2022_C18415,93,52,72,217,2022
2019_B18416,83,49,76,208,2019
2019_C18417,90,92,40,222,2019
2019_C18418,94,59,67,220,2019
2019_A18419,78,95,67,240,2019
2021_B18420,74,90,67,231,2021
2022_A18421,81,45,54,180,2022
2019_B18422,85,60,49,194,2019
2022_B18423,85,67,70,222,2022
2022_C18424,88,45,57,190,2022
2021_C18425,88,68,38,194,2021
2021_B18426,96,60,39,195,2021
2019_B18427,82,70,36,188,2019
2019_C18428,72,88,57,217,2019
2021_B18429,80,82,35,197,2021
2019_B18430,76,76,53,205,2019
2019_A18431,75,82,62,219,2019
2021_C18432,82,56,38,176,2021
2019_C18433,83,51,54,188,2019
2021_C18434,84,62,77,223,2021
2019_A18435,96,91,48,235,2019
2019_C18436,90,85,45,220,2019
2019_C18437,81,57,40,178,2019
2019_A18438,90,81,57,228,2019
2019_A18439,86,84,75,245,2019
2021_C18440,90,65,73,228,2021
2021_A18441,73,54,46,173,2021
2019_A18442,76,58,47,181,2019
2019_C18443,77,91,36,204,2019
2019_A18444,82,90,67,239,2019
2019_C18445,83,78,36,197,2019
2019_B18446,87,81,77,245,2019
2022_C18447,97,81,75,253,2022
2022_A18448,86,73,50,209,2022
2022_A18449,73,53,59,185,2022
2019_A18450,80,91,52,223,2019
2022_B18451,79,92,45,216,2022
2021_C18452,90,49,73,212,2021
2021_C18453,92,81,43,216,2021
2021_C18454,82,78,46,206,2021
2019_C18455,82,75,42,199,2019
2021_B18456,90,85,44,219,2021
2021_C18457,89,95,49,233,2021
2022_C18458,78,64,63,205,2022
2021_B18459,91,87,38,216,2021
2022_B18460,80,51,35,166,2022
2021_B18461,75,59,63,197,2021
2022_B18462,89,71,52,212,2022
2021_C18463,89,92,73,254,2021
2019_A18464,88,63,72,223,2019
2019_C18465,87,59,45,191,2019
2022_A18466,77,82,46,205,2022
2022_C18467,78,62,79,219,2022
2022_C18468,84,92,54,230,2022
2021_B18469,92,64,73,229,2021
2021_B18470,89,73,47,209,2021
2022_A18471,84,93,61,238,2022
2022_B18472,89,86,72,247,2022
2021_A18473,90,68,54,212,2021
2021_B18474,85,83,66,234,2021
2019_A18475,88,66,71,225,2019
2022_C18476,93,94,40,227,2022
2019_A18477,75,95,45,215,2019
2019_B18478,72,77,54,203,2019
2019_A18479,73,88,44,205,2019
2019_B18480,75,63,74,212,2019
2019_B18481,90,62,59,211,2019
2019_B18482,86,79,63,228,2019
2019_C18483,95,86,38,219,2019
2022_C18484,90,91,69,250,2022
2021_C18485,86,60,40,186,2021
2022_A18486,79,81,71,231,2022
2022_B18487,78,55,51,184,2022
2021_B18488,83,83,61,227,2021
2021_B18489,83,45,39,167,2021
2019_A18490,79,73,59,211,2019
2019_A18491,87,95,63,245,2019
2019_C18492,80,88,54,222,2019
2019_B18493,79,46,43,168,2019
2021_B18494,80,76,40,196,2021
2022_B18495,89,63,73,225,2022
2019_A18496,88,79,73,240,2019
2019_A18497,92,88,68,248,2019
2022_C18498,75,76,79,230,2022
2021_C18499,97,66,40,203,2021
2021_A18500,76,66,54,196,2021
2022_C18501,75,64,69,208,2022
2022_A18502,82,86,69,237,2022
2019_A18503,80,90,61,231,2019
2019_A18504,78,61,39,178,2019
2021_A18505,90,79,64,233,2021
2021_A18506,71,91,58,220,2021
2021_C18507,93,78,64,235,2021
2019_B18508,89,51,63,203,2019
2021_C18509,90,60,73,223,2021
2022_C18510,91,78,59,228,2022
2019_C18511,90,77,65,232,2019
2022_C18512,72,82,67,221,2022
2021_A18513,76,75,52,203,2021
2022_A18514,77,82,71,230,2022
2021_C18515,82,65,58,205,2021
2021_B18516,72,62,69,203,2021
2022_B18517,87,89,53,229,2022
2022_A18518,80,49,64,193,2022
2022_C18519,97,63,52,212,2022
2021_B18520,71,69,39,179,2021
2019_B18521,82,79,78,239,2019
2019_B18522,84,88,53,225,2019
2019_B18523,87,80,49,216,2019
2022_C18524,72,86,61,219,2022
2022_A18525,74,67,65,206,2022
2019_A18526,83,88,47,218,2019
2021_A18527,76,74,47,197,2021
2022_C18528,80,60,54,194,2022
2021_A18529,88,55,57,200,2021
2021_C18530,86,93,77,256,2021
2021_B18531,81,61,39,181,2021
2021_C18532,84,66,46,196,2021
2019_C18533,83,76,38,197,2019
2019_C18534,90,74,59,223,2019
2021_C18535,82,46,70,198,2021
2019_C18536,92,85,48,225,2019
2021_A18537,96,57,40,193,2021
2022_C18538,73,70,48,191,2022
2021_A18539,84,75,70,229,2021
2022_A18540,79,70,71,220,2022
2021_C18541,96,95,48,239,2021
2022_B18542,79,68,43,190,2022
2021_B18543,93,47,68,208,2021
2021_B18544,76,85,50,211,2021
2021_B18545,95,79,51,225,2021
2022_A18546,88,74,46,208,2022
2022_B18547,79,45,46,170,2022
2021_A18548,71,63,56,190,2021
2021_B18549,78,80,66,224,2021
2022_C18550,87,91,54,232,2022
2021_B18551,71,45,42,158,2021
2022_C18552,86,57,58,201,2022
2022_B18553,78,65,49,192,2022
2019_B18554,78,95,66,239,2019
2019_C18555,88,60,63,211,2019
2021_C18556,76,46,73,195,2021
2021_B18557,71,89,71,231,2021
2021_A18558,85,59,52,196,2021
2022_C18559,79,95,49,223,2022
2022_A18560,79,84,78,241,2022
2019_A18561,86,51,77,214,2019
2022_C18562,95,69,54,218,2022
2022_A18563,79,95,37,211,2022
2019_C18564,87,69,62,218,2019
2022_C18565,79,55,49,183,2022
2022_B18566,85,76,55,216,2022
2019_C18567,81,81,46,208,2019
2019_A18568,73,70,44,187,2019
2021_C18569,94,73,52,219,2021
2019_C18570,94,48,56,198,2019
2021_C18571,81,79,57,217,2021
2021_B18572,77,86,44,207,2021
2022_B18573,97,69,68,234,2022
2022_A18574,90,45,63,198,2022
2022_A18575,79,73,35,187,2022
2019_B18576,91,56,74,221,2019
2021_C18577,77,91,60,228,2021
2019_C18578,96,86,43,225,2019
2022_A18579,87,90,57,234,2022
2019_B18580,86,73,75,234,2019
2021_C18581,97,81,37,215,2021
2019_C18582,81,48,62,191,2019
2019_A18583,96,49,47,192,2019
2022_B18584,76,88,41,205,2022
2019_B18585,77,93,68,238,2019
2019_B18586,86,65,42,193,2019
2021_C18587,97,57,74,228,2021
2022_A18588,83,53,56,192,2022
2022_B18589,77,53,51,181,2022
2019_A18590,73,65,63,201,2019
2019_A18591,89,55,73,217,2019
2022_B18592,81,56,51,188,2022
2019_B18593,97,68,39,204,2019
2019_C18594,97,80,35,212,2019
2019_C18595,87,95,42,224,2019
2019_A18596,84,50,46,180,2019
2019_B18597,91,71,56,218,2019
2021_B18598,90,53,50,193,2021
2022_B18599,78,59,61,198,2022
2021_B18600,75,93,35,203,2021
2021_C18601,86,48,52,186,2021
2021_A18602,79,96,47,222,2021
2019_A18603,76,82,76,234,2019
2019_C18604,87,53,66,206,2019
2021_C18605,88,52,68,208,2021
2021_B18606,71,67,77,215,2021
2019_A18607,79,57,40,176,2019
2021_C18608,74,73,44,191,2021
2021_C18609,76,93,69,238,2021
2021_A18610,80,71,40,191,2021
2021_C18611,83,83,67,233,2021
2021_B18612,76,61,43,180,2021
2019_B18613,76,51,36,163,2019
2022_C18614,93,92,70,255,2022
2022_C18615,84,95,67,246,2022
2021_B18616,91,71,45,207,2021
2019_B18617,86,69,50,205,2019
2021_A18618,79,91,48,218,2021
2022_C18619,87,90,59,236,2022
2021_A18620,92,96,78,266,2021
2019_C18621,81,92,40,213,2019
2019_A18622,88,90,48,226,2019
2021_A18623,97,81,49,227,2021
2022_A18624,77,95,79,251,2022
2022_A18625,88,45,71,204,2022
2021_B18626,80,55,49,184,2021
2022_A18627,85,47,58,190,2022
2019_B18628,92,72,63,227,2019
2019_B18629,85,75,39,199,2019
2022_B18630,77,49,45,171,2022
2021_B18631,85,83,54,222,2021
2019_C18632,97,58,43,198,2019
2021_A18633,78,93,62,233,2021
2019_B18634,90,63,65,218,2019
2019_C18635,95,46,73,214,2019
2019_A18636,78,93,44,215,2019
2021_A18637,71,58,40,169,2021
2019_A18638,88,58,64,210,2019
2021_B18639,72,63,39,174,2021
2022_A18640,82,74,48,204,2022
2022_B18641,97,48,35,180,2022
2022_C18642,96,80,62,238,2022
2021_A18643,80,66,42,188,2021
2021_C18644,76,51,47,174,2021
2021_C18645,94,50,64,208,2021
2021_A18646,81,65,71,217,2021
2021_C18647,78,80,42,200,2021
2019_C18648,75,50,47,172,2019
2021_B18649,96,70,62,228,2021
2021_C18650,80,90,63,233,2021
2019_C18651,82,70,66,218,2019
2019_C18652,77,77,48,202,2019
2019_C18653,77,60,71,208,2019
2022_A18654,93,66,39,198,2022
2019_B18655,92,62,46,200,2019
2021_A18656,73,80,58,211,2021
2019_A18657,81,61,69,211,2019
2019_A18658,93,89,39,221,2019
2019_B18659,86,54,54,194,2019
2019_C18660,82,45,56,183,2019
2021_B18661,76,65,51,192,2021
2019_C18662,76,62,39,177,2019
2021_A18663,97,73,51,221,2021
2019_B18664,89,80,73,242,2019
2019_A18665,79,85,75,239,2019
2022_C18666,74,95,38,207,2022
2021_A18667,92,95,51,238,2021
2021_A18668,71,65,47,183,2021
2022_C18669,77,90,35,202,2022
2022_A18670,88,82,43,213,2022
2021_C18671,82,95,38,215,2021
2022_C18672,89,52,48,189,2022
2021_B18673,93,72,75,240,2021
2021_A18674,92,55,43,190,2021
2022_A18675,90,84,64,238,2022
2021_A18676,74,89,35,198,2021
2021_B18677,79,94,68,241,2021
2019_B18678,84,63,42,189,2019
2019_C18679,92,80,38,210,2019
2021_C18680,76,83,72,231,2021
2022_B18681,77,58,59,194,2022
2019_B18682,90,67,66,223,2019
2022_A18683,74,50,54,178,2022
2021_B18684,90,61,68,219,2021
2019_B18685,78,51,68,197,2019
2022_C18686,94,49,50,193,2022
2021_A18687,89,58,39,186,2021
2022_B18688,72,90,39,201,2022
2019_A18689,89,83,58,230,2019
2021_A18690,92,75,41,208,2021
2022_A18691,82,93,61,236,2022
2022_C18692,93,89,52,234,2022
2019_C18693,84,47,77,208,2019
2022_A18694,81,47,71,199,2022
2022_C18695,77,80,59,216,2022
2019_C18696,78,68,76,222,2019
2019_B18697,85,68,60,213,2019
2019_B18698,89,53,79,221,2019
2019_C18699,97,72,53,222,2019
2022_B18700,80,64,64,208,2022
2021_A18701,82,95,75,252,2021
2019_A18702,82,86,52,220,2019
2022_A18703,77,89,71,237,2022
2019_B18704,82,78,39,199,2019
2019_C18705,77,94,50,221,2019
2021_A18706,91,59,70,220,2021
2019_C18707,85,94,42,221,2019
2019_C18708,92,59,71,222,2019
2022_A18709,90,73,41,204,2022
2019_B18710,81,83,48,212,2019
2021_A18711,97,65,71,233,2021
2022_C18712,77,83,77,237,2022
2021_A18713,92,92,77,261,2021
2021_C18714,83,94,36,213,2021
2019_B18715,91,87,78,256,2019
2022_B18716,83,78,60,221,2022
2019_C18717,89,54,35,178,2019
2021_B18718,81,66,55,202,2021
2019_A18719,90,45,50,185,2019
2019_B18720,88,77,70,235,2019
2021_B18721,89,84,72,245,2021
2019_B18722,92,55,68,215,2019
2019_A18723,77,80,43,200,2019
2021_C18724,83,58,70,211,2021
2021_A18725,89,95,71,255,2021
2022_A18726,86,54,37,177,2022
2022_C18727,93,79,61,233,2022
2021_B18728,88,89,61,238,2021
2022_C18729,87,61,40,188,2022
2021_A18730,87,47,74,208,2021
2021_A18731,84,89,53,226,2021
2019_B18732,82,60,73,215,2019
2019_C18733,86,57,42,185,2019
2022_A18734,74,82,49,205,2022
2022_B18735,91,74,50,215,2022
2019_B18736,93,60,67,220,2019
2022_C18737,72,46,44,162,2022
2022_C18738,83,85,69,237,2022
2019_C18739,77,66,53,196,2019
2019_A18740,75,56,61,192,2019
2021_B18741,73,89,76,238,2021
2022_A18742,76,90,53,219,2022
2019_A18743,93,72,48,213,2019
2022_C18744,92,51,63,206,2022
2019_B18745,84,85,52,221,2019
2021_C18746,91,94,36,221,2021
2021_C18747,88,84,40,212,2021
2021_A18748,71,90,57,218,2021
2021_A18749,94,67,36,197,2021
2022_C18750,81,82,73,236,2022
2019_A18751,87,46,56,189,2019
2019_B18752,93,75,47,215,2019
2022_B18753,71,83,74,228,2022
2021_C18754,91,55,48,194,2021
2021_A18755,73,67,36,176,2021
2022_B18756,87,77,57,221,2022
2022_C18757,93,49,58,200,2022
2021_B18758,97,54,73,224,2021
2019_C18759,91,54,41,186,2019
2019_C18760,76,76,59,211,2019
2019_A18761,80,74,60,214,2019
2022_C18762,83,80,74,237,2022
2021_B18763,76,75,61,212,2021
2019_C18764,81,79,61,221,2019
2021_B18765,83,94,61,238,2021
2021_C18766,74,61,36,171,2021
2021_B18767,77,68,79,224,2021
2021_C18768,76,66,76,218,2021
2021_C18769,93,62,76,231,2021
2019_A18770,87,45,42,174,2019
2021_A18771,95,82,44,221,2021
2019_C18772,78,93,39,210,2019
2021_A18773,82,48,36,166,2021
2021_B18774,93,84,44,221,2021
2019_B18775,72,85,70,227,2019
2021_A18776,78,50,55,183,2021
2019_B18777,75,86,75,236,2019
2021_C18778,89,52,65,206,2021
2022_A18779,84,55,64,203,2022
2022_A18780,71,45,68,184,2022
2019_B18781,97,46,65,208,2019
2019_C18782,88,66,77,231,2019
2022_B18783,75,52,41,168,2022
2019_B18784,74,45,76,195,2019
2019_B18785,97,88,67,252,2019
2022_A18786,88,50,78,216,2022
2022_C18787,73,77,64,214,2022
2022_B18788,93,65,50,208,2022
2021_C18789,79,71,78,228,2021
2021_A18790,71,94,52,217,2021
2021_C18791,97,48,73,218,2021
2019_C18792,79,45,48,172,2019
2022_B18793,81,59,45,185,2022
2019_C18794,77,73,74,224,2019
2022_C18795,81,54,58,193,2022
2022_A18796,85,94,43,222,2022
2019_C18797,76,85,51,212,2019
2022_C18798,75,51,47,173,2022
2019_A18799,91,85,61,237,2019
2019_A18800,75,87,68,230,2019
2021_C18801,96,49,47,192,2021
2019_C18802,81,59,40,180,2019
2021_B18803,79,74,58,211,2021
2019_C18804,80,74,78,232,2019
2022_C18805,88,65,54,207,2022
2022_C18806,85,51,44,180,2022
2022_C18807,88,47,37,172,2022
2022_A18808,90,87,71,248,2022
2022_C18809,95,68,65,228,2022
2019_C18810,85,92,66,243,2019
2022_A18811,83,75,49,207,2022
2021_C18812,86,81,64,231,2021
2019_B18813,94,46,51,191,2019
2019_A18814,85,89,42,216,2019
2021_C18815,90,71,67,228,2021
2022_A18816,77,71,52,200,2022
2022_B18817,91,49,42,182,2022
2019_C18818,97,50,35,182,2019
2022_B18819,79,86,49,214,2022
2022_C18820,71,64,55,190,2022
2021_C18821,77,71,37,185,2021
2021_C18822,94,55,73,222,2021
2022_A18823,91,52,62,205,2022
2019_C18824,76,91,67,234,2019
2019_A18825,85,76,61,222,2019
2021_B18826,74,73,65,212,2021
2021_A18827,97,55,74,226,2021
2022_B18828,96,84,36,216,2022
2021_B18829,82,70,72,224,2021
2021_C18830,94,89,59,242,2021
2019_C18831,72,46,47,165,2019
2022_B18832,96,58,69,223,2022
2021_A18833,76,68,78,222,2021
2019_C18834,89,61,77,227,2019
2022_C18835,72,65,46,183,2022
2022_A18836,78,56,62,196,2022
2022_C18837,73,96,38,207,2022
2019_B18838,77,45,72,194,2019
2019_B18839,76,71,45,192,2019
2021_C18840,76,86,49,211,2021
2021_C18841,83,86,56,225,2021
2021_B18842,90,92,72,254,2021
2019_B18843,84,75,58,217,2019
2021_B18844,72,83,39,194,2021
2021_A18845,73,58,36,167,2021
2021_B18846,80,51,44,175,2021
2019_C18847,77,62,64,203,2019
2021_A18848,72,91,70,233,2021
2019_A18849,72,51,72,195,2019
2019_C18850,87,83,78,248,2019
2022_B18851,94,90,49,233,2022
2021_B18852,92,91,39,222,2021
2022_C18853,95,71,66,232,2022
2019_A18854,90,64,45,199,2019
2022_C18855,95,68,36,199,2022
2021_A18856,76,82,49,207,2021
2022_B18857,82,68,79,229,2022
2019_B18858,92,64,69,225,2019
2019_A18859,89,95,48,232,2019
2021_A18860,86,83,68,237,2021
2021_C18861,95,50,47,192,2021
2021_A18862,88,83,78,249,2021
2019_A18863,76,94,52,222,2019
2021_B18864,79,67,54,200,2021
2022_A18865,71,80,48,199,2022
2021_A18866,97,53,43,193,2021
2022_A18867,77,78,53,208,2022
2021_B18868,89,72,48,209,2021
2019_C18869,83,95,79,257,2019
2022_C18870,91,70,75,236,2022
2019_A18871,88,54,77,219,2019
2019_C18872,80,89,43,212,2019
2019_A18873,81,47,55,183,2019
2019_C18874,89,89,52,230,2019
2021_A18875,93,96,48,237,2021
2022_B18876,86,83,39,208,2022
2021_B18877,71,46,69,186,2021
2022_A18878,73,62,59,194,2022
2021_C18879,84,53,69,206,2021
2022_B18880,71,45,47,163,2022
2021_C18881,87,46,59,192,2021
2019_C18882,92,50,71,213,2019
2019_A18883,96,62,70,228,2019
2021_A18884,86,56,77,219,2021
2022_B18885,92,64,70,226,2022
2022_B18886,93,50,65,208,2022
2022_A18887,86,90,42,218,2022
2021_B18888,85,69,64,218,2021
2022_B18889,85,62,36,183,2022
2019_B18890,73,79,35,187,2019
2021_B18891,74,53,62,189,2021
2022_A18892,85,45,64,194,2022
2019_B18893,86,49,73,208,2019
2021_B18894,76,51,58,185,2021
2022_C18895,88,58,50,196,2022
2021_B18896,89,63,35,187,2021
2021_B18897,81,76,38,195,2021
2019_B18898,90,73,62,225,2019
2021_C18899,87,56,41,184,2021
2022_C18900,91,82,62,235,2022
2021_A18901,91,45,74,210,2021
2022_B18902,85,90,66,241,2022
2019_C18903,71,56,55,182,2019
2022_B18904,77,84,38,199,2022
2021_B18905,90,85,36,211,2021
2021_C18906,73,63,70,206,2021
2021_B18907,74,94,43,211,2021
2019_C18908,91,62,70,223,2019
2021_C18909,83,73,40,196,2021
2022_A18910,93,82,48,223,2022
2022_C18911,96,69,55,220,2022
2019_A18912,73,88,43,204,2019
2022_C18913,81,65,68,214,2022
2022_B18914,96,88,69,253,2022
2021_C18915,81,63,35,179,2021
2019_A18916,91,66,56,213,2019
2022_B18917,82,52,40,174,2022
2019_A18918,95,55,54,204,2019
2021_C18919,83,51,78,212,2021
2022_A18920,88,92,62,242,2022
2019_B18921,85,94,48,227,2019
2022_C18922,85,49,78,212,2022
2021_C18923,93,71,35,199,2021
2021_A18924,85,59,73,217,2021
2022_C18925,81,70,46,197,2022
2019_B18926,80,77,78,235,2019
2019_B18927,82,93,50,225,2019
2022_B18928,75,96,60,231,2022
2019_A18929,88,65,59,212,2019
2022_A18930,90,85,70,245,2022
2022_B18931,86,70,59,215,2022
2019_A18932,77,74,57,208,2019
2021_A18933,71,63,63,197,2021
2019_B18934,90,69,57,216,2019
2019_B18935,94,47,58,199,2019
2019_B18936,92,68,51,211,2019
2022_A18937,86,46,70,202,2022
2021_B18938,91,81,38,210,2021
2021_C18939,95,68,52,215,2021
2019_C18940,84,86,46,216,2019
2019_B18941,79,69,68,216,2019
2022_A18942,86,65,73,224,2022
2022_C18943,71,88,66,225,2022
2019_B18944,95,47,50,192,2019
2021_C18945,96,51,41,188,2021
2022_A18946,90,63,61,214,2022
2019_B18947,95,76,37,208,2019
2019_B18948,84,79,79,242,2019
2022_C18949,96,64,73,233,2022
2019_A18950,75,86,77,238,2019
2019_C18951,81,96,66,243,2019
2022_B18952,94,71,52,217,2022
2021_A18953,83,66,54,203,2021
2021_C18954,73,45,70,188,2021
2021_B18955,75,94,74,243,2021
2022_C18956,88,91,62,241,2022
2022_A18957,91,58,68,217,2022
2021_B18958,84,93,36,213,2021
2022_C18959,79,78,53,210,2022
2022_B18960,82,89,78,249,2022
2022_C18961,77,68,62,207,2022
2019_B18962,74,75,44,193,2019
2021_A18963,88,75,46,209,2021
2019_A18964,89,92,42,223,2019
2022_A18965,81,87,76,244,2022
2019_C18966,95,75,79,249,2019
2019_C18967,85,65,50,200,2019
2021_B18968,79,58,78,215,2021
2019_C18969,95,72,40,207,2019
2019_B18970,87,51,37,175,2019
2019_C18971,79,53,51,183,2019
2019_B18972,95,78,76,249,2019
2019_B18973,78,56,44,178,2019
2021_A18974,94,54,68,216,2021
2021_B18975,71,91,46,208,2021
2019_A18976,91,66,78,235,2019
2019_B18977,80,88,41,209,2019
2021_B18978,86,51,75,212,2021
2021_B18979,91,55,64,210,2021
2022_A18980,86,56,56,198,2022
2022_C18981,93,88,65,246,2022
2022_B18982,87,64,56,207,2022
2019_C18983,88,45,37,170,2019
2022_B18984,71,90,39,200,2022
2022_B18985,76,51,45,172,2022
2019_C18986,86,45,66,197,2019
2021_B18987,90,63,43,196,2021
2022_A18988,93,76,68,237,2022
2019_B18989,95,75,45,215,2019
2019_B18990,86,55,78,219,2019
2021_C18991,76,87,70,233,2021
2022_C18992,81,91,51,223,2022
2022_B18993,72,84,70,226,2022
2022_C18994,93,49,46,188,2022
2019_C18995,86,78,49,213,2019
2021_C18996,76,80,72,228,2021
2019_C18997,77,70,63,210,2019
2021_A18998,84,47,61,192,2021
2021_A18999,90,54,78,222,2021
2021_B19000,93,65,43,201,2021
2022_A19001,83,79,73,235,2022
2019_A19002,76,69,45,190,2019
2021_C19003,95,53,58,206,2021
2019_C19004,78,73,46,197,2019
2019_A19005,94,51,62,207,2019
2019_C19006,88,78,65,231,2019
2022_C19007,97,69,49,215,2022
2022_B19008,90,62,37,189,2022
2019_C19009,94,94,71,259,2019
2019_C19010,90,60,38,188,2019
2021_B19011,83,79,46,208,2021
2022_A19012,88,72,78,238,2022
2021_B19013,89,96,78,263,2021
2022_A19014,84,67,70,221,2022
2022_C19015,95,66,76,237,2022
2022_B19016,82,77,41,200,2022
2022_A19017,90,91,47,228,2022
2021_A19018,81,70,47,198,2021
2022_B19019,77,56,74,207,2022
2021_B19020,82,53,53,188,2021
2021_B19021,88,94,35,217,2021
2019_A19022,72,59,61,192,2019
2019_B19023,80,60,56,196,2019
2022_C19024,79,91,49,219,2022
2022_C19025,87,50,71,208,2022
2019_A19026,74,74,44,192,2019
2022_A19027,87,75,58,220,2022
2019_B19028,89,78,57,224,2019
2019_C19029,79,84,38,201,2019
2022_B19030,97,59,43,199,2022
2022_A19031,80,74,53,207,2022
2019_A19032,88,90,38,216,2019
2022_B19033,72,88,58,218,2022
2022_B19034,73,61,64,198,2022
2022_C19035,87,85,39,211,2022
2021_C19036,86,61,44,191,2021
2022_A19037,89,61,47,197,2022
2022_C19038,84,51,46,181,2022
2019_C19039,78,78,59,215,2019
2019_B19040,86,90,61,237,2019
2019_A19041,77,52,46,175,2019
2022_A19042,91,60,71,222,2022
2019_A19043,93,59,70,222,2019
2021_A19044,85,60,35,180,2021
2022_C19045,76,69,50,195,2022
2019_B19046,80,83,41,204,2019
2019_C19047,77,74,76,227,2019
2019_A19048,86,50,59,195,2019
2021_B19049,72,91,71,234,2021
2019_C19050,80,87,38,205,2019
2019_B19051,72,92,63,227,2019
2021_C19052,89,72,47,208,2021
2021_A19053,89,48,41,178,2021
2019_C19054,87,49,45,181,2019
2021_B19055,74,49,56,179,2021
2022_C19056,78,86,79,243,2022
2021_B19057,95,90,78,263,2021
2019_B19058,84,74,53,211,2019
2021_B19059,77,63,69,209,2021
2022_B19060,95,61,72,228,2022
2022_C19061,93,71,71,235,2022
2019_B19062,74,91,65,230,2019
2021_B19063,79,77,37,193,2021
2022_B19064,95,71,72,238,2022
2022_B19065,96,72,59,227,2022
2019_C19066,91,55,78,224,2019
2022_A19067,77,66,54,197,2022
2022_B19068,71,76,57,204,2022
2021_A19069,97,94,41,232,2021
2019_A19070,89,95,68,252,2019
2019_A19071,76,95,76,247,2019
2021_A19072,87,61,36,184,2021
2019_C19073,86,92,47,225,2019
2021_B19074,97,78,35,210,2021
2021_C19075,90,86,46,222,2021
2022_B19076,79,85,62,226,2022
2019_B19077,75,59,63,197,2019
2022_C19078,81,53,39,173,2022
2022_A19079,85,78,61,224,2022
2022_A19080,83,84,46,213,2022
2019_C19081,73,75,58,206,2019
2022_B19082,74,63,57,194,2022
2019_C19083,83,62,78,223,2019
2021_A19084,86,91,58,235,2021
2022_C19085,94,58,48,200,2022
2019_B19086,75,51,79,205,2019
2019_C19087,79,55,59,193,2019
2021_A19088,97,79,45,221,2021
2021_C19089,89,58,66,213,2021
2019_C19090,95,78,61,234,2019
2019_C19091,81,55,67,203,2019
2019_A19092,88,68,62,218,2019
2019_A19093,80,67,39,186,2019
2022_A19094,77,96,51,224,2022
2022_A19095,86,83,64,233,2022
2022_C19096,88,82,79,249,2022
2022_C19097,71,52,43,166,2022
2022_A19098,83,74,41,198,2022
2019_B19099,77,74,74,225,2019
2022_C19100,75,80,62,217,2022
2021_C19101,84,58,79,221,2021
2019_C19102,81,74,39,194,2019
2021_C19103,88,73,38,199,2021
2022_A19104,92,65,60,217,2022
2022_A19105,72,89,70,231,2022
2019_C19106,90,89,43,222,2019
2022_B19107,72,95,61,228,2022
2021_C19108,86,45,75,206,2021
2021_B19109,91,82,72,245,2021
2021_A19110,94,63,59,216,2021
2019_C19111,93,74,77,244,2019
2021_B19112,94,58,76,228,2021
2019_B19113,75,47,39,161,2019
2022_C19114,80,53,74,207,2022
2019_B19115,95,63,42,200,2019
2022_B19116,75,47,39,161,2022
2019_B19117,87,91,77,255,2019
2019_A19118,82,83,63,228,2019
2019_A19119,89,58,76,223,2019
2019_C19120,84,77,57,218,2019
2022_B19121,89,94,43,226,2022
2019_B19122,90,46,60,196,2019
2019_C19123,84,53,62,199,2019
2021_B19124,82,53,46,181,2021
2022_B19125,85,76,74,235,2022
2022_C19126,71,61,62,194,2022
2021_A19127,88,57,71,216,2021
2021_B19128,90,96,36,222,2021
2022_A19129,76,92,48,216,2022
2019_C19130,87,96,68,251,2019
2019_C19131,75,66,72,213,2019
2022_A19132,82,69,69,220,2022
2021_A19133,85,48,36,169,2021
2021_C19134,92,87,42,221,2021
2021_B19135,94,56,79,229,2021
2021_B19136,96,54,65,215,2021
2019_C19137,73,63,35,171,2019
2021_B19138,71,55,78,204,2021
2022_B19139,81,85,37,203,2022
2022_C19140,87,64,61,212,2022
2019_B19141,93,72,46,211,2019
2021_A19142,87,69,75,231,2021
2019_B19143,86,95,74,255,2019
2019_C19144,87,64,46,197,2019
2021_B19145,94,53,37,184,2021
2019_C19146,76,78,44,198,2019
2019_C19147,76,71,79,226,2019
2019_C19148,87,46,60,193,2019
2019_B19149,94,56,45,195,2019
2021_C19150,88,57,78,223,2021
2021_C19151,74,56,73,203,2021
2021_A19152,84,49,71,204,2021
2019_C19153,91,63,70,224,2019
2021_A19154,87,60,66,213,2021
2021_A19155,94,83,42,219,2021
2022_B19156,90,75,64,229,2022
2022_B19157,76,93,49,218,2022
2019_A19158,77,63,46,186,2019
2021_A19159,76,47,42,165,2021
2019_A19160,76,93,44,213,2019
2022_C19161,89,52,68,209,2022
2021_C19162,94,51,52,197,2021
2022_A19163,89,78,62,229,2022
2021_C19164,95,70,55,220,2021
2022_A19165,91,45,57,193,2022
2021_B19166,84,88,35,207,2021
2019_B19167,88,76,69,233,2019
2019_A19168,85,91,49,225,2019
2019_A19169,85,72,38,195,2019
2021_B19170,79,96,57,232,2021
2019_C19171,89,82,62,233,2019
2019_C19172,93,57,57,207,2019
2022_B19173,74,83,62,219,2022
2022_B19174,74,46,64,184,2022
2022_C19175,77,49,48,174,2022
2021_C19176,86,69,74,229,2021
2019_C19177,97,54,65,216,2019
2022_A19178,83,81,73,237,2022
2021_B19179,93,93,61,247,2021
2021_A19180,72,96,71,239,2021
2019_A19181,84,72,59,215,2019
2019_A19182,74,76,37,187,2019
2022_B19183,76,87,70,233,2022
2021_B19184,90,69,58,217,2021
2021_A19185,79,62,43,184,2021
2021_C19186,71,76,55,202,2021
2019_C19187,89,73,38,200,2019
2021_A19188,90,53,36,179,2021
2019_C19189,88,47,50,185,2019
2019_A19190,89,60,69,218,2019
2021_B19191,96,57,73,226,2021
2022_B19192,79,54,45,178,2022
2022_A19193,72,79,68,219,2022
2021_B19194,97,95,62,254,2021
2021_B19195,88,58,72,218,2021
2021_A19196,91,70,63,224,2021
2019_C19197,95,55,61,211,2019
2019_A19198,75,50,55,180,2019
2019_A19199,94,51,74,219,2019
2021_B19200,81,71,47,199,2021
2019_A19201,88,62,57,207,2019
2019_A19202,71,58,38,167,2019
2021_A19203,95,56,41,192,2021
2019_C19204,77,79,45,201,2019
2021_C19205,91,55,46,192,2021
2019_C19206,73,83,37,193,2019
2021_C19207,75,86,50,211,2021
2019_B19208,86,52,68,206,2019
2021_A19209,72,85,56,213,2021
2022_A19210,93,45,46,184,2022
2021_A19211,87,64,67,218,2021
2019_C19212,79,76,47,202,2019
2022_C19213,96,65,76,237,2022
2021_B19214,82,72,38,192,2021
2019_A19215,83,70,77,230,2019
2022_B19216,71,92,35,198,2022
2019_B19217,96,62,63,221,2019
2019_C19218,85,57,73,215,2019
2019_A19219,80,76,58,214,2019
2019_A19220,77,87,52,216,2019
2022_C19221,74,68,60,202,2022
2021_C19222,75,89,35,199,2021
2022_C19223,87,66,38,191,2022
2022_C19224,97,90,54,241,2022
2019_B19225,74,49,35,158,2019
2022_C19226,87,88,71,246,2022
2022_A19227,82,85,74,241,2022
2022_A19228,86,91,47,224,2022
2021_B19229,88,63,62,213,2021
2022_B19230,93,65,78,236,2022
2021_C19231,83,95,71,249,2021
2019_C19232,79,68,66,213,2019
2019_B19233,86,75,53,214,2019
2021_B19234,97,73,78,248,2021
2021_C19235,83,79,76,238,2021
2019_B19236,96,81,53,230,2019
2021_A19237,82,51,50,183,2021
2022_B19238,79,49,72,200,2022
2022_C19239,74,86,38,198,2022
2021_B19240,81,91,68,240,2021
2019_C19241,95,80,53,228,2019
2022_B19242,96,74,51,221,2022
2021_B19243,73,75,38,186,2021
2021_C19244,71,86,60,217,2021
2019_C19245,81,86,67,234,2019
2022_C19246,83,68,61,212,2022
2022_B19247,76,87,63,226,2022
2022_B19248,75,67,77,219,2022
2021_C19249,89,71,37,197,2021
2022_C19250,87,63,53,203,2022
2019_B19251,93,88,50,231,2019
2021_A19252,87,69,39,195,2021
2022_C19253,74,74,61,209,2022
2022_A19254,87,61,70,218,2022
2022_C19255,76,63,48,187,2022
2019_B19256,97,55,79,231,2019
2019_B19257,90,73,46,209,2019
2022_C19258,87,71,51,209,2022
2022_A19259,73,93,63,229,2022
2022_A19260,83,72,46,201,2022
2021_C19261,93,57,65,215,2021
2022_C19262,96,89,47,232,2022
2021_B19263,95,75,55,225,2021
2022_A19264,73,60,66,199,2022
2019_B19265,89,73,72,234,2019
2022_B19266,96,69,64,229,2022
2019_B19267,85,75,35,195,2019
2021_C19268,78,52,51,181,2021
2021_C19269,79,60,63,202,2021
2021_A19270,81,74,79,234,2021
2019_B19271,71,78,59,208,2019
2021_A19272,95,56,78,229,2021
2019_B19273,94,94,73,261,2019
2019_C19274,86,65,56,207,2019
2022_B19275,86,94,51,231,2022
2019_A19276,94,78,58,230,2019
2022_C19277,72,80,59,211,2022
2021_B19278,72,59,50,181,2021
2019_A19279,78,65,48,191,2019
2021_C19280,97,50,77,224,2021
2021_B19281,75,71,38,184,2021
2021_B19282,75,60,41,176,2021
2022_B19283,71,68,66,205,2022
2021_C19284,79,73,56,208,2021
2022_B19285,91,61,39,191,2022
2022_A19286,80,68,61,209,2022
2019_C19287,96,52,56,204,2019
2022_A19288,89,73,57,219,2022
2022_C19289,92,47,41,180,2022
2019_A19290,72,78,41,191,2019
2022_C19291,82,52,58,192,2022
2021_B19292,96,90,65,251,2021
2019_C19293,86,85,41,212,2019
2019_C19294,95,84,53,232,2019
2021_C19295,73,88,76,237,2021
2022_C19296,75,52,75,202,2022
2022_B19297,93,94,40,227,2022
2022_A19298,91,59,52,202,2022
2019_B19299,73,95,76,244,2019
2022_B19300,81,73,67,221,2022
2022_C19301,82,50,72,204,2022
2019_C19302,76,89,55,220,2019
2019_A19303,95,71,53,219,2019
2022_B19304,81,63,79,223,2022
2022_B19305,75,71,50,196,2022
2022_C19306,95,81,44,220,2022
2021_B19307,86,58,54,198,2021
2022_A19308,92,95,60,247,2022
2022_A19309,97,82,38,217,2022
2021_A19310,88,88,55,231,2021
2022_A19311,79,46,72,197,2022
2022_C19312,92,67,59,218,2022
2022_C19313,87,58,71,216,2022
2022_A19314,85,78,38,201,2022
2019_B19315,85,55,57,197,2019
2022_B19316,96,73,37,206,2022
2019_B19317,92,83,64,239,2019
2019_C19318,87,53,46,186,2019
2021_A19319,78,96,76,250,2021
2021_A19320,75,89,35,199,2021
2021_A19321,95,75,51,221,2021
2021_B19322,97,75,52,224,2021
2022_A19323,95,54,60,209,2022
2021_A19324,88,95,51,234,2021
2021_B19325,94,64,37,195,2021
2021_A19326,71,95,59,225,2021
2021_C19327,87,94,65,246,2021
2021_A19328,79,53,68,200,2021
2021_A19329,92,76,74,242,2021
2021_C19330,93,85,43,221,2021
2021_C19331,85,47,43,175,2021
2021_C19332,87,68,79,234,2021
2019_B19333,92,57,59,208,2019
2021_C19334,97,90,60,247,2021
2021_A19335,77,70,37,184,2021
2022_A19336,76,78,37,191,2022
2021_C19337,93,90,79,262,2021
2022_A19338,71,56,55,182,2022
2022_A19339,80,53,51,184,2022
2022_C19340,83,61,67,211,2022
2021_C19341,83,56,56,195,2021
2021_C19342,71,66,60,197,2021
2022_C19343,80,76,49,205,2022
2021_A19344,93,64,58,215,2021
2021_C19345,87,52,42,181,2021
2021_C19346,90,73,69,232,2021
2019_C19347,73,92,69,234,2019
2022_C19348,83,49,64,196,2022
2021_C19349,94,53,58,205,2021
2022_B19350,80,78,79,237,2022
2019_A19351,78,77,71,226,2019
2022_A19352,92,73,58,223,2022
2022_B19353,72,47,65,184,2022
2019_C19354,88,91,75,254,2019
2022_A19355,94,76,61,231,2022
2022_B19356,72,71,52,195,2022
2019_B19357,84,52,54,190,2019
2021_C19358,84,76,57,217,2021
2021_B19359,87,93,65,245,2021
2021_C19360,74,71,38,183,2021
2019_C19361,90,77,46,213,2019
2022_A19362,92,51,69,212,2022
2022_C19363,73,56,49,178,2022
2021_A19364,92,64,39,195,2021
2019_B19365,77,89,64,230,2019
2021_C19366,83,96,69,248,2021
2022_A19367,86,53,38,177,2022
2021_C19368,77,73,75,225,2021
2019_B19369,86,83,49,218,2019
2021_B19370,82,80,79,241,2021
2021_B19371,95,57,35,187,2021
2019_B19372,76,81,62,219,2019
2019_B19373,75,50,61,186,2019
2019_A19374,73,89,67,229,2019
2021_A19375,87,74,45,206,2021
2019_A19376,97,92,55,244,2019
2021_A19377,81,81,37,199,2021
2019_C19378,81,75,35,191,2019
2021_A19379,86,47,55,188,2021
2021_B19380,74,60,36,170,2021
2021_A19381,90,61,47,198,2021
2022_C19382,86,74,37,197,2022
2021_B19383,74,78,40,192,2021
2021_A19384,83,50,65,198,2021
2019_B19385,95,79,61,235,2019
2021_B19386,76,56,74,206,2021
2019_C19387,89,66,38,193,2019
2021_A19388,90,76,78,244,2021
2022_B19389,86,86,67,239,2022
2021_C19390,86,64,49,199,2021
2021_B19391,80,52,70,202,2021
2019_B19392,92,77,51,220,2019
2019_C19393,80,82,63,225,2019
2022_A19394,94,84,40,218,2022
2021_B19395,94,76,39,209,2021
2019_C19396,77,85,52,214,2019
2019_A19397,81,90,64,235,2019
2019_C19398,96,65,62,223,2019
2022_A19399,78,85,62,225,2022
2021_A19400,85,45,79,209,2021
2022_A19401,87,79,66,232,2022
2022_A19402,87,92,59,238,2022
2021_A19403,79,88,49,216,2021
2019_C19404,72,95,49,216,2019
2022_C19405,96,85,59,240,2022
2022_C19406,84,63,39,186,2022
2022_B19407,85,81,56,222,2022
2021_C19408,72,46,78,196,2021
2021_B19409,90,55,40,185,2021
2021_B19410,80,80,38,198,2021
2021_A19411,82,90,70,242,2021
2019_B19412,78,67,35,180,2019
2021_A19413,75,53,59,187,2021
2022_C19414,84,78,72,234,2022
2021_B19415,73,70,47,190,2021
2022_C19416,87,78,58,223,2022
2022_C19417,78,82,48,208,2022
2022_B19418,92,45,56,193,2022
2022_B19419,91,45,49,185,2022
2019_C19420,77,60,35,172,2019
2021_B19421,91,89,53,233,2021
2021_C19422,95,95,56,246,2021
2021_A19423,91,49,69,209,2021
2022_A19424,73,61,69,203,2022
2021_A19425,90,60,61,211,2021
2019_C19426,94,56,69,219,2019
2022_B19427,95,80,76,251,2022
2021_A19428,94,80,50,224,2021
2021_C19429,72,64,54,190,2021
2021_C19430,73,54,64,191,2021
2021_C19431,90,91,56,237,2021
2019_C19432,97,96,57,250,2019
2022_A19433,94,95,60,249,2022
2019_C19434,79,80,56,215,2019
2019_C19435,93,86,77,256,2019
2022_B19436,72,89,67,228,2022
2022_A19437,95,88,46,229,2022
2019_C19438,93,53,47,193,2019
2021_B19439,94,86,40,220,2021
2022_C19440,76,66,71,213,2022
2019_C19441,96,63,38,197,2019
2022_B19442,97,81,46,224,2022
2022_B19443,90,75,48,213,2022
2019_B19444,96,75,43,214,2019
2021_B19445,71,66,48,185,2021
2019_C19446,86,52,68,206,2019
2022_B19447,72,65,49,186,2022
2019_B19448,90,56,60,206,2019
2022_B19449,86,81,51,218,2022
2022_C19450,96,62,65,223,2022
2022_B19451,88,70,38,196,2022
2021_C19452,81,67,35,183,2021
2019_B19453,91,73,42,206,2019
2022_B19454,75,88,61,224,2022
2021_C19455,96,66,66,228,2021
2022_B19456,79,53,40,172,2022
2021_A19457,95,63,61,219,2021
2019_A19458,74,80,76,230,2019
2021_A19459,88,71,49,208,2021
2019_B19460,71,89,43,203,2019
2022_C19461,87,88,75,250,2022
2021_A19462,82,92,68,242,2021
2022_B19463,97,60,51,208,2022
2022_B19464,72,72,54,198,2022
2022_C19465,71,89,63,223,2022
2022_C19466,97,56,70,223,2022
2021_C19467,82,48,57,187,2021
2019_B19468,85,95,38,218,2019
2019_B19469,72,52,58,182,2019
2019_C19470,93,66,41,200,2019
2022_C19471,88,94,45,227,2022
2019_C19472,77,86,40,203,2019
2019_B19473,85,74,59,218,2019
2019_A19474,71,51,68,190,2019
2021_B19475,78,76,39,193,2021
2022_A19476,86,60,62,208,2022
2019_A19477,78,90,54,222,2019
2021_B19478,82,49,79,210,2021
2019_B19479,96,46,58,200,2019
2021_C19480,96,72,41,209,2021
2019_B19481,84,85,71,240,2019
2019_A19482,97,71,59,227,2019
2022_B19483,84,59,44,187,2022
2022_B19484,93,61,54,208,2022
2021_B19485,85,73,41,199,2021
2021_A19486,74,96,40,210,2021
2019_B19487,77,52,44,173,2019
2022_A19488,76,93,73,242,2022
2022_B19489,80,70,71,221,2022
2021_B19490,87,73,52,212,2021
2021_B19491,84,64,69,217,2021
2022_A19492,74,48,53,175,2022
2022_B19493,91,94,62,247,2022
2019_A19494,87,87,61,235,2019
2022_B19495,75,62,74,211,2022
2022_B19496,97,77,69,243,2022
2021_A19497,79,77,50,206,2021
2021_A19498,85,80,76,241,2021
2019_B19499,94,83,73,250,2019
2019_A19500,82,76,43,201,2019
2021_B19501,93,82,63,238,2021
2021_C19502,82,56,60,198,2021
2021_C19503,80,48,56,184,2021
2019_A19504,95,48,63,206,2019
2021_A19505,86,77,38,201,2021
2022_C19506,83,85,46,214,2022
2022_A19507,93,78,68,239,2022
2019_A19508,78,62,47,187,2019
2019_A19509,73,83,79,235,2019
2022_B19510,93,57,71,221,2022
2022_C19511,80,85,65,230,2022
2021_C19512,86,47,47,180,2021
2019_C19513,71,80,63,214,2019
2022_A19514,91,75,51,217,2022
2019_B19515,86,75,54,215,2019
2021_C19516,86,50,54,190,2021
2019_A19517,73,52,44,169,2019
2021_A19518,97,88,72,257,2021
2022_C19519,82,48,36,166,2022
2022_B19520,77,94,71,242,2022
2021_C19521,78,88,56,222,2021
2019_B19522,71,91,59,221,2019
2022_B19523,85,88,50,223,2022
2019_B19524,74,82,69,225,2019
2022_B19525,72,50,74,196,2022
2021_A19526,72,51,38,161,2021
2019_A19527,72,77,44,193,2019
2021_A19528,80,95,62,237,2021
2019_B19529,97,84,39,220,2019
2019_C19530,82,79,77,238,2019
2019_B19531,88,74,76,238,2019
2019_A19532,75,65,66,206,2019
2019_B19533,71,79,79,229,2019
2022_B19534,77,56,71,204,2022
2021_B19535,93,77,36,206,2021
2019_C19536,80,86,60,226,2019
2022_A19537,85,58,66,209,2022
2021_A19538,81,79,70,230,2021
2019_C19539,97,86,61,244,2019
2019_A19540,75,92,38,205,2019
2021_A19541,96,76,48,220,2021
2021_B19542,90,61,71,222,2021
2022_A19543,81,46,41,168,2022
2021_A19544,94,82,51,227,2021
2021_C19545,84,83,61,228,2021
2021_A19546,97,65,76,238,2021
2022_C19547,71,84,53,208,2022
2019_A19548,74,82,68,224,2019
2019_C19549,91,82,45,218,2019
2021_A19550,96,90,47,233,2021
2019_C19551,89,52,66,207,2019
2021_B19552,71,56,48,175,2021
2022_B19553,84,72,58,214,2022
2022_B19554,87,62,72,221,2022
2021_A19555,84,53,70,207,2021
2021_C19556,93,49,45,187,2021
2022_B19557,84,63,66,213,2022
2021_A19558,88,61,74,223,2021
2019_A19559,97,52,59,208,2019
2022_C19560,94,64,63,221,2022
2022_A19561,74,67,67,208,2022
2022_A19562,81,53,79,213,2022
2021_B19563,74,54,76,204,2021
2019_C19564,84,88,54,226,2019
2021_B19565,90,89,63,242,2021
2022_C19566,95,67,58,220,2022
2021_B19567,81,46,53,180,2021
2021_C19568,71,65,79,215,2021
2021_C19569,74,56,68,198,2021
2019_C19570,92,50,75,217,2019
2021_B19571,96,72,42,210,2021
2022_A19572,72,55,69,196,2022
2019_B19573,96,45,62,203,2019
2019_A19574,97,50,35,182,2019
2019_B19575,84,72,68,224,2019
2019_A19576,80,77,36,193,2019
2019_B19577,93,50,72,215,2019
2021_B19578,87,88,41,216,2021
2019_A19579,96,70,67,233,2019
2021_B19580,95,77,47,219,2021
2021_A19581,74,76,59,209,2021
2022_A19582,83,69,48,200,2022
2021_C19583,73,62,48,183,2021
2021_A19584,89,52,71,212,2021
2021_A19585,94,49,52,195,2021
2021_C19586,75,56,63,194,2021
2022_A19587,84,80,65,229,2022
2021_A19588,94,88,68,250,2021
2021_C19589,73,91,36,200,2021
2021_A19590,89,57,60,206,2021
2021_A19591,88,51,65,204,2021
2021_C19592,96,71,71,238,2021
2022_B19593,80,70,36,186,2022
2019_B19594,73,87,79,239,2019
2021_B19595,73,63,61,197,2021
2022_A19596,95,91,57,243,2022
2019_A19597,78,96,61,235,2019
2021_A19598,86,64,48,198,2021
2021_A19599,71,70,62,203,2021
2022_A19600,73,72,66,211,2022
2021_C19601,71,64,73,208,2021
2022_C19602,82,86,45,213,2022
2021_B19603,89,49,68,206,2021
2021_A19604,97,79,61,237,2021
2021_C19605,73,67,53,193,2021
2021_B19606,86,61,51,198,2021
2022_A19607,92,47,72,211,2022
2019_A19608,95,68,42,205,2019
2019_A19609,97,92,71,260,2019
2021_A19610,74,96,74,244,2021
2021_C19611,76,96,51,223,2021
2019_A19612,78,94,43,215,2019
2022_B19613,95,61,70,226,2022
2019_C19614,81,47,78,206,2019
2021_A19615,80,73,62,215,2021
2022_C19616,76,61,71,208,2022
2019_B19617,91,57,69,217,2019
2021_A19618,71,52,72,195,2021
2019_A19619,82,77,52,211,2019
2019_C19620,95,69,35,199,2019
2019_B19621,86,54,79,219,2019
2021_B19622,78,68,41,187,2021
2019_C19623,94,85,78,257,2019
2022_A19624,87,96,79,262,2022
2021_B19625,94,93,69,256,2021
2021_A19626,95,73,64,232,2021
2021_C19627,82,85,73,240,2021
2021_B19628,72,82,69,223,2021
2021_C19629,88,52,57,197,2021
2019_B19630,75,64,65,204,2019
2019_A19631,76,65,51,192,2019
2019_B19632,95,96,43,234,2019
2021_C19633,76,93,52,221,2021
2019_A19634,93,91,35,219,2019
2019_B19635,95,60,65,220,2019
2022_C19636,73,78,77,228,2022
2019_C19637,85,74,45,204,2019
2021_C19638,86,76,72,234,2021
2022_C19639,84,74,62,220,2022
2019_A19640,92,76,41,209,2019
2019_B19641,72,68,43,183,2019
2021_A19642,79,80,59,218,2021
2019_C19643,82,93,51,226,2019
2022_A19644,86,51,77,214,2022
2022_A19645,95,50,56,201,2022
2019_B19646,96,96,50,242,2019
2019_C19647,94,92,65,251,2019
2021_A19648,85,94,61,240,2021
2022_C19649,87,95,60,242,2022
2022_A19650,84,89,43,216,2022
2022_B19651,73,72,40,185,2022
2022_B19652,72,61,72,205,2022
2019_B19653,91,63,39,193,2019
2019_C19654,79,48,57,184,2019
2019_B19655,91,51,36,178,2019
2021_C19656,95,81,58,234,2021
2019_C19657,91,83,76,250,2019
2022_B19658,80,46,62,188,2022
2019_A19659,91,72,68,231,2019
2021_C19660,75,62,40,177,2021
2022_C19661,95,92,66,253,2022
2019_A19662,71,80,43,194,2019
2022_B19663,80,48,74,202,2022
2021_B19664,97,72,74,243,2021
2019_B19665,85,77,78,240,2019
2022_C19666,95,60,69,224,2022
2021_A19667,74,72,74,220,2021
2019_B19668,77,93,54,224,2019
2019_C19669,82,49,53,184,2019
2019_C19670,78,64,45,187,2019
2021_B19671,89,62,41,192,2021
2021_A19672,89,93,67,249,2021
2019_B19673,79,63,47,189,2019
2022_A19674,80,53,65,198,2022
2022_A19675,78,78,67,223,2022
2022_C19676,85,80,49,214,2022
2019_C19677,83,53,55,191,2019
2021_A19678,71,45,42,158,2021
2022_A19679,97,72,62,231,2022
2019_B19680,87,63,56,206,2019
2022_B19681,97,75,69,241,2022
2021_A19682,75,76,45,196,2021
2021_A19683,91,70,60,221,2021
2022_B19684,72,52,56,180,2022
2021_A19685,85,94,69,248,2021
2019_A19686,97,61,37,195,2019
2021_A19687,82,83,41,206,2021
2019_C19688,88,65,77,230,2019
2019_C19689,96,73,71,240,2019
2019_A19690,86,60,63,209,2019
2021_C19691,93,71,40,204,2021
2022_B19692,80,58,51,189,2022
2022_A19693,90,78,60,228,2022
2019_C19694,89,74,38,201,2019
2021_A19695,76,65,77,218,2021
2019_B19696,83,88,49,220,2019
2019_A19697,88,64,70,222,2019
2019_A19698,85,46,39,170,2019
2019_C19699,88,72,63,223,2019
2022_B19700,80,86,65,231,2022
2021_A19701,95,91,41,227,2021
2019_A19702,85,75,78,238,2019
2019_A19703,88,67,71,226,2019
2019_C19704,97,66,47,210,2019
2021_A19705,90,52,44,186,2021
2022_B19706,97,60,50,207,2022
2021_B19707,95,88,77,260,2021
2021_B19708,72,76,41,189,2021
2022_B19709,94,79,60,233,2022
2021_A19710,79,67,70,216,2021
2021_B19711,75,62,43,180,2021
2022_C19712,86,89,64,239,2022
2021_A19713,93,67,46,206,2021
2022_B19714,91,55,68,214,2022
2022_B19715,73,86,60,219,2022
2019_A19716,79,93,54,226,2019
2021_C19717,80,55,74,209,2021
2022_A19718,95,63,69,227,2022
2019_A19719,80,52,76,208,2019
2019_B19720,71,71,75,217,2019
2019_C19721,97,83,79,259,2019
2022_C19722,74,82,50,206,2022
2019_A19723,93,89,67,249,2019
2022_B19724,78,95,62,235,2022
2021_C19725,80,61,56,197,2021
2021_C19726,81,91,52,224,2021
2021_A19727,85,81,53,219,2021
2021_A19728,92,88,57,237,2021
2019_B19729,96,80,69,245,2019
2022_A19730,78,57,49,184,2022
2019_C19731,75,85,76,236,2019
2019_B19732,91,95,36,222,2019
2021_B19733,85,87,54,226,2021
2019_A19734,92,78,76,246,2019
2022_B19735,87,93,53,233,2022
2022_A19736,95,58,45,198,2022
2019_A19737,78,84,69,231,2019
2021_B19738,82,74,73,229,2021
2021_A19739,83,84,75,242,2021
2022_A19740,93,71,53,217,2022
2019_A19741,84,68,55,207,2019
2022_A19742,94,45,36,175,2022
2022_B19743,92,94,51,237,2022
2019_A19744,96,45,64,205,2019
2021_A19745,84,88,50,222,2021
2022_A19746,82,50,42,174,2022
2021_B19747,80,91,44,215,2021
2022_A19748,79,46,75,200,2022
2021_B19749,87,61,40,188,2021
2022_B19750,77,96,43,216,2022
2021_C19751,95,67,49,211,2021
2022_A19752,80,69,46,195,2022
2019_B19753,80,59,65,204,2019
2021_C19754,91,64,40,195,2021
2021_B19755,82,66,64,212,2021
2022_C19756,93,78,37,208,2022
2022_C19757,77,65,73,215,2022
2022_C19758,88,60,57,205,2022
2022_A19759,87,57,69,213,2022
2022_B19760,77,94,58,229,2022
2019_B19761,79,74,64,217,2019
2019_B19762,87,75,62,224,2019
2022_B19763,77,77,44,198,2022
2022_B19764,79,92,47,218,2022
2022_C19765,97,95,68,260,2022
2019_A19766,91,59,39,189,2019
2022_B19767,74,50,39,163,2022
2022_C19768,88,88,76,252,2022
2022_A19769,72,68,62,202,2022
2019_C19770,90,81,42,213,2019
2021_B19771,80,45,72,197,2021
2022_A19772,73,89,76,238,2022
2021_A19773,95,73,62,230,2021
2019_C19774,93,85,49,227,2019
2022_C19775,88,96,68,252,2022
2022_B19776,93,70,57,220,2022
2021_B19777,81,48,54,183,2021
2019_A19778,71,50,51,172,2019
2019_A19779,93,47,73,213,2019
2022_A19780,81,69,58,208,2022
2022_B19781,86,55,59,200,2022
2021_A19782,85,54,78,217,2021
2019_C19783,91,76,54,221,2019
2021_C19784,80,65,48,193,2021
2022_B19785,89,82,45,216,2022
2019_C19786,84,45,70,199,2019
2019_A19787,82,64,70,216,2019
2019_A19788,79,73,71,223,2019
2022_B19789,88,84,63,235,2022
2019_B19790,97,71,60,228,2019
2019_C19791,76,81,53,210,2019
2022_B19792,94,51,37,182,2022
2022_A19793,80,77,44,201,2022
2021_C19794,87,94,64,245,2021
2019_B19795,74,73,72,219,2019
2019_C19796,78,95,76,249,2019
2022_B19797,92,68,40,200,2022
2021_B19798,92,62,55,209,2021
2022_C19799,75,81,65,221,2022
2021_B19800,86,93,46,225,2021
2021_C19801,75,85,36,196,2021
2021_A19802,96,85,55,236,2021
2022_A19803,71,45,46,162,2022
2021_C19804,96,61,52,209,2021
2019_A19805,93,96,52,241,2019
2019_A19806,95,47,64,206,2019
2021_C19807,77,74,65,216,2021
2022_C19808,93,88,73,254,2022
2019_C19809,73,91,55,219,2019
2021_B19810,87,89,66,242,2021
2021_A19811,77,76,60,213,2021
2022_C19812,71,50,42,163,2022
2021_B19813,72,47,63,182,2021
2021_B19814,84,94,44,222,2021
2019_C19815,72,78,37,187,2019
2021_B19816,92,58,67,217,2021
2022_B19817,88,53,37,178,2022
2019_A19818,84,93,70,247,2019
2022_C19819,83,93,56,232,2022
2019_B19820,92,87,47,226,2019
2019_A19821,94,92,37,223,2019
2022_B19822,84,68,57,209,2022
2019_B19823,73,78,54,205,2019
2019_A19824,92,67,44,203,2019
2021_B19825,85,87,70,242,2021
2022_A19826,81,48,65,194,2022
2019_B19827,89,81,59,229,2019
2019_A19828,96,71,64,231,2019
2021_A19829,77,64,66,207,2021
2022_C19830,86,73,72,231,2022
2022_C19831,77,64,51,192,2022
2019_A19832,72,75,44,191,2019
2021_A19833,81,84,42,207,2021
2022_B19834,76,77,45,198,2022
2021_A19835,97,62,73,232,2021
2021_C19836,71,94,47,212,2021
2021_B19837,71,48,50,169,2021
2022_C19838,95,85,73,253,2022
2019_C19839,81,46,77,204,2019
2022_A19840,71,89,64,224,2022
2019_B19841,80,70,70,220,2019
2021_C19842,92,95,67,254,2021
2019_B19843,78,71,37,186,2019
2022_B19844,79,89,36,204,2022
2022_C19845,96,60,69,225,2022
2021_C19846,75,73,56,204,2021
2019_C19847,84,93,66,243,2019
2022_A19848,84,63,46,193,2022
2022_B19849,85,88,52,225,2022
2021_C19850,87,81,70,238,2021
2019_A19851,95,63,68,226,2019
2019_A19852,74,82,41,197,2019
2022_C19853,79,60,49,188,2022
2022_A19854,90,95,66,251,2022
2019_A19855,81,56,40,177,2019
2019_C19856,88,60,77,225,2019
2022_C19857,80,68,74,222,2022
2019_C19858,72,73,60,205,2019
2021_C19859,94,92,55,241,2021
2021_C19860,84,75,69,228,2021
2022_A19861,86,77,73,236,2022
2022_A19862,83,45,61,189,2022
2022_C19863,88,74,39,201,2022
2022_C19864,72,95,46,213,2022
2022_A19865,74,79,75,228,2022
2021_C19866,85,55,51,191,2021
2021_B19867,90,45,76,211,2021
2022_B19868,77,87,77,241,2022
2019_C19869,91,65,60,216,2019
2022_B19870,75,51,45,171,2022
2019_B19871,76,95,45,216,2019
2022_A19872,82,94,52,228,2022
2019_B19873,89,62,52,203,2019
2019_C19874,89,96,36,221,2019
2019_B19875,73,59,61,193,2019
2019_C19876,79,74,64,217,2019
2022_A19877,88,84,61,233,2022
2021_C19878,89,92,37,218,2021
2022_A19879,92,52,55,199,2022
2019_C19880,75,89,71,235,2019
2019_C19881,73,94,45,212,2019
2021_A19882,76,52,61,189,2021
2022_C19883,75,90,59,224,2022
2021_B19884,87,59,62,208,2021
2022_A19885,85,76,51,212,2022
2022_A19886,77,55,35,167,2022
2021_C19887,95,76,60,231,2021
2021_B19888,75,66,50,191,2021
2021_A19889,79,78,41,198,2021
2022_A19890,72,89,61,222,2022
2022_C19891,76,81,62,219,2022
2019_C19892,88,74,53,215,2019
2022_A19893,94,72,45,211,2022
2022_A19894,75,67,72,214,2022
2022_A19895,95,79,64,238,2022
2021_A19896,85,65,47,197,2021
2022_C19897,94,60,47,201,2022
2019_A19898,81,89,42,212,2019
2019_B19899,94,80,43,217,2019
2021_C19900,76,94,74,244,2021
2022_A19901,79,79,43,201,2022
2022_C19902,71,87,76,234,2022
2022_B19903,79,46,63,188,2022
2019_A19904,94,96,59,249,2019
2019_B19905,80,45,64,189,2019
2019_A19906,87,77,68,232,2019
2022_B19907,81,77,41,199,2022
2021_C19908,81,90,53,224,2021
2021_B19909,96,81,40,217,2021
2021_A19910,90,92,79,261,2021
2022_A19911,94,68,55,217,2022
2021_A19912,91,49,66,206,2021
2022_B19913,72,66,76,214,2022
2022_A19914,82,54,65,201,2022
2022_A19915,90,84,40,214,2022
2019_B19916,94,92,37,223,2019
2021_C19917,89,78,76,243,2021
2021_C19918,83,79,57,219,2021
2019_A19919,86,48,47,181,2019
2019_B19920,77,96,52,225,2019
2022_A19921,88,57,45,190,2022
2021_C19922,76,85,73,234,2021
2019_C19923,93,62,35,190,2019
2021_C19924,79,71,69,219,2021
2022_B19925,85,83,48,216,2022
2019_A19926,76,60,60,196,2019
2022_A19927,77,71,71,219,2022
2019_A19928,95,54,42,191,2019
2022_A19929,79,71,79,229,2022
2022_B19930,76,93,52,221,2022
2021_A19931,86,71,46,203,2021
2022_C19932,93,67,78,238,2022
2022_C19933,84,77,60,221,2022
2019_A19934,71,57,76,204,2019
2019_A19935,72,62,59,193,2019
2021_B19936,91,52,55,198,2021
2021_C19937,84,96,71,251,2021
2019_A19938,86,82,35,203,2019
2019_B19939,87,47,67,201,2019
2022_B19940,91,96,78,265,2022
2022_B19941,76,65,55,196,2022
2022_A19942,89,79,50,218,2022
2021_A19943,88,89,74,251,2021
2022_C19944,75,62,67,204,2022
2021_C19945,79,69,43,191,2021
2019_B19946,97,63,68,228,2019
2021_A19947,77,76,66,219,2021
2019_A19948,92,50,56,198,2019
2019_A19949,76,85,37,198,2019
2022_A19950,97,53,65,215,2022
2019_A19951,91,69,39,199,2019
2019_C19952,92,47,76,215,2019
2019_B19953,78,65,68,211,2019
2021_B19954,83,67,57,207,2021
2019_B19955,76,66,73,215,2019
2021_A19956,78,52,38,168,2021
2022_B19957,74,74,63,211,2022
2021_C19958,71,73,61,205,2021
2021_C19959,75,83,46,204,2021
2019_B19960,94,51,57,202,2019
2021_C19961,94,73,79,246,2021
2019_B19962,91,92,39,222,2019
2022_A19963,72,79,77,228,2022
2022_B19964,74,75,51,200,2022
2019_B19965,87,92,60,239,2019
2021_C19966,91,66,49,206,2021
2019_B19967,92,57,54,203,2019
2022_C19968,78,79,67,224,2022
2021_A19969,93,85,72,250,2021
2019_B19970,82,81,56,219,2019
2019_A19971,96,62,40,198,2019
2019_B19972,84,82,76,242,2019
2022_A19973,76,94,50,220,2022
2019_C19974,76,82,61,219,2019
2022_C19975,83,70,76,229,2022
2022_C19976,77,82,52,211,2022
2019_A19977,83,63,54,200,2019
2021_B19978,80,75,45,200,2021
2022_A19979,90,52,69,211,2022
2022_B19980,96,53,54,203,2022
2022_C19981,92,59,62,213,2022
2022_C19982,88,88,43,219,2022
2022_B19983,93,64,79,236,2022
2021_C19984,97,76,63,236,2021
2019_A19985,71,93,63,227,2019
2022_B19986,80,75,50,205,2022
2022_B19987,85,66,41,192,2022
2019_B19988,77,51,64,192,2019
2022_C19989,71,51,73,195,2022
2021_A19990,77,75,76,228,2021
2021_C19991,87,89,76,252,2021
2019_C19992,95,51,69,215,2019
2019_C19993,73,50,36,159,2019
2019_A19994,88,72,49,209,2019
2021_B19995,74,81,65,220,2021
2019_C19996,75,80,71,226,2019
2021_C19997,74,96,60,230,2021
2022_B19998,97,76,55,228,2022
2021_B19999,92,55,58,205,2021
2022_C20000,97,95,63,255,2022
2022_A20001,97,81,38,216,2022
2019_B20002,86,82,57,225,2019
2022_B20003,84,75,69,228,2022
2022_B20004,88,64,53,205,2022
2021_C20005,73,74,50,197,2021
2019_A20006,89,55,75,219,2019
2019_C20007,87,45,47,179,2019
2019_C20008,90,95,73,258,2019
2019_B20009,73,77,53,203,2019
2021_B20010,76,54,45,175,2021
2022_A20011,90,69,51,210,2022
2021_B20012,75,93,39,207,2021
2022_B20013,96,48,39,183,2022
2021_B20014,79,58,42,179,2021
2019_B20015,82,81,75,238,2019
2021_C20016,76,49,78,203,2021
2019_A20017,84,71,47,202,2019
2019_C20018,92,95,44,231,2019
2022_A20019,87,56,58,201,2022
2021_A20020,86,89,64,239,2021
2019_B20021,97,86,47,230,2019
2021_C20022,76,96,74,246,2021
2019_A20023,88,46,47,181,2019
2021_A20024,85,46,67,198,2021
2022_C20025,80,74,69,223,2022
2022_B20026,94,47,41,182,2022
2022_A20027,85,69,76,230,2022
2019_B20028,91,90,45,226,2019
2021_A20029,72,72,59,203,2021
2019_B20030,74,49,37,160,2019
2021_B20031,91,51,62,204,2021
2022_B20032,81,89,56,226,2022
2021_C20033,95,53,57,205,2021
2022_B20034,91,58,50,199,2022
2021_A20035,90,61,79,230,2021
2022_A20036,83,67,60,210,2022
2021_C20037,80,53,46,179,2021
2019_A20038,90,55,79,224,2019
2019_A20039,78,56,36,170,2019
2021_A20040,93,78,69,240,2021
2022_A20041,82,96,57,235,2022
2021_B20042,84,68,72,224,2021
2019_C20043,88,53,38,179,2019
2022_B20044,96,83,46,225,2022
2021_A20045,87,87,36,210,2021
2019_C20046,85,86,66,237,2019
2019_B20047,81,73,75,229,2019
2022_B20048,94,87,44,225,2022
2022_C20049,96,85,40,221,2022
2019_A20050,86,50,47,183,2019
2019_C20051,97,77,78,252,2019
2019_C20052,89,86,74,249,2019
2022_B20053,75,57,55,187,2022
2022_B20054,94,71,58,223,2022
2019_A20055,96,69,79,244,2019
2021_C20056,83,48,61,192,2021
2022_B20057,71,83,60,214,2022
2022_C20058,80,77,43,200,2022
2022_C20059,73,73,45,191,2022
2019_A20060,93,64,52,209,2019
2021_B20061,74,58,69,201,2021
2021_A20062,90,83,48,221,2021
2021_B20063,84,71,63,218,2021
2019_B20064,82,68,44,194,2019
2019_B20065,78,63,39,180,2019
2021_A20066,94,76,44,214,2021
2019_B20067,78,66,60,204,2019
2022_A20068,77,64,54,195,2022
2021_B20069,75,79,60,214,2021
2022_B20070,88,83,49,220,2022
2021_C20071,75,93,67,235,2021
2021_B20072,95,84,41,220,2021
2021_C20073,85,55,76,216,2021
2022_C20074,91,54,39,184,2022
2022_C20075,86,46,67,199,2022
2019_B20076,73,54,79,206,2019
2019_A20077,92,65,59,216,2019
2019_A20078,93,51,54,198,2019
2019_C20079,76,91,40,207,2019
2022_C20080,86,78,46,210,2022
2021_C20081,85,84,64,233,2021
2019_C20082,79,48,67,194,2019
2021_A20083,89,49,53,191,2021
2022_C20084,97,84,52,233,2022
2022_B20085,88,59,79,226,2022
2021_C20086,87,67,70,224,2021
2019_C20087,85,57,40,182,2019
2022_C20088,95,61,36,192,2022
2022_A20089,92,65,78,235,2022
2022_B20090,87,89,48,224,2022
2021_C20091,76,87,42,205,2021
2019_B20092,74,58,48,180,2019
2022_A20093,73,85,78,236,2022
2021_C20094,78,57,64,199,2021
2019_B20095,85,76,70,231,2019
2021_A20096,79,49,52,180,2021
2019_A20097,87,57,76,220,2019
2021_B20098,94,77,50,221,2021
2019_C20099,94,78,79,251,2019
2022_A20100,85,51,68,204,2022
2021_B20101,97,72,39,208,2021
2021_B20102,90,47,45,182,2021
2021_C20103,81,45,63,189,2021
2021_C20104,79,50,35,164,2021
2021_A20105,79,60,42,181,2021
2022_B20106,84,94,56,234,2022
2019_C20107,87,66,72,225,2019
2021_B20108,75,68,37,180,2021
2022_A20109,87,84,71,242,2022
2021_C20110,80,94,42,216,2021
2021_A20111,81,87,36,204,2021
2021_A20112,86,82,66,234,2021
2022_B20113,84,69,77,230,2022
2021_C20114,79,75,73,227,2021
2022_B20115,79,68,69,216,2022
2022_A20116,73,59,44,176,2022
2021_A20117,73,81,36,190,2021
2019_C20118,74,75,36,185,2019
2019_B20119,97,71,37,205,2019
2021_B20120,87,58,64,209,2021
2021_B20121,94,59,68,221,2021
2021_A20122,72,75,79,226,2021
2021_B20123,92,93,57,242,2021
2022_A20124,83,91,56,230,2022
2021_C20125,83,66,35,184,2021
2022_C20126,89,72,66,227,2022
2021_A20127,95,48,76,219,2021
2019_C20128,95,94,65,254,2019
2019_A20129,90,55,79,224,2019
2022_C20130,81,80,55,216,2022
2019_B20131,88,59,38,185,2019
2019_A20132,86,45,51,182,2019
2019_A20133,83,87,45,215,2019
2022_A20134,82,46,47,175,2022
2019_C20135,91,48,43,182,2019
2021_B20136,90,48,59,197,2021
2021_A20137,75,90,59,224,2021
2019_C20138,71,45,53,169,2019
2021_C20139,92,93,43,228,2021
2021_A20140,97,84,72,253,2021
2021_C20141,76,73,37,186,2021
2022_A20142,93,87,73,253,2022
2022_C20143,96,69,77,242,2022
2019_C20144,93,73,59,225,2019
2021_A20145,82,66,42,190,2021
2022_C20146,85,83,56,224,2022
2021_C20147,74,63,67,204,2021
2021_C20148,91,53,36,180,2021
2019_C20149,77,58,46,181,2019
2022_A20150,80,95,58,233,2022
2019_B20151,82,75,38,195,2019
2022_C20152,86,62,54,202,2022
2022_C20153,85,69,72,226,2022
2021_B20154,93,50,76,219,2021
2019_C20155,76,57,69,202,2019
2022_A20156,95,47,38,180,2022
2019_B20157,89,68,41,198,2019
2019_C20158,89,89,54,232,2019
2019_B20159,96,46,78,220,2019
2021_C20160,84,61,75,220,2021
2022_B20161,97,95,67,259,2022
2021_A20162,91,69,69,229,2021
2021_B20163,80,60,43,183,2021
2022_A20164,93,75,41,209,2022
2021_C20165,73,89,39,201,2021
2019_C20166,95,50,68,213,2019
2022_C20167,76,47,74,197,2022
2019_B20168,89,49,74,212,2019
2022_A20169,80,82,43,205,2022
2022_A20170,78,50,59,187,2022
2022_A20171,88,57,75,220,2022
2019_A20172,97,53,73,223,2019
2019_C20173,72,79,41,192,2019
2021_B20174,73,68,59,200,2021
2022_C20175,83,50,50,183,2022
2022_B20176,71,80,52,203,2022
2021_B20177,96,81,53,230,2021
2022_C20178,87,69,52,208,2022
2019_A20179,84,72,71,227,2019
2019_A20180,94,67,67,228,2019
2021_B20181,96,59,39,194,2021
2021_B20182,74,49,64,187,2021
2019_C20183,83,55,42,180,2019
2019_C20184,82,70,74,226,2019
2021_A20185,85,61,50,196,2021
2022_A20186,76,64,78,218,2022
2022_C20187,95,96,52,243,2022
2021_A20188,79,64,49,192,2021
2022_B20189,79,82,35,196,2022
2021_A20190,74,79,66,219,2021
2022_B20191,93,94,51,238,2022
2022_B20192,95,80,37,212,2022
2019_A20193,81,67,56,204,2019
2019_C20194,85,73,76,234,2019
2022_C20195,82,91,35,208,2022
2022_A20196,82,92,55,229,2022
2019_B20197,94,88,51,233,2019
2021_B20198,93,66,67,226,2021
2021_B20199,75,92,55,222,2021
2022_A20200,85,45,69,199,2022
2021_B20201,88,73,53,214,2021
2019_A20202,72,78,41,191,2019
2021_C20203,82,92,57,231,2021
2019_A20204,93,77,67,237,2019
2022_A20205,73,81,73,227,2022
2022_A20206,79,91,70,240,2022
2021_C20207,71,70,38,179,2021
2021_C20208,87,83,79,249,2021
2019_C20209,84,96,44,224,2019
2022_B20210,90,60,35,185,2022
2022_B20211,96,94,79,269,2022
2022_B20212,78,58,62,198,2022
2019_C20213,76,63,45,184,2019
2022_B20214,83,49,41,173,2022
2022_C20215,80,83,62,225,2022
2022_A20216,97,87,66,250,2022
2021_B20217,80,47,67,194,2021
2019_B20218,78,57,65,200,2019
2021_A20219,76,72,54,202,2021
2021_A20220,89,54,70,213,2021
2019_A20221,73,77,73,223,2019
2021_B20222,83,59,48,190,2021
2019_B20223,82,60,69,211,2019
2021_C20224,79,46,70,195,2021
2022_A20225,73,52,67,192,2022
2022_C20226,87,87,49,223,2022
2021_B20227,80,96,67,243,2021
2022_A20228,89,92,47,228,2022
2019_C20229,84,57,57,198,2019
2022_A20230,93,85,69,247,2022
2022_A20231,86,87,42,215,2022
2019_B20232,78,50,41,169,2019
2022_B20233,77,78,66,221,2022
2019_B20234,78,62,54,194,2019
2022_A20235,78,56,77,211,2022
2022_B20236,77,96,62,235,2022
2019_B20237,93,62,37,192,2019
2019_C20238,82,62,63,207,2019
2022_B20239,75,71,67,213,2022
2021_C20240,96,58,57,211,2021
2021_C20241,96,56,79,231,2021
2021_B20242,94,60,71,225,2021
2021_B20243,96,82,36,214,2021
2019_B20244,82,63,59,204,2019
2021_A20245,75,67,65,207,2021
2019_B20246,77,64,35,176,2019
2022_B20247,89,93,60,242,2022
2022_C20248,76,95,46,217,2022
2019_C20249,75,86,76,237,2019
2021_B20250,96,76,35,207,2021
2019_B20251,93,51,43,187,2019
2022_C20252,76,45,61,182,2022
2021_B20253,85,88,67,240,2021
2019_B20254,89,93,40,222,2019
2021_A20255,93,64,49,206,2021
2022_A20256,75,92,45,212,2022
2022_A20257,97,70,51,218,2022
2022_A20258,78,56,43,177,2022
2019_A20259,84,64,54,202,2019
2021_B20260,77,67,53,197,2021
2021_B20261,97,48,53,198,2021
2019_A20262,90,65,57,212,2019
2022_B20263,74,74,66,214,2022
2021_A20264,78,73,46,197,2021
2019_B20265,86,52,72,210,2019
2021_C20266,95,53,47,195,2021
2021_C20267,81,77,44,202,2021
2021_C20268,73,78,41,192,2021
2019_C20269,97,47,61,205,2019
2021_A20270,72,74,51,197,2021
2021_B20271,81,63,52,196,2021
2022_B20272,91,80,46,217,2022
2022_A20273,83,58,43,184,2022
2019_A20274,96,78,71,245,2019
2019_C20275,80,54,46,180,2019
2021_A20276,84,82,57,223,2021
2019_B20277,82,82,77,241,2019
2022_C20278,83,68,47,198,2022
2019_A20279,74,55,55,184,2019
2021_A20280,85,59,65,209,2021
2022_B20281,77,70,55,202,2022
2021_B20282,85,69,69,223,2021
2021_A20283,83,63,50,196,2021
2021_A20284,90,89,78,257,2021
2021_A20285,83,52,69,204,2021
2022_B20286,82,58,42,182,2022
2021_A20287,91,87,77,255,2021
2021_A20288,83,90,44,217,2021
2021_B20289,87,72,61,220,2021
2021_B20290,91,77,78,246,2021
2019_A20291,94,63,78,235,2019
2021_B20292,72,70,42,184,2021
2022_B20293,94,61,61,216,2022
2019_B20294,84,72,59,215,2019
2022_A20295,91,62,48,201,2022
2021_C20296,87,88,45,220,2021
2021_C20297,73,64,76,213,2021
2022_A20298,84,49,60,193,2022
2022_A20299,91,93,37,221,2022
2021_B20300,82,94,41,217,2021
2022_B20301,77,47,44,168,2022
2021_A20302,78,54,67,199,2021
2022_C20303,74,92,41,207,2022
2021_B20304,84,50,71,205,2021
2022_B20305,84,92,71,247,2022
2021_A20306,88,70,63,221,2021
2022_A20307,74,92,46,212,2022
2021_C20308,76,77,76,229,2021
2021_A20309,79,55,41,175,2021
2019_C20310,87,63,63,213,2019
2019_B20311,84,54,50,188,2019
2022_C20312,82,55,49,186,2022
2019_C20313,82,46,58,186,2019
2021_A20314,79,51,42,172,2021
2022_C20315,73,67,68,208,2022
2019_A20316,81,83,43,207,2019
2022_C20317,79,88,40,207,2022
2021_A20318,88,51,35,174,2021
2022_A20319,95,70,46,211,2022
2019_B20320,86,81,51,218,2019
2019_B20321,76,64,55,195,2019
2021_A20322,92,45,50,187,2021
2021_A20323,74,85,77,236,2021
2022_A20324,80,49,70,199,2022
2021_A20325,77,85,71,233,2021
2022_A20326,80,81,41,202,2022
2021_B20327,90,82,75,247,2021
2019_B20328,86,51,58,195,2019
2019_C20329,82,82,64,228,2019
2019_B20330,94,68,37,199,2019
2019_A20331,81,88,38,207,2019
2022_C20332,95,71,62,228,2022
2021_C20333,74,61,59,194,2021
2021_A20334,96,89,60,245,2021
2022_C20335,88,86,44,218,2022
2022_A20336,89,56,71,216,2022
2022_B20337,80,59,60,199,2022
2019_A20338,87,94,67,248,2019
2021_A20339,71,88,59,218,2021
2019_A20340,71,82,71,224,2019
2022_C20341,83,66,68,217,2022
2019_C20342,94,83,47,224,2019
2021_A20343,96,81,51,228,2021
2022_A20344,84,83,61,228,2022
2021_A20345,72,82,45,199,2021
2021_C20346,93,84,42,219,2021
2021_A20347,73,96,43,212,2021
2021_A20348,94,54,63,211,2021
2021_B20349,97,52,42,191,2021
2022_B20350,90,85,76,251,2022
2019_B20351,97,46,51,194,2019
2019_A20352,86,60,53,199,2019
2019_A20353,74,66,60,200,2019
2021_C20354,89,61,59,209,2021
2021_A20355,96,94,61,251,2021
2021_A20356,85,81,68,234,2021
2021_C20357,76,61,48,185,2021
2022_B20358,77,83,41,201,2022
2019_C20359,80,85,77,242,2019
2022_C20360,96,46,79,221,2022
2019_A20361,94,92,72,258,2019
2019_A20362,91,45,42,178,2019
2022_A20363,97,76,64,237,2022
2021_B20364,95,89,35,219,2021
2019_C20365,82,66,51,199,2019
2019_A20366,85,53,56,194,2019
2019_B20367,71,66,38,175,2019
2021_B20368,95,52,45,192,2021
2021_C20369,74,94,50,218,2021
2019_A20370,93,56,57,206,2019
2019_B20371,85,89,59,233,2019
2022_A20372,73,96,58,227,2022
2019_B20373,88,84,55,227,2019
2021_B20374,71,85,53,209,2021
2019_A20375,95,90,47,232,2019
2022_A20376,97,89,76,262,2022
2019_A20377,81,54,59,194,2019
2022_B20378,82,94,54,230,2022
2021_A20379,96,63,51,210,2021
2019_A20380,86,96,46,228,2019
2021_B20381,85,86,66,237,2021
2022_C20382,84,67,48,199,2022
2019_B20383,84,58,60,202,2019
2021_C20384,73,55,42,170,2021
2022_B20385,81,58,63,202,2022
2019_C20386,90,84,49,223,2019
2021_B20387,88,45,66,199,2021
2021_A20388,80,91,61,232,2021
2021_B20389,76,62,38,176,2021
2021_A20390,76,86,59,221,2021
2019_B20391,74,84,52,210,2019
2021_B20392,74,57,58,189,2021
2021_C20393,88,50,45,183,2021
2021_C20394,96,54,68,218,2021
2019_B20395,87,69,70,226,2019
2022_A20396,78,58,61,197,2022
2021_B20397,80,46,78,204,2021
2021_C20398,82,56,72,210,2021
2022_A20399,88,58,36,182,2022
2022_A20400,86,75,57,218,2022
2022_A20401,92,48,66,206,2022
2021_C20402,76,63,39,178,2021
2021_A20403,78,93,59,230,2021
2021_C20404,89,84,49,222,2021
2022_C20405,78,53,60,191,2022
2021_C20406,81,92,76,249,2021
2021_B20407,71,95,69,235,2021
2022_C20408,88,90,55,233,2022
2021_B20409,85,65,67,217,2021
2019_C20410,71,45,61,177,2019
2022_A20411,90,84,65,239,2022
2019_C20412,96,73,47,216,2019
2019_A20413,94,69,73,236,2019
2021_C20414,76,55,37,168,2021
2019_B20415,84,52,64,200,2019
2019_C20416,92,87,70,249,2019
2022_C20417,85,67,57,209,2022
2021_C20418,85,83,71,239,2021
2022_C20419,94,58,76,228,2022
2022_A20420,86,49,70,205,2022
2019_C20421,85,54,48,187,2019
2022_A20422,97,65,59,221,2022
2021_C20423,89,61,50,200,2021
2022_C20424,82,53,77,212,2022
2021_C20425,88,96,78,262,2021
2022_B20426,84,90,68,242,2022
2022_C20427,94,94,57,245,2022
2019_A20428,83,65,55,203,2019
2022_B20429,89,80,67,236,2022
2021_A20430,86,60,67,213,2021
2021_C20431,79,96,37,212,2021
2019_C20432,74,91,51,216,2019
2021_B20433,77,77,49,203,2021
2022_A20434,93,73,46,212,2022
2022_B20435,87,81,51,219,2022
2022_B20436,86,53,48,187,2022
2019_B20437,86,90,65,241,2019
2019_C20438,71,91,61,223,2019
2021_A20439,74,47,57,178,2021
2022_B20440,73,66,44,183,2022
2022_B20441,90,77,77,244,2022
2019_A20442,82,58,67,207,2019
2021_A20443,95,55,40,190,2021
2021_B20444,72,67,70,209,2021
2021_A20445,77,91,50,218,2021
2019_C20446,84,80,66,230,2019
2021_A20447,75,65,70,210,2021
2021_B20448,88,85,62,235,2021
2021_A20449,95,56,48,199,2021
2019_B20450,78,59,65,202,2019
2022_B20451,83,91,56,230,2022
2019_C20452,91,90,78,259,2019
2021_A20453,81,53,54,188,2021
2022_C20454,74,67,62,203,2022
2019_A20455,86,61,58,205,2019
2019_B20456,79,76,78,233,2019
2019_A20457,91,82,40,213,2019
2022_A20458,97,69,74,240,2022
2019_B20459,78,90,49,217,2019
2022_A20460,90,73,42,205,2022
2022_A20461,73,55,73,201,2022
2019_C20462,97,75,69,241,2019
2019_C20463,96,83,75,254,2019
2022_C20464,78,56,72,206,2022
2021_C20465,89,55,76,220,2021
2022_B20466,91,68,69,228,2022
2021_B20467,95,83,43,221,2021
2022_A20468,71,48,65,184,2022
2019_C20469,82,50,72,204,2019
2019_B20470,86,74,55,215,2019
2019_C20471,84,50,61,195,2019
2022_B20472,78,72,68,218,2022
2022_A20473,74,58,38,170,2022
2019_A20474,78,47,37,162,2019
2019_A20475,92,71,54,217,2019
2022_B20476,77,62,79,218,2022
2021_C20477,93,77,77,247,2021
2022_B20478,92,73,35,200,2022
2019_C20479,72,96,59,227,2019
2019_B20480,75,48,51,174,2019
2022_A20481,75,94,35,204,2022
2021_C20482,80,90,51,221,2021
2021_C20483,73,59,65,197,2021
2019_B20484,84,92,69,245,2019
2021_B20485,83,63,76,222,2021
2021_B20486,96,61,43,200,2021
2022_C20487,74,48,41,163,2022
2022_C20488,88,75,53,216,2022
2021_B20489,81,63,56,200,2021
2021_A20490,81,70,71,222,2021
2021_A20491,81,94,37,212,2021
2022_B20492,80,64,54,198,2022
2021_A20493,72,62,39,173,2021
2022_B20494,91,49,56,196,2022
2021_B20495,90,60,72,222,2021
2021_C20496,75,82,37,194,2021
2019_C20497,77,73,68,218,2019
2019_C20498,84,77,73,234,2019
2022_A20499,91,84,40,215,2022
2021_B20500,74,53,66,193,2021
2021_C20501,97,59,58,214,2021
2021_C20502,91,91,66,248,2021
2019_B20503,85,96,78,259,2019
2022_A20504,86,85,54,225,2022
2022_A20505,74,67,65,206,2022
2022_B20506,78,75,37,190,2022
2022_C20507,91,71,59,221,2022
2022_C20508,83,63,78,224,2022
2019_C20509,83,82,69,234,2019
2021_C20510,92,65,40,197,2021
2019_C20511,96,89,67,252,2019
2021_C20512,75,77,57,209,2021
2022_C20513,89,68,68,225,2022
2022_A20514,91,85,61,237,2022
2022_B20515,87,80,48,215,2022
2022_B20516,83,95,62,240,2022
2021_B20517,97,50,71,218,2021
2022_C20518,78,53,66,197,2022
2022_B20519,75,76,77,228,2022
2021_C20520,85,83,67,235,2021
2022_C20521,78,92,48,218,2022
2021_C20522,93,69,40,202,2021
2021_B20523,85,45,67,197,2021
2021_A20524,85,65,45,195,2021
2019_A20525,82,51,56,189,2019
2022_C20526,94,90,52,236,2022
2022_A20527,77,48,38,163,2022
2021_B20528,81,82,53,216,2021
2021_C20529,83,79,63,225,2021
2022_C20530,86,82,53,221,2022
2019_A20531,93,72,71,236,2019
2019_A20532,75,89,64,228,2019
2019_C20533,74,88,58,220,2019
2022_C20534,97,56,79,232,2022
2021_B20535,88,63,53,204,2021
2019_B20536,80,84,40,204,2019
2021_A20537,97,47,42,186,2021
2022_C20538,82,61,71,214,2022
2022_C20539,75,67,45,187,2022
2019_B20540,87,67,79,233,2019
2022_C20541,81,86,73,240,2022
2021_A20542,89,47,66,202,2021
2022_B20543,77,91,55,223,2022
2022_C20544,77,67,58,202,2022
2019_A20545,84,66,50,200,2019
2019_C20546,97,94,42,233,2019
2022_C20547,85,67,51,203,2022
2021_B20548,72,94,40,206,2021
2021_B20549,90,67,35,192,2021
2021_B20550,72,68,73,213,2021
2019_C20551,87,91,64,242,2019
2022_A20552,95,90,54,239,2022
2019_C20553,81,46,60,187,2019
2022_C20554,89,74,61,224,2022
2021_C20555,94,56,67,217,2021
2022_B20556,72,73,73,218,2022
2021_A20557,73,92,46,211,2021
2019_C20558,72,62,52,186,2019
2019_B20559,89,67,59,215,2019
2019_A20560,78,62,77,217,2019
2019_A20561,93,48,50,191,2019
2021_A20562,73,60,75,208,2021
2022_C20563,79,87,79,245,2022
2019_B20564,74,68,62,204,2019
2019_B20565,81,75,51,207,2019
2021_A20566,84,69,51,204,2021
2019_B20567,85,65,50,200,2019
2021_B20568,93,50,59,202,2021
2021_C20569,74,85,61,220,2021
2021_B20570,75,53,61,189,2021
2021_A20571,81,65,70,216,2021
2021_A20572,76,81,69,226,2021
2021_C20573,89,74,40,203,2021
2019_C20574,94,59,53,206,2019
2021_C20575,82,68,39,189,2021
2022_B20576,84,45,49,178,2022
2022_C20577,72,52,70,194,2022
2021_A20578,95,53,44,192,2021
2022_C20579,90,74,56,220,2022
2019_A20580,79,89,53,221,2019
2022_B20581,85,61,70,216,2022
2021_C20582,86,47,38,171,2021
2022_B20583,78,79,36,193,2022
2019_B20584,75,75,76,226,2019
2021_A20585,88,68,41,197,2021
2022_C20586,73,90,62,225,2022
2021_A20587,95,47,39,181,2021
2021_B20588,86,53,55,194,2021
2022_C20589,93,74,76,243,2022
2021_C20590,73,85,42,200,2021
2022_B20591,78,58,71,207,2022
2022_A20592,75,64,66,205,2022
2021_A20593,85,46,38,169,2021
2019_A20594,85,54,78,217,2019
2021_A20595,85,86,58,229,2021
2019_B20596,95,57,57,209,2019
2019_C20597,78,46,43,167,2019
2019_B20598,72,50,69,191,2019
2022_C20599,76,47,61,184,2022
2019_A20600,83,87,38,208,2019
2019_C20601,89,57,46,192,2019
2019_C20602,90,84,45,219,2019
2019_B20603,75,82,47,204,2019
2021_C20604,78,89,44,211,2021
2022_C20605,78,80,42,200,2022
2022_C20606,95,71,35,201,2022
2022_B20607,77,48,39,164,2022
2021_C20608,72,85,42,199,2021
2021_A20609,74,77,59,210,2021
2021_A20610,88,96,43,227,2021
2022_A20611,97,93,66,256,2022
2022_B20612,87,46,48,181,2022
2021_A20613,96,78,46,220,2021
2019_B20614,72,87,52,211,2019
2022_C20615,97,79,47,223,2022
2022_C20616,82,64,43,189,2022
2022_B20617,79,50,39,168,2022
2022_C20618,79,49,58,186,2022
2022_A20619,94,55,53,202,2022
2022_A20620,75,63,79,217,2022
2019_A20621,71,71,36,178,2019
2022_C20622,74,62,73,209,2022
2022_B20623,75,70,42,187,2022
2021_B20624,77,65,61,203,2021
2022_C20625,96,54,51,201,2022
2019_A20626,87,89,37,213,2019
2021_C20627,74,56,75,205,2021
2021_A20628,90,83,55,228,2021
2019_B20629,73,93,67,233,2019
2019_A20630,72,65,49,186,2019
2019_B20631,88,52,45,185,2019
2019_B20632,91,74,37,202,2019
2022_B20633,95,95,35,225,2022
2021_B20634,74,54,41,169,2021
2019_B20635,79,45,66,190,2019
2019_C20636,75,62,56,193,2019
2021_C20637,97,67,62,226,2021
2019_A20638,85,79,41,205,2019
2019_B20639,84,70,53,207,2019
2022_A20640,71,76,54,201,2022
2022_A20641,87,82,54,223,2022
2022_C20642,96,81,41,218,2022
2022_B20643,91,93,38,222,2022
2022_C20644,87,83,41,211,2022
2021_A20645,91,81,72,244,2021
2021_A20646,97,45,52,194,2021
2022_C20647,74,63,73,210,2022
2019_C20648,78,53,55,186,2019
2022_B20649,85,95,60,240,2022
2021_B20650,93,48,41,182,2021
2019_C20651,78,60,57,195,2019
2021_B20652,72,88,62,222,2021
2021_C20653,76,71,76,223,2021
2019_B20654,93,92,61,246,2019
2022_B20655,92,94,77,263,2022
2021_C20656,76,88,72,236,2021
2022_C20657,82,62,49,193,2022
2019_A20658,90,74,39,203,2019
2019_C20659,91,49,48,188,2019
2022_B20660,95,72,71,238,2022
2019_C20661,90,96,49,235,2019
2019_B20662,82,96,54,232,2019
2022_A20663,75,60,47,182,2022
2021_B20664,93,48,55,196,2021
2022_A20665,83,82,68,233,2022
2019_A20666,90,48,39,177,2019
2019_A20667,79,62,50,191,2019
2021_C20668,82,53,52,187,2021
2022_A20669,84,47,42,173,2022
2021_C20670,88,70,41,199,2021
2019_C20671,84,45,45,174,2019
2022_C20672,94,50,65,209,2022
2021_A20673,71,89,67,227,2021
2019_A20674,74,77,35,186,2019
2019_A20675,93,80,41,214,2019
2019_A20676,83,92,64,239,2019
2021_C20677,88,84,63,235,2021
2021_C20678,81,48,51,180,2021
2022_C20679,89,51,69,209,2022
2019_B20680,73,59,42,174,2019
2021_B20681,93,57,62,212,2021
2022_A20682,85,94,70,249,2022
2021_C20683,83,63,41,187,2021
2021_A20684,86,62,60,208,2021
2022_C20685,97,52,68,217,2022
2021_A20686,72,48,62,182,2021
2019_C20687,74,61,46,181,2019
2021_A20688,75,50,79,204,2021
2021_B20689,85,56,79,220,2021
2021_A20690,76,86,75,237,2021
2019_B20691,77,60,44,181,2019
2022_B20692,93,72,38,203,2022
2022_B20693,97,72,42,211,2022
2019_C20694,71,83,65,219,2019
2021_A20695,87,51,50,188,2021
2019_C20696,78,52,74,204,2019
2019_A20697,72,63,50,185,2019
2022_C20698,77,71,75,223,2022
2021_C20699,79,50,37,166,2021
2019_A20700,76,69,36,181,2019
2021_A20701,83,69,41,193,2021
2019_A20702,85,62,45,192,2019
2019_A20703,78,45,60,183,2019
2021_B20704,74,92,70,236,2021
2022_A20705,78,46,39,163,2022
2022_B20706,86,69,50,205,2022
2019_A20707,80,94,42,216,2019
2022_C20708,82,83,53,218,2022
2019_B20709,75,95,44,214,2019
2022_C20710,80,57,40,177,2022
2022_B20711,84,70,78,232,2022
2022_A20712,97,76,52,225,2022
2019_B20713,82,77,56,215,2019
2022_C20714,97,96,54,247,2022
2019_C20715,71,61,71,203,2019
2019_B20716,91,75,60,226,2019
2021_C20717,80,69,64,213,2021
2022_A20718,87,63,59,209,2022
2021_C20719,84,47,50,181,2021
2022_A20720,72,69,64,205,2022
2019_A20721,89,66,61,216,2019
2019_A20722,74,54,36,164,2019
2019_A20723,92,68,59,219,2019
2022_A20724,89,91,60,240,2022
2019_A20725,73,93,71,237,2019
2021_B20726,97,78,63,238,2021
2019_C20727,85,46,63,194,2019
2021_C20728,92,56,64,212,2021
2022_C20729,97,68,75,240,2022
2019_A20730,90,51,60,201,2019
2021_C20731,91,65,53,209,2021
2019_C20732,84,85,79,248,2019
2021_B20733,84,79,40,203,2021
2021_B20734,85,54,35,174,2021
2019_C20735,88,92,61,241,2019
2021_A20736,92,64,61,217,2021
2021_A20737,85,95,73,253,2021
2022_B20738,81,88,73,242,2022
2021_B20739,96,68,39,203,2021
2022_C20740,73,75,71,219,2022
2021_B20741,73,86,43,202,2021
2021_B20742,93,46,51,190,2021
2022_B20743,81,60,68,209,2022
2021_A20744,80,46,49,175,2021
2019_C20745,87,71,55,213,2019
2022_B20746,79,89,69,237,2022
2022_C20747,97,72,56,225,2022
2022_A20748,79,78,62,219,2022
2019_B20749,86,62,40,188,2019
2019_C20750,90,50,37,177,2019
2019_C20751,82,75,56,213,2019
2019_C20752,88,84,74,246,2019
2021_A20753,78,58,71,207,2021
2022_A20754,76,56,42,174,2022
2021_A20755,83,73,43,199,2021
2019_A20756,92,83,75,250,2019
2019_C20757,74,94,73,241,2019
2021_B20758,77,83,64,224,2021
2021_B20759,77,84,68,229,2021
2022_C20760,92,79,68,239,2022
2021_B20761,91,47,71,209,2021
2019_B20762,76,80,44,200,2019
2019_B20763,89,81,52,222,2019
2022_A20764,90,53,49,192,2022
2021_B20765,94,65,48,207,2021
2019_B20766,89,90,76,255,2019
2021_C20767,97,83,54,234,2021
2019_C20768,88,92,58,238,2019
2019_C20769,90,57,38,185,2019
2019_A20770,87,50,39,176,2019
2022_C20771,90,94,61,245,2022
2022_A20772,85,93,38,216,2022
2019_A20773,90,73,57,220,2019
2021_B20774,89,63,68,220,2021
2022_A20775,87,57,60,204,2022
2019_C20776,89,80,62,231,2019
2021_A20777,90,85,55,230,2021
2022_A20778,80,45,44,169,2022
2021_B20779,79,49,56,184,2021
2019_C20780,73,47,71,191,2019
2022_B20781,79,49,48,176,2022
2019_B20782,93,93,47,233,2019
2019_B20783,92,59,65,216,2019
2021_C20784,94,67,69,230,2021
2021_B20785,90,66,62,218,2021
2021_A20786,88,71,73,232,2021
2022_C20787,81,58,55,194,2022
2022_C20788,95,48,40,183,2022
2019_C20789,78,51,39,168,2019
2022_B20790,97,54,77,228,2022
2019_C20791,79,89,79,247,2019
2019_B20792,92,69,70,231,2019
2022_C20793,84,69,56,209,2022
2019_B20794,79,63,52,194,2019
2021_B20795,88,75,69,232,2021
2021_B20796,74,54,76,204,2021
2021_A20797,94,74,53,221,2021
2019_C20798,92,96,46,234,2019
2019_B20799,81,72,47,200,2019
2022_B20800,86,94,52,232,2022
2022_C20801,80,62,44,186,2022
2022_B20802,72,62,40,174,2022
2022_B20803,97,61,58,216,2022
2022_C20804,72,70,44,186,2022
2022_A20805,88,69,67,224,2022
2022_C20806,75,52,69,196,2022
2021_C20807,77,65,74,216,2021
2021_A20808,92,72,48,212,2021
2021_A20809,79,71,54,204,2021
2019_C20810,91,49,38,178,2019
2022_A20811,84,82,56,222,2022
2021_A20812,71,64,38,173,2021
2021_C20813,71,69,67,207,2021
2019_C20814,87,84,50,221,2019
2022_A20815,84,57,43,184,2022
2019_C20816,75,84,60,219,2019
2021_B20817,88,90,37,215,2021
2022_B20818,83,48,53,184,2022
2022_C20819,72,45,59,176,2022
2019_C20820,76,90,74,240,2019
2022_B20821,91,75,49,215,2022
2019_A20822,71,77,78,226,2019
2019_A20823,82,48,43,173,2019
2022_B20824,95,96,42,233,2022
2022_A20825,73,61,36,170,2022
2022_C20826,80,50,67,197,2022
2019_A20827,85,57,49,191,2019
2021_C20828,91,53,47,191,2021
2022_A20829,76,48,79,203,2022
2019_C20830,93,84,50,227,2019
2022_C20831,82,76,64,222,2022
2019_B20832,97,52,77,226,2019
2022_B20833,71,83,65,219,2022
2019_C20834,77,95,64,236,2019
2019_B20835,83,45,37,165,2019
2022_B20836,88,74,71,233,2022
2019_B20837,79,84,46,209,2019
2021_C20838,76,77,68,221,2021
2022_A20839,73,95,64,232,2022
2019_B20840,88,48,72,208,2019
2022_A20841,95,77,51,223,2022
2022_C20842,80,96,53,229,2022
2021_A20843,76,77,79,232,2021
2021_C20844,75,84,73,232,2021
2021_A20845,96,74,71,241,2021
2022_B20846,81,80,53,214,2022
2019_C20847,84,79,39,202,2019
2021_A20848,96,79,39,214,2021
2022_A20849,95,76,70,241,2022
2021_C20850,79,70,66,215,2021
2019_A20851,78,85,49,212,2019
2021_C20852,95,84,43,222,2021
2021_B20853,91,92,51,234,2021
2022_C20854,97,72,55,224,2022
2019_B20855,84,59,37,180,2019
2022_A20856,94,76,37,207,2022
2019_B20857,88,50,75,213,2019
2022_C20858,72,73,41,186,2022
2019_B20859,95,64,74,233,2019
2019_B20860,86,50,76,212,2019
2022_C20861,85,47,58,190,2022
2021_B20862,93,85,62,240,2021
2022_A20863,90,55,40,185,2022
2022_A20864,84,65,53,202,2022
2019_A20865,78,64,54,196,2019
2022_B20866,81,56,78,215,2022
2019_A20867,81,49,47,177,2019
2021_C20868,91,47,38,176,2021
2021_C20869,89,74,47,210,2021
2021_A20870,79,45,47,171,2021
2022_B20871,76,95,66,237,2022
2022_C20872,95,95,74,264,2022
2021_C20873,73,77,67,217,2021
2019_B20874,81,63,39,183,2019
2019_C20875,89,77,67,233,2019
2021_A20876,78,52,43,173,2021
2021_B20877,93,75,76,244,2021
2021_A20878,89,64,36,189,2021
2022_B20879,84,90,46,220,2022
2021_A20880,88,74,51,213,2021
2019_B20881,72,85,63,220,2019
2022_C20882,86,78,63,227,2022
2019_A20883,97,78,77,252,2019
2022_B20884,97,89,41,227,2022
2021_A20885,91,66,64,221,2021
2022_A20886,80,51,58,189,2022
2019_C20887,86,79,49,214,2019
2019_C20888,73,76,35,184,2019
2022_A20889,78,55,74,207,2022
2021_C20890,91,77,35,203,2021
2021_B20891,82,71,45,198,2021
2019_A20892,79,93,45,217,2019
2019_B20893,85,83,46,214,2019
2021_B20894,96,94,67,257,2021
2019_B20895,94,94,56,244,2019
2022_B20896,73,88,56,217,2022
2022_A20897,90,78,54,222,2022
2022_A20898,95,62,48,205,2022
2021_A20899,78,61,51,190,2021
2019_B20900,97,88,54,239,2019
2022_C20901,88,63,76,227,2022
2022_C20902,88,80,77,245,2022
2021_A20903,73,58,49,180,2021
2022_A20904,84,83,65,232,2022
2022_B20905,77,58,79,214,2022
2019_C20906,86,58,69,213,2019
2021_C20907,83,67,57,207,2021
2019_A20908,94,93,71,258,2019
2022_B20909,82,69,46,197,2022
2021_A20910,86,78,60,224,2021
2019_C20911,76,82,49,207,2019
2019_B20912,93,62,56,211,2019
2022_C20913,88,46,68,202,2022
2021_A20914,84,93,39,216,2021
2021_C20915,87,68,46,201,2021
2019_C20916,89,50,47,186,2019
2021_B20917,83,49,37,169,2021
2019_B20918,72,65,66,203,2019
2019_A20919,77,75,71,223,2019
2021_A20920,71,85,55,211,2021
2021_C20921,93,87,71,251,2021
2019_A20922,93,66,35,194,2019
2019_A20923,87,83,44,214,2019
2022_A20924,79,90,57,226,2022
2022_C20925,83,93,54,230,2022
2021_B20926,91,53,77,221,2021
2019_B20927,97,88,52,237,2019
2022_C20928,91,77,45,213,2022
2022_B20929,71,52,59,182,2022
2022_C20930,92,46,79,217,2022
2019_C20931,83,91,44,218,2019
2019_C20932,87,96,39,222,2019
2021_A20933,77,68,63,208,2021
2021_B20934,78,53,53,184,2021
2022_C20935,85,92,50,227,2022
2022_B20936,86,59,68,213,2022
2022_B20937,75,61,75,211,2022
2019_A20938,77,50,36,163,2019
2022_C20939,81,90,42,213,2022
2019_A20940,92,72,46,210,2019
2019_A20941,84,89,38,211,2019
2019_C20942,81,70,46,197,2019
2021_C20943,79,70,73,222,2021
2022_C20944,90,72,69,231,2022
2021_B20945,92,73,74,239,2021
2022_A20946,83,56,66,205,2022
2019_A20947,80,88,72,240,2019
2019_C20948,78,49,56,183,2019
2019_C20949,87,53,79,219,2019
2021_B20950,86,85,71,242,2021
2021_B20951,71,48,44,163,2021
2019_C20952,90,63,76,229,2019
2021_B20953,85,45,62,192,2021
2021_B20954,71,52,58,181,2021
2021_B20955,91,50,45,186,2021
2019_C20956,86,78,37,201,2019
2021_A20957,82,77,37,196,2021
2019_A20958,72,87,69,228,2019
2021_A20959,80,54,40,174,2021
2019_A20960,78,82,50,210,2019
2022_B20961,91,66,60,217,2022
2022_C20962,80,96,68,244,2022
2021_C20963,89,86,41,216,2021
2022_A20964,76,71,42,189,2022
2019_A20965,88,55,77,220,2019
2022_B20966,74,80,54,208,2022
2022_A20967,94,67,64,225,2022
2019_A20968,81,90,76,247,2019
2021_C20969,88,65,53,206,2021
2022_A20970,77,57,58,192,2022
2022_C20971,96,95,44,235,2022
2019_A20972,76,53,47,176,2019
2022_C20973,71,65,42,178,2022
2019_A20974,87,73,42,202,2019
2022_B20975,96,78,50,224,2022
2022_B20976,80,65,63,208,2022
2019_A20977,81,53,42,176,2019
2019_A20978,89,57,51,197,2019
2021_C20979,92,65,75,232,2021
2022_B20980,95,68,54,217,2022
2021_C20981,87,79,40,206,2021
2021_A20982,80,45,37,162,2021
2021_B20983,74,69,38,181,2021
2022_C20984,74,54,49,177,2022
2019_B20985,78,61,55,194,2019
2021_A20986,97,60,75,232,2021
2019_B20987,93,64,45,202,2019
2021_B20988,91,82,54,227,2021
2022_A20989,74,73,46,193,2022
2021_C20990,79,80,63,222,2021
2022_A20991,83,71,51,205,2022
2021_A20992,74,67,36,177,2021
2019_C20993,78,73,35,186,2019
2021_B20994,78,60,51,189,2021
2021_A20995,88,57,63,208,2021
2019_C20996,79,58,70,207,2019
2021_B20997,75,91,53,219,2021
2019_C20998,78,85,49,212,2019
2019_A20999,90,60,77,227,2019
2021_A21000,76,80,53,209,2021
2019_C21001,82,65,65,212,2019
2019_A21002,85,80,38,203,2019
2022_A21003,71,76,66,213,2022
2019_A21004,89,95,38,222,2019
2021_B21005,73,52,70,195,2021
2022_B21006,85,57,68,210,2022
2019_C21007,72,77,40,189,2019
2021_A21008,86,73,54,213,2021
2022_A21009,94,61,40,195,2022
2022_B21010,93,90,63,246,2022
2021_C21011,97,54,58,209,2021
2021_C21012,71,60,50,181,2021
2021_A21013,84,63,67,214,2021
2019_A21014,74,70,45,189,2019
2021_A21015,80,48,55,183,2021
2022_B21016,78,83,79,240,2022
2022_B21017,88,77,43,208,2022
2022_B21018,92,66,46,204,2022
2019_A21019,94,80,79,253,2019
2019_A21020,84,89,75,248,2019
2022_C21021,82,88,45,215,2022
2019_A21022,86,50,46,182,2019
2019_B21023,94,50,45,189,2019
2022_B21024,72,71,54,197,2022
2021_B21025,81,49,37,167,2021
2021_B21026,84,73,67,224,2021
2019_B21027,96,58,72,226,2019
2019_C21028,83,90,51,224,2019
2021_C21029,71,71,77,219,2021
2019_B21030,81,77,40,198,2019
2022_C21031,82,60,66,208,2022
2021_C21032,73,62,63,198,2021
2022_C21033,95,51,54,200,2022
2021_C21034,76,92,79,247,2021
2022_A21035,79,48,51,178,2022
2019_C21036,80,83,77,240,2019
2022_C21037,83,60,66,209,2022
2021_A21038,87,46,74,207,2021
2021_C21039,75,46,38,159,2021
2022_B21040,85,86,76,247,2022
2019_A21041,83,85,71,239,2019
2021_A21042,88,47,78,213,2021
2021_A21043,78,67,49,194,2021
2019_C21044,91,53,73,217,2019
2022_A21045,83,78,65,226,2022
2021_C21046,87,92,40,219,2021
2022_C21047,76,66,65,207,2022
2021_B21048,79,70,62,211,2021
2019_A21049,77,53,60,190,2019
2019_C21050,76,72,75,223,2019
2022_C21051,81,69,58,208,2022
2021_B21052,71,82,65,218,2021
2019_A21053,71,77,46,194,2019
2019_B21054,79,89,38,206,2019
2022_B21055,90,88,72,250,2022
2019_B21056,87,83,74,244,2019
2022_A21057,76,82,47,205,2022
2019_B21058,80,67,73,220,2019
2021_A21059,97,58,51,206,2021
2021_C21060,92,85,35,212,2021
2021_C21061,71,72,70,213,2021
2019_A21062,94,45,62,201,2019
2019_C21063,72,67,78,217,2019
2022_A21064,94,65,40,199,2022
2019_C21065,79,80,43,202,2019
2021_C21066,73,75,53,201,2021
2022_A21067,79,75,42,196,2022
2019_C21068,97,59,58,214,2019
2021_A21069,83,67,77,227,2021
2022_C21070,80,90,49,219,2022
2019_A21071,88,67,78,233,2019
2022_A21072,84,65,70,219,2022
2022_B21073,93,47,46,186,2022
2019_B21074,77,71,41,189,2019
2021_C21075,80,82,64,226,2021
2021_B21076,89,95,52,236,2021
2022_C21077,97,80,41,218,2022
2019_A21078,80,74,50,204,2019
2022_C21079,91,57,61,209,2022
2019_C21080,80,59,67,206,2019
2019_C21081,81,68,60,209,2019
2021_A21082,78,67,77,222,2021
2021_C21083,75,46,36,157,2021
2021_C21084,84,80,60,224,2021
2019_A21085,91,62,41,194,2019
2019_C21086,89,54,57,200,2019
2021_A21087,90,68,48,206,2021
2021_A21088,74,82,45,201,2021
2022_A21089,84,76,69,229,2022
2021_B21090,96,49,53,198,2021
2022_A21091,91,84,61,236,2022
2022_C21092,81,95,74,250,2022
2022_A21093,87,71,48,206,2022
2021_B21094,72,60,44,176,2021
2019_B21095,78,84,36,198,2019
2019_A21096,81,62,50,193,2019
2022_A21097,84,94,63,241,2022
2022_A21098,90,62,62,214,2022
2021_B21099,95,46,72,213,2021
2019_B21100,73,71,50,194,2019
2021_C21101,90,93,78,261,2021
2019_A21102,83,51,37,171,2019
2022_A21103,75,86,68,229,2022
2019_C21104,97,55,79,231,2019
2019_B21105,85,55,71,211,2019
2021_A21106,97,64,50,211,2021
2021_B21107,86,45,57,188,2021
2019_A21108,86,91,73,250,2019
2019_C21109,72,47,55,174,2019
2021_A21110,72,56,54,182,2021
2021_C21111,76,56,39,171,2021
2021_B21112,91,83,46,220,2021
2022_B21113,85,50,66,201,2022
2022_C21114,79,60,59,198,2022
2021_C21115,81,92,70,243,2021
2022_B21116,96,91,63,250,2022
2021_B21117,89,95,65,249,2021
2022_B21118,71,45,67,183,2022
2019_A21119,96,56,54,206,2019
2019_B21120,91,92,44,227,2019
2019_C21121,81,46,35,162,2019
2022_C21122,81,94,50,225,2022
2021_A21123,83,80,78,241,2021
2021_B21124,78,88,36,202,2021
2022_A21125,87,72,43,202,2022
2019_C21126,95,63,73,231,2019
2021_A21127,74,89,67,230,2021
2021_A21128,97,52,46,195,2021
2021_B21129,96,69,54,219,2021
2021_C21130,95,47,63,205,2021
2022_C21131,74,72,50,196,2022
2021_A21132,94,96,60,250,2021
2019_C21133,96,80,35,211,2019
2019_B21134,76,51,75,202,2019
2019_A21135,85,67,79,231,2019
2019_C21136,79,55,62,196,2019
2019_C21137,94,53,79,226,2019
2021_B21138,91,51,47,189,2021
2019_A21139,73,82,48,203,2019
2019_A21140,80,77,72,229,2019
2021_C21141,71,88,78,237,2021
2021_C21142,91,85,49,225,2021
2019_B21143,91,82,65,238,2019
2022_C21144,93,88,71,252,2022
2019_A21145,97,52,77,226,2019
2019_C21146,72,63,38,173,2019
2019_B21147,85,55,77,217,2019
2022_B21148,89,47,44,180,2022
2022_C21149,92,47,38,177,2022
2021_C21150,84,59,60,203,2021
2021_A21151,77,59,59,195,2021
2022_B21152,94,78,71,243,2022
2021_B21153,97,48,38,183,2021
2021_A21154,93,93,68,254,2021
2022_C21155,95,86,47,228,2022
2022_C21156,78,46,59,183,2022
2022_C21157,82,67,48,197,2022
2019_C21158,82,87,64,233,2019
2021_B21159,90,93,70,253,2021
2021_B21160,72,67,48,187,2021
2022_A21161,84,86,54,224,2022
2021_B21162,87,52,72,211,2021
2021_B21163,90,62,65,217,2021
2022_B21164,92,68,56,216,2022
2019_B21165,95,63,68,226,2019
2022_B21166,78,63,76,217,2022
2021_C21167,71,75,47,193,2021
2019_C21168,75,85,37,197,2019
2022_B21169,92,63,58,213,2022
2022_A21170,82,47,72,201,2022
2022_B21171,88,82,62,232,2022
2019_C21172,80,73,49,202,2019
2019_B21173,75,74,67,216,2019
2019_C21174,71,67,79,217,2019
2022_B21175,86,81,58,225,2022
2019_C21176,85,66,55,206,2019
2019_B21177,88,96,71,255,2019
2019_C21178,81,78,65,224,2019
2022_B21179,96,83,68,247,2022
2019_C21180,76,75,72,223,2019
2019_C21181,76,95,60,231,2019
2021_B21182,90,82,73,245,2021
2021_A21183,97,56,41,194,2021
2022_A21184,96,83,66,245,2022
2019_C21185,90,84,35,209,2019
2021_A21186,75,81,49,205,2021
2019_B21187,78,57,73,208,2019
2021_A21188,86,45,47,178,2021
2021_A21189,75,52,43,170,2021
2022_A21190,73,72,47,192,2022
2019_B21191,97,89,55,241,2019
2021_C21192,80,87,64,231,2021
2021_B21193,72,55,53,180,2021
2019_C21194,89,84,44,217,2019
2022_A21195,72,48,57,177,2022
2022_B21196,76,57,65,198,2022
2022_B21197,77,48,73,198,2022
2019_B21198,93,56,59,208,2019
2021_A21199,72,48,62,182,2021
2022_C21200,90,73,43,206,2022
2022_B21201,79,45,78,202,2022
2022_C21202,87,64,46,197,2022
2022_C21203,73,57,39,169,2022
2019_C21204,86,57,61,204,2019
2021_C21205,73,64,61,198,2021
2021_B21206,81,86,60,227,2021
2022_B21207,86,95,56,237,2022
2019_C21208,76,57,59,192,2019
2019_C21209,73,57,38,168,2019
2021_B21210,83,46,65,194,2021
2019_A21211,86,71,58,215,2019
2022_C21212,97,51,66,214,2022
2019_B21213,93,58,45,196,2019
2021_B21214,86,59,45,190,2021
2021_C21215,90,57,40,187,2021
2019_B21216,86,93,49,228,2019
2019_C21217,93,55,62,210,2019
2022_C21218,93,95,57,245,2022
2021_C21219,91,70,67,228,2021
2021_A21220,90,74,68,232,2021
2021_A21221,80,86,46,212,2021
2022_B21222,92,50,66,208,2022
2022_C21223,94,50,36,180,2022
2021_A21224,94,90,75,259,2021
2022_A21225,94,50,56,200,2022
2022_A21226,95,57,54,206,2022
2019_C21227,85,49,56,190,2019
2019_B21228,91,55,63,209,2019
2021_B21229,74,61,66,201,2021
2021_B21230,83,82,36,201,2021
2019_A21231,97,83,67,247,2019
2019_C21232,96,76,56,228,2019
2022_B21233,89,87,43,219,2022
2021_A21234,77,45,61,183,2021
2019_B21235,85,84,68,237,2019
2021_A21236,95,79,39,213,2021
2019_A21237,77,61,78,216,2019
2022_B21238,95,82,73,250,2022
2021_C21239,74,63,49,186,2021
2022_A21240,93,91,59,243,2022
2019_B21241,77,67,59,203,2019
2021_B21242,97,95,50,242,2021
2021_A21243,77,53,38,168,2021
2021_B21244,78,49,54,181,2021
2021_B21245,94,83,51,228,2021
2019_C21246,90,62,68,220,2019
2021_A21247,74,83,60,217,2021
2021_B21248,75,70,55,200,2021
2019_B21249,97,93,47,237,2019
2021_A21250,95,84,36,215,2021
2021_B21251,82,85,57,224,2021
2019_B21252,91,68,56,215,2019
2021_A21253,85,92,77,254,2021
2022_B21254,94,65,76,235,2022
2019_B21255,79,77,36,192,2019
2019_A21256,92,91,62,245,2019
2021_A21257,91,48,47,186,2021
2022_A21258,97,72,64,233,2022
2022_B21259,86,65,70,221,2022
2019_A21260,73,63,55,191,2019
2021_C21261,75,86,53,214,2021
2022_A21262,75,72,51,198,2022
2022_A21263,79,76,64,219,2022
2019_A21264,90,62,68,220,2019
2019_B21265,80,76,49,205,2019
2022_A21266,91,67,66,224,2022
2022_C21267,81,70,56,207,2022
2022_B21268,72,74,51,197,2022
2022_B21269,90,74,75,239,2022
2019_A21270,82,81,53,216,2019
2022_A21271,88,90,55,233,2022
2022_C21272,76,78,37,191,2022
2021_B21273,80,47,49,176,2021
2022_A21274,78,56,45,179,2022
2019_B21275,95,53,68,216,2019
2021_C21276,87,58,58,203,2021
2019_A21277,71,62,39,172,2019
2022_B21278,74,54,58,186,2022
2019_C21279,81,89,56,226,2019
2022_C21280,96,46,57,199,2022
2022_C21281,88,80,65,233,2022
2021_B21282,90,55,49,194,2021
2019_B21283,88,70,42,200,2019
2022_B21284,89,87,59,235,2022
2022_C21285,91,53,42,186,2022
2019_A21286,85,72,65,222,2019
2021_C21287,78,53,51,182,2021
2022_C21288,92,76,57,225,2022
2022_C21289,80,59,54,193,2022
2022_A21290,88,85,70,243,2022
2019_C21291,86,48,79,213,2019
2019_A21292,84,58,61,203,2019
2019_B21293,72,64,44,180,2019
2021_A21294,82,49,45,176,2021
2022_B21295,77,84,61,222,2022
2021_A21296,97,75,62,234,2021
2022_B21297,91,78,54,223,2022
2019_C21298,86,77,71,234,2019
2022_A21299,96,52,76,224,2022
2021_A21300,89,71,61,221,2021
2021_B21301,71,78,38,187,2021
2021_B21302,78,51,71,200,2021
2021_A21303,88,88,79,255,2021
2019_A21304,86,47,47,180,2019
2022_C21305,72,76,48,196,2022
2019_B21306,83,63,44,190,2019
2021_C21307,91,50,46,187,2021
2021_B21308,97,53,72,222,2021
2022_C21309,79,67,59,205,2022
2022_C21310,74,93,57,224,2022
2019_A21311,85,49,55,189,2019
2022_C21312,87,95,41,223,2022
2022_A21313,86,48,66,200,2022
2019_B21314,92,49,40,181,2019
2022_B21315,84,60,59,203,2022
2021_A21316,72,72,76,220,2021
2021_B21317,85,94,40,219,2021
2021_B21318,95,62,36,193,2021
2021_C21319,71,91,68,230,2021
2022_A21320,97,54,37,188,2022
2021_B21321,72,96,47,215,2021
2019_A21322,88,63,57,208,2019
2019_B21323,83,90,36,209,2019
2022_A21324,84,88,70,242,2022
2022_C21325,89,69,39,197,2022
2021_A21326,79,72,77,228,2021
2022_A21327,86,72,35,193,2022
2021_C21328,83,86,44,213,2021
2022_B21329,73,96,78,247,2022
2022_C21330,75,72,66,213,2022
2019_A21331,78,63,47,188,2019
2022_B21332,78,82,53,213,2022
2019_B21333,72,45,39,156,2019
2019_A21334,81,78,65,224,2019
2021_B21335,92,75,62,229,2021
2019_B21336,94,73,35,202,2019
2022_A21337,84,50,77,211,2022
2022_C21338,93,45,49,187,2022
2021_A21339,90,83,46,219,2021
2019_A21340,97,88,69,254,2019
2019_A21341,81,56,42,179,2019
2021_A21342,74,60,64,198,2021
2022_B21343,71,45,71,187,2022
2022_C21344,77,76,72,225,2022
2019_A21345,89,74,66,229,2019
2019_C21346,85,61,76,222,2019
2022_A21347,85,50,53,188,2022
2019_C21348,90,54,66,210,2019
2019_A21349,79,50,71,200,2019
2021_B21350,92,95,66,253,2021
2019_C21351,75,81,72,228,2019
2021_B21352,75,68,56,199,2021
2019_C21353,75,76,68,219,2019
2021_B21354,74,55,65,194,2021
2022_C21355,79,57,75,211,2022
2022_C21356,89,81,55,225,2022
2021_A21357,90,74,68,232,2021
2021_A21358,80,48,75,203,2021
2019_A21359,83,90,54,227,2019
2019_B21360,78,71,61,210,2019
2019_B21361,94,78,76,248,2019
2022_B21362,77,54,73,204,2022
2021_A21363,85,88,69,242,2021
2022_B21364,92,92,72,256,2022
2019_B21365,78,81,43,202,2019
2021_B21366,92,52,58,202,2021
2019_B21367,73,64,50,187,2019
2019_A21368,95,94,37,226,2019
2022_B21369,86,87,48,221,2022
2021_B21370,79,58,44,181,2021
2021_B21371,93,48,41,182,2021
2022_A21372,84,87,61,232,2022
2019_C21373,81,78,66,225,2019
2022_A21374,72,83,73,228,2022
2019_B21375,81,62,74,217,2019
2021_C21376,97,95,70,262,2021
2022_C21377,88,46,43,177,2022
2021_C21378,87,94,64,245,2021
2022_A21379,73,81,56,210,2022
2022_A21380,81,62,47,190,2022
2022_A21381,90,60,64,214,2022
2021_A21382,82,82,70,234,2021
2022_B21383,72,69,54,195,2022
2019_C21384,79,45,65,189,2019
2019_C21385,90,79,60,229,2019
2022_B21386,87,50,38,175,2022
2022_C21387,85,59,51,195,2022
2019_B21388,81,49,72,202,2019
2019_C21389,87,84,38,209,2019
2021_A21390,93,50,39,182,2021
2019_C21391,92,51,67,210,2019
2019_C21392,90,59,63,212,2019
2022_C21393,88,93,51,232,2022
2021_C21394,89,51,43,183,2021
2021_C21395,88,95,44,227,2021
2019_C21396,71,75,68,214,2019
2021_A21397,79,65,39,183,2021
2019_C21398,71,85,56,212,2019
2019_C21399,84,72,78,234,2019
2022_A21400,90,70,48,208,2022
2021_C21401,88,78,76,242,2021
2022_B21402,96,49,70,215,2022
2021_B21403,96,48,71,215,2021
2021_A21404,91,58,36,185,2021
2022_C21405,96,54,51,201,2022
2021_B21406,85,83,62,230,2021
2019_C21407,80,90,45,215,2019
2021_C21408,94,57,35,186,2021
2021_C21409,80,69,52,201,2021
2019_B21410,71,60,35,166,2019
2022_C21411,85,61,50,196,2022
2022_A21412,82,58,47,187,2022
2022_A21413,82,69,66,217,2022
2022_B21414,97,94,61,252,2022
2022_B21415,75,58,50,183,2022
2019_A21416,92,49,52,193,2019
2022_C21417,78,66,38,182,2022
2019_B21418,88,74,54,216,2019
2022_A21419,89,80,36,205,2022
2022_C21420,95,55,72,222,2022
2019_B21421,84,62,55,201,2019
2022_C21422,84,47,35,166,2022
2019_B21423,84,85,37,206,2019
2019_B21424,88,90,51,229,2019
2019_C21425,72,56,68,196,2019
2019_C21426,85,51,72,208,2019
2019_C21427,73,55,42,170,2019
2019_B21428,86,48,70,204,2019
2021_A21429,85,53,35,173,2021
2022_B21430,73,79,35,187,2022
2019_A21431,78,94,58,230,2019
2022_A21432,94,47,47,188,2022
2019_C21433,86,67,53,206,2019
2022_C21434,96,75,38,209,2022
2019_B21435,71,81,77,229,2019
2021_A21436,76,48,72,196,2021
2022_A21437,79,59,39,177,2022
2022_C21438,72,56,49,177,2022
2019_A21439,87,69,37,193,2019
2019_A21440,78,69,75,222,2019
2021_A21441,95,90,79,264,2021
2022_B21442,74,94,66,234,2022
2019_C21443,76,80,75,231,2019
2021_B21444,84,93,53,230,2021
2022_A21445,90,55,64,209,2022
2019_A21446,78,90,56,224,2019
2022_B21447,91,92,75,258,2022
2022_C21448,84,91,69,244,2022
2022_B21449,97,56,67,220,2022
2022_B21450,77,58,42,177,2022
2022_A21451,86,94,46,226,2022
2022_C21452,76,75,78,229,2022
2022_B21453,84,45,67,196,2022
2021_A21454,88,80,65,233,2021
2022_B21455,78,74,63,215,2022
2022_A21456,74,74,44,192,2022
2019_A21457,86,94,73,253,2019
2022_A21458,89,92,61,242,2022
2022_B21459,96,55,36,187,2022
2022_A21460,88,95,41,224,2022
2021_C21461,92,64,79,235,2021
2019_B21462,72,57,73,202,2019
2019_A21463,87,55,71,213,2019
2021_A21464,81,54,73,208,2021
2019_A21465,90,68,72,230,2019
2021_C21466,89,64,53,206,2021
2021_C21467,97,64,46,207,2021
2021_A21468,76,60,72,208,2021
2019_C21469,82,80,63,225,2019
2019_A21470,93,74,54,221,2019
2019_C21471,72,54,52,178,2019
2021_B21472,83,53,49,185,2021
2021_C21473,83,93,72,248,2021
2019_C21474,82,49,59,190,2019
2019_B21475,79,96,74,249,2019
2021_B21476,83,69,45,197,2021
2022_C21477,96,61,36,193,2022
2021_C21478,87,64,75,226,2021
2019_C21479,72,94,50,216,2019
2021_B21480,84,87,59,230,2021
2022_C21481,82,51,70,203,2022
2021_A21482,73,49,72,194,2021
2019_A21483,83,82,65,230,2019
2021_A21484,82,88,75,245,2021
2019_B21485,96,64,79,239,2019
2021_A21486,87,62,47,196,2021
2019_C21487,87,94,49,230,2019
2022_C21488,71,81,57,209,2022
2022_B21489,75,49,72,196,2022
2022_C21490,91,80,79,250,2022
2022_C21491,73,73,78,224,2022
2022_B21492,80,95,57,232,2022
2022_B21493,96,58,63,217,2022
2021_C21494,74,95,62,231,2021
2021_B21495,79,76,42,197,2021
2019_B21496,91,60,61,212,2019
2019_C21497,82,45,75,202,2019
2022_A21498,95,67,35,197,2022
2022_C21499,82,88,53,223,2022
2019_A21500,71,96,75,242,2019
2021_A21501,91,61,43,195,2021
2021_A21502,83,52,70,205,2021
2022_B21503,82,73,48,203,2022
2019_C21504,75,76,57,208,2019
2022_C21505,82,83,65,230,2022
2022_B21506,87,83,69,239,2022
2019_A21507,80,69,67,216,2019
2022_C21508,97,90,53,240,2022
2021_C21509,95,94,55,244,2021
2021_C21510,78,60,39,177,2021
2019_C21511,88,69,51,208,2019
2019_C21512,72,64,59,195,2019
2021_B21513,95,84,42,221,2021
2019_A21514,92,67,66,225,2019
2022_B21515,91,69,40,200,2022
2019_C21516,91,53,58,202,2019
2022_C21517,75,54,53,182,2022
2019_C21518,73,58,62,193,2019
2019_B21519,97,76,55,228,2019
2022_C21520,71,61,65,197,2022
2019_B21521,83,84,77,244,2019
2022_C21522,82,47,66,195,2022
2019_B21523,87,89,59,235,2019
2022_C21524,94,80,59,233,2022
2021_B21525,94,46,46,186,2021
2022_B21526,80,53,49,182,2022
2021_C21527,91,69,36,196,2021
2021_C21528,79,81,60,220,2021
2019_A21529,87,73,44,204,2019
2021_B21530,89,76,39,204,2021
2021_B21531,84,84,43,211,2021
2019_A21532,79,68,61,208,2019
2022_B21533,79,53,48,180,2022
2019_B21534,87,81,50,218,2019
2021_C21535,95,73,69,237,2021
2019_C21536,94,82,45,221,2019
2019_B21537,73,89,44,206,2019
2019_B21538,77,73,46,196,2019
2022_A21539,77,58,58,193,2022
2021_B21540,97,68,79,244,2021
2021_A21541,94,79,54,227,2021
2022_A21542,97,59,51,207,2022
2019_A21543,76,75,35,186,2019
2019_B21544,73,92,56,221,2019
2019_B21545,89,70,44,203,2019
2019_C21546,85,84,41,210,2019
2022_B21547,92,74,46,212,2022
2019_A21548,75,73,46,194,2019
2019_B21549,81,58,70,209,2019
2019_C21550,92,85,71,248,2019
2022_B21551,95,61,69,225,2022
2019_B21552,82,56,49,187,2019
2021_B21553,97,79,42,218,2021
2022_A21554,91,84,51,226,2022
2022_A21555,97,79,65,241,2022
2021_A21556,86,60,35,181,2021
2019_A21557,75,73,45,193,2019
2022_B21558,78,80,43,201,2022
2021_A21559,84,46,63,193,2021
2021_B21560,73,70,49,192,2021
2019_A21561,74,78,58,210,2019
2021_C21562,73,85,76,234,2021
2022_C21563,72,64,56,192,2022
2021_A21564,87,54,59,200,2021
2021_C21565,83,57,48,188,2021
2022_B21566,80,50,73,203,2022
2022_C21567,89,50,54,193,2022
2022_C21568,87,87,35,209,2022
2022_C21569,81,93,62,236,2022
2021_C21570,97,56,48,201,2021
2019_C21571,96,54,40,190,2019
2022_B21572,80,46,76,202,2022
2022_C21573,97,76,54,227,2022
2021_A21574,83,62,74,219,2021
2019_A21575,92,68,68,228,2019
2021_B21576,97,46,78,221,2021
2019_C21577,91,87,67,245,2019
2021_B21578,83,91,64,238,2021
2022_A21579,72,46,47,165,2022
2021_C21580,89,95,78,262,2021
2021_C21581,89,65,69,223,2021
2021_C21582,74,76,36,186,2021
2019_B21583,76,63,62,201,2019
2021_C21584,86,91,74,251,2021
2019_A21585,95,64,60,219,2019
2021_A21586,90,66,64,220,2021
2022_C21587,92,66,56,214,2022
2022_B21588,86,85,57,228,2022
2022_B21589,91,85,55,231,2022
2019_C21590,87,65,69,221,2019
2019_A21591,73,95,60,228,2019
2021_A21592,72,67,67,206,2021
2019_B21593,93,58,75,226,2019
2021_B21594,80,88,55,223,2021
2021_A21595,78,63,79,220,2021
2022_C21596,93,82,42,217,2022
2021_A21597,90,85,79,254,2021
2022_A21598,96,59,52,207,2022
2019_A21599,85,83,37,205,2019
2022_B21600,85,91,52,228,2022
2021_B21601,72,61,77,210,2021
2019_A21602,93,68,40,201,2019
2019_B21603,87,89,37,213,2019
2019_A21604,72,55,55,182,2019
2021_A21605,86,94,60,240,2021
2019_A21606,90,55,59,204,2019
2019_C21607,93,85,79,257,2019
2019_A21608,80,58,44,182,2019
2021_B21609,71,68,65,204,2021
2022_B21610,81,88,72,241,2022
2021_A21611,78,84,78,240,2021
2022_A21612,74,78,77,229,2022
2019_A21613,75,45,60,180,2019
2022_B21614,82,88,47,217,2022
2022_B21615,73,81,56,210,2022
2021_A21616,71,47,77,195,2021
2021_C21617,85,58,74,217,2021
2021_C21618,97,56,67,220,2021
2022_A21619,82,93,57,232,2022
2022_A21620,80,55,40,175,2022
2021_A21621,88,49,61,198,2021
2019_A21622,76,62,45,183,2019
2019_A21623,82,77,60,219,2019
2021_C21624,94,57,36,187,2021
2021_B21625,78,80,62,220,2021
2019_A21626,73,51,48,172,2019
2022_B21627,96,62,76,234,2022
2019_B21628,76,45,45,166,2019
2021_B21629,76,76,69,221,2021
2019_A21630,78,50,63,191,2019
2022_C21631,90,48,72,210,2022
2021_B21632,94,90,66,250,2021
2019_C21633,78,75,75,228,2019
2021_C21634,87,74,36,197,2021
2021_C21635,89,91,63,243,2021
2019_A21636,81,76,77,234,2019
2019_C21637,79,55,52,186,2019
2022_C21638,87,96,69,252,2022
2019_B21639,77,55,73,205,2019
2021_A21640,73,66,62,201,2021
2019_A21641,90,81,46,217,2019
2021_A21642,94,68,37,199,2021
2019_A21643,85,63,70,218,2019
2019_B21644,86,60,41,187,2019
2022_A21645,76,50,45,171,2022
2019_A21646,79,68,44,191,2019
2019_C21647,89,52,50,191,2019
2022_A21648,78,93,37,208,2022
2019_C21649,80,72,37,189,2019
2022_A21650,71,68,72,211,2022
2021_B21651,91,61,37,189,2021
2022_B21652,97,91,38,226,2022
2021_A21653,80,89,58,227,2021
2019_C21654,78,80,72,230,2019
2022_A21655,94,53,41,188,2022
2022_A21656,78,94,68,240,2022
2021_B21657,92,57,38,187,2021
2022_C21658,94,83,37,214,2022
2022_C21659,82,65,73,220,2022
2021_C21660,79,88,35,202,2021
2021_A21661,88,95,68,251,2021
2021_A21662,93,57,56,206,2021
2019_C21663,84,93,73,250,2019
2021_A21664,85,46,38,169,2021
2019_B21665,96,85,51,232,2019
2021_A21666,73,87,70,230,2021
2022_C21667,92,89,37,218,2022
2019_B21668,94,75,52,221,2019
2021_B21669,83,45,72,200,2021
2021_C21670,93,83,39,215,2021
2019_C21671,75,93,51,219,2019
2022_C21672,80,56,38,174,2022
2021_A21673,87,89,75,251,2021
2019_A21674,86,54,47,187,2019
2022_A21675,91,77,76,244,2022
2022_B21676,79,81,61,221,2022
2021_B21677,93,46,70,209,2021
2019_C21678,95,66,71,232,2019
2021_B21679,95,56,54,205,2021
2022_B21680,79,64,60,203,2022
2021_A21681,75,46,68,189,2021
2021_C21682,86,94,61,241,2021
2021_A21683,90,50,45,185,2021
2021_B21684,84,51,78,213,2021
2021_C21685,90,71,73,234,2021
2019_B21686,87,68,45,200,2019
2022_A21687,90,83,70,243,2022
2019_A21688,93,78,63,234,2019
2021_B21689,72,61,50,183,2021
2021_A21690,77,59,75,211,2021
2019_C21691,89,94,46,229,2019
2021_B21692,85,78,55,218,2021
2022_B21693,86,89,44,219,2022
2019_A21694,88,77,62,227,2019
2019_C21695,92,72,41,205,2019
2021_A21696,87,67,50,204,2021
2019_C21697,76,83,62,221,2019
2019_C21698,72,68,47,187,2019
2022_C21699,92,81,71,244,2022
2019_B21700,88,64,43,195,2019
2021_A21701,86,60,35,181,2021
2019_A21702,81,67,75,223,2019
2021_C21703,72,71,36,179,2021
2021_B21704,77,50,39,166,2021
2022_C21705,82,49,52,183,2022
2021_A21706,83,96,35,214,2021
2019_B21707,75,72,39,186,2019
2021_C21708,77,75,77,229,2021
2021_C21709,96,81,65,242,2021
2022_C21710,72,53,51,176,2022
2022_A21711,89,74,78,241,2022
2019_C21712,94,61,37,192,2019
2022_A21713,81,71,35,187,2022
2022_B21714,77,78,51,206,2022
2021_A21715,83,76,70,229,2021
2022_B21716,83,46,64,193,2022
2019_B21717,83,50,36,169,2019
2019_A21718,80,52,44,176,2019
2019_C21719,75,68,37,180,2019
2019_B21720,72,49,61,182,2019
2022_A21721,89,48,70,207,2022
2019_B21722,88,69,62,219,2019
2022_C21723,75,56,66,197,2022
2019_A21724,76,53,79,208,2019
2019_B21725,95,71,63,229,2019
2019_A21726,86,77,71,234,2019
2021_A21727,74,45,72,191,2021
2022_B21728,85,60,72,217,2022
2019_A21729,73,56,52,181,2019
2021_C21730,88,57,40,185,2021
2022_A21731,83,69,39,191,2022
2021_A21732,74,51,54,179,2021
2021_C21733,80,75,61,216,2021
2022_C21734,84,71,39,194,2022
2021_C21735,75,52,73,200,2021
2019_B21736,95,69,44,208,2019
2021_A21737,88,85,72,245,2021
2022_A21738,97,57,40,194,2022
2022_B21739,86,89,40,215,2022
2019_B21740,84,59,61,204,2019
2021_C21741,80,55,45,180,2021
2019_A21742,89,59,44,192,2019
2022_C21743,84,77,54,215,2022
2019_C21744,84,54,77,215,2019
2019_B21745,78,59,45,182,2019
2021_C21746,92,50,70,212,2021
2019_C21747,79,61,38,178,2019
2022_B21748,77,74,37,188,2022
2022_B21749,90,59,56,205,2022
2021_A21750,73,77,65,215,2021
2021_A21751,96,50,74,220,2021
2021_C21752,95,55,68,218,2021
2019_C21753,74,52,52,178,2019
2021_A21754,96,93,75,264,2021
2019_A21755,91,78,38,207,2019
2019_B21756,85,58,55,198,2019
2021_C21757,74,48,61,183,2021
2019_B21758,79,94,46,219,2019
2022_A21759,88,94,61,243,2022
2021_C21760,80,70,78,228,2021
2019_A21761,73,94,49,216,2019
2019_C21762,96,84,76,256,2019
2021_A21763,85,79,58,222,2021
2019_A21764,91,59,53,203,2019
2019_A21765,76,70,46,192,2019
2022_C21766,97,76,69,242,2022
2021_B21767,74,80,36,190,2021
2021_C21768,85,65,77,227,2021
2019_C21769,83,83,35,201,2019
2021_B21770,95,94,74,263,2021
2021_A21771,76,64,74,214,2021
2019_C21772,94,70,52,216,2019
2022_C21773,75,94,56,225,2022
2022_B21774,95,78,68,241,2022
2019_A21775,80,71,48,199,2019
2022_B21776,97,57,76,230,2022
2022_C21777,87,68,75,230,2022
2022_C21778,82,77,69,228,2022
2022_B21779,82,50,35,167,2022
2022_C21780,74,86,52,212,2022
2019_C21781,72,93,73,238,2019
2022_A21782,93,60,70,223,2022
2019_B21783,80,58,71,209,2019
2019_C21784,82,49,71,202,2019
2021_C21785,88,58,49,195,2021
2022_A21786,95,58,54,207,2022
2019_C21787,80,51,50,181,2019
2021_B21788,83,80,40,203,2021
2022_A21789,85,46,41,172,2022
2021_C21790,97,48,69,214,2021
2019_A21791,87,78,56,221,2019
2018_C33001,97,54,47,198,2018
2018_B33002,96,68,75,239,2018
2018_C33003,93,92,76,261,2018
2018_A33004,87,54,71,212,2018
2018_A33005,87,68,37,192,2018
2018_C33006,86,92,55,233,2018
2018_B33007,91,55,56,202,2018
2018_A33008,93,66,60,219,2018
2018_A33009,84,47,40,171,2018
2018_A33010,74,78,49,201,2018
2018_B33011,87,46,55,188,2018
2018_A33012,83,77,64,224,2018
2018_A33013,96,86,47,229,2018
2018_B33014,72,53,50,175,2018
2018_B33015,72,50,39,161,2018
2018_B33016,92,54,64,210,2018
2018_B33017,81,59,62,202,2018
2018_C33018,79,66,73,218,2018
2018_A33019,93,66,60,219,2018
2018_C33020,91,60,49,200,2018
2018_B33021,74,72,54,200,2018
2018_A33022,77,47,64,188,2018
2018_C33023,86,51,41,178,2018
2018_A33024,80,87,35,202,2018
2018_A33025,78,48,50,176,2018
2018_A33026,72,52,49,173,2018
2018_A33027,80,64,37,181,2018
2018_A33028,81,57,38,176,2018
2018_B33029,88,46,76,210,2018
2018_B33030,93,72,75,240,2018
2018_B33031,83,96,39,218,2018
2018_A33032,73,94,63,230,2018
2018_A33033,72,69,78,219,2018
2018_C33034,72,83,66,221,2018
2018_B33035,71,71,44,186,2018
2018_A33036,72,81,63,216,2018
2018_C33037,78,79,75,232,2018
2018_B33038,89,79,48,216,2018
2018_A33039,74,88,46,208,2018
2018_C33040,80,94,67,241,2018
2018_C33041,71,94,71,236,2018
2018_A33042,83,83,41,207,2018
2018_C33043,88,60,56,204,2018
2018_C33044,81,62,68,211,2018
2018_C33045,85,74,40,199,2018
2018_A33046,75,72,49,196,2018
2018_A33047,74,83,38,195,2018
2018_C33048,90,65,57,212,2018
2018_A33049,84,85,49,218,2018
2018_A33050,87,48,67,202,2018
2018_A33051,94,56,64,214,2018
2018_C33052,85,56,51,192,2018
2018_A33053,85,80,56,221,2018
2018_B33054,74,78,41,193,2018
2018_A33055,77,91,44,212,2018
2018_B33056,97,72,41,210,2018
2018_C33057,91,86,36,213,2018
2018_C33058,96,61,60,217,2018
2018_A33059,72,94,51,217,2018
2018_A33060,87,59,62,208,2018
2018_C33061,86,79,78,243,2018
2018_C33062,77,89,72,238,2018
2018_C33063,72,58,38,168,2018
2018_B33064,85,45,72,202,2018
2018_C33065,84,67,51,202,2018
2018_C33066,92,96,75,263,2018
2018_C33067,88,64,62,214,2018
2018_C33068,80,64,38,182,2018
2018_A33069,85,48,62,195,2018
2018_B33070,92,76,41,209,2018
2018_B33071,91,52,51,194,2018
2018_C33072,77,82,44,203,2018
2018_B33073,76,61,79,216,2018
2018_B33074,88,96,65,249,2018
2018_C33075,76,62,52,190,2018
2018_A33076,89,62,49,200,2018
2018_C33077,78,96,58,232,2018
2018_C33078,73,72,63,208,2018
2018_B33079,84,48,50,182,2018
2018_B33080,81,58,61,200,2018
2018_B33081,75,91,54,220,2018
2018_A33082,93,54,37,184,2018
2018_C33083,80,75,75,230,2018
2018_C33084,89,88,45,222,2018
2018_A33085,87,55,44,186,2018
2018_C33086,74,89,53,216,2018
2018_B33087,74,50,73,197,2018
2018_C33088,88,57,72,217,2018
2018_B33089,88,49,72,209,2018
2018_A33090,89,78,37,204,2018
2018_A33091,91,60,70,221,2018
2018_A33092,76,76,37,189,2018
2018_A33093,87,45,62,194,2018
2018_A33094,82,45,72,199,2018
2018_A33095,73,64,36,173,2018
2018_C33096,81,49,45,175,2018
2018_C33097,97,77,51,225,2018
2018_A33098,72,74,37,183,2018
2018_C33099,71,69,76,216,2018
2018_A33100,72,54,40,166,2018
2018_B33101,76,72,77,225,2018
2018_A33102,92,71,59,222,2018
2018_B33103,88,55,46,189,2018
2018_B33104,82,77,50,209,2018
2018_B33105,89,48,51,188,2018
2018_C33106,77,50,55,182,2018
2018_C33107,80,61,37,178,2018
2018_A33108,73,88,61,222,2018
2018_B33109,84,88,67,239,2018
2018_B33110,73,70,50,193,2018
2018_C33111,83,69,72,224,2018
2018_A33112,79,48,37,164,2018
2018_B33113,96,82,47,225,2018
2018_A33114,94,55,54,203,2018
2018_A33115,92,96,59,247,2018
2018_C33116,75,58,69,202,2018
2018_A33117,85,73,56,214,2018
2018_B33118,74,82,58,214,2018
2018_A33119,97,80,63,240,2018
2018_A33120,88,50,46,184,2018
2018_B33121,92,95,50,237,2018
2018_B33122,72,52,73,197,2018
2018_C33123,96,59,62,217,2018
2018_B33124,97,91,42,230,2018
2018_C33125,87,58,68,213,2018
2018_B33126,80,89,35,204,2018
2018_B33127,77,62,68,207,2018
2018_C33128,85,88,35,208,2018
2018_A33129,91,57,69,217,2018
2018_C33130,93,46,49,188,2018
2018_A33131,95,76,78,249,2018
2018_A33132,79,53,41,173,2018
2018_B33133,81,53,39,173,2018
2018_A33134,78,57,38,173,2018
2018_A33135,72,74,37,183,2018
2018_C33136,93,92,40,225,2018
2018_C33137,81,88,40,209,2018
2018_B33138,95,72,62,229,2018
2018_C33139,78,61,67,206,2018
2018_C33140,86,55,75,216,2018
2018_A33141,74,49,67,190,2018
2018_A33142,85,63,77,225,2018
2018_B33143,92,79,44,215,2018
2018_B33144,72,76,78,226,2018
2018_A33145,79,93,79,251,2018
2018_C33146,73,61,78,212,2018
2018_B33147,80,56,49,185,2018
2018_A33148,81,48,78,207,2018
2018_B33149,72,88,69,229,2018
2018_A33150,95,93,66,254,2018
2018_A33151,74,92,75,241,2018
2018_B33152,73,64,65,202,2018
2018_B33153,83,51,63,197,2018
2018_A33154,79,62,54,195,2018
2018_C33155,75,80,37,192,2018
2018_C33156,90,66,35,191,2018
2018_B33157,77,96,77,250,2018
2018_A33158,75,68,52,195,2018
2018_B33159,87,74,65,226,2018
2018_A33160,93,85,72,250,2018
2018_C33161,95,86,73,254,2018
2018_C33162,74,48,47,169,2018
2018_C33163,74,71,68,213,2018
2018_A33164,88,53,55,196,2018
2018_A33165,95,83,56,234,2018
2018_C33166,96,74,74,244,2018
2018_A33167,85,46,44,175,2018
2018_C33168,73,77,44,194,2018
2018_A33169,71,50,38,159,2018
2018_B33170,87,96,44,227,2018
2018_B33171,78,86,42,206,2018
2018_B33172,90,66,36,192,2018
2018_C33173,77,83,35,195,2018
2018_C33174,93,67,45,205,2018
2018_A33175,93,65,60,218,2018
2018_A33176,87,96,68,251,2018
2018_B33177,94,69,45,208,2018
2018_B33178,88,91,51,230,2018
2018_A33179,75,86,70,231,2018
2018_C33180,81,47,62,190,2018
2018_B33181,88,75,49,212,2018
2018_A33182,88,71,64,223,2018
2018_B33183,90,82,79,251,2018
2018_A33184,90,95,71,256,2018
2018_C33185,76,78,72,226,2018
2018_A33186,85,45,51,181,2018
2018_A33187,76,87,48,211,2018
2018_C33188,81,71,56,208,2018
2018_A33189,80,55,60,195,2018
2018_A33190,90,68,56,214,2018
2018_A33191,81,76,73,230,2018
2018_A33192,79,95,69,243,2018
2018_C33193,82,69,71,222,2018
2018_A33194,87,93,45,225,2018
2018_B33195,73,69,75,217,2018
2018_A33196,95,83,70,248,2018
2018_A33197,81,94,59,234,2018
2018_C33198,95,79,70,244,2018
2018_C33199,87,50,49,186,2018
2018_C33200,92,62,45,199,2018
2018_B33201,87,65,47,199,2018
2018_A33202,83,78,70,231,2018
2018_C33203,76,88,68,232,2018
2018_C33204,84,60,55,199,2018
2018_C33205,73,46,67,186,2018
2018_B33206,81,87,72,240,2018
2018_C33207,90,48,47,185,2018
2018_A33208,93,80,47,220,2018
2018_C33209,75,45,63,183,2018
2018_B33210,91,51,43,185,2018
2018_C33211,97,52,47,196,2018
2018_C33212,93,72,50,215,2018
2018_A33213,82,79,77,238,2018
2018_B33214,92,64,54,210,2018
2018_B33215,92,72,68,232,2018
2018_B33216,96,59,52,207,2018
2018_C33217,74,45,40,159,2018
2018_A33218,80,81,58,219,2018
2018_B33219,84,82,61,227,2018
2018_A33220,95,81,46,222,2018
2018_C33221,89,55,76,220,2018
2018_C33222,86,91,46,223,2018
2018_C33223,91,56,61,208,2018
2018_A33224,93,50,57,200,2018
2018_A33225,77,58,37,172,2018
2018_B33226,95,51,79,225,2018
2018_B33227,86,77,70,233,2018
2018_A33228,89,53,72,214,2018
2018_A33229,91,75,42,208,2018
2018_C33230,76,51,64,191,2018
2018_A33231,86,74,75,235,2018
2018_B33232,86,95,42,223,2018
2018_A33233,86,79,71,236,2018
2018_C33234,79,57,76,212,2018
2018_A33235,88,49,47,184,2018
2018_B33236,73,61,68,202,2018
2018_A33237,81,89,40,210,2018
2018_A33238,85,61,36,182,2018
2018_C33239,93,52,42,187,2018
2018_A33240,72,46,77,195,2018
2018_A33241,81,83,64,228,2018
2018_C33242,92,94,35,221,2018
2018_B33243,78,80,61,219,2018
2018_A33244,96,47,45,188,2018
2018_C33245,94,86,68,248,2018
2018_B33246,83,58,44,185,2018
2018_A33247,77,83,52,212,2018
2018_C33248,75,54,66,195,2018
2018_B33249,77,79,77,233,2018
2018_B33250,82,90,38,210,2018
2018_B33251,92,75,62,229,2018
2018_A33252,92,51,67,210,2018
2018_C33253,81,56,40,177,2018
2018_C33254,80,46,56,182,2018
2018_B33255,74,87,66,227,2018
2018_B33256,71,50,44,165,2018
2018_A33257,86,52,37,175,2018
2018_A33258,86,49,75,210,2018
2018_A33259,96,69,41,206,2018
2018_A33260,86,89,63,238,2018
2018_A33261,79,77,44,200,2018
2018_C33262,75,54,58,187,2018
2018_C33263,92,54,75,221,2018
2018_B33264,79,91,63,233,2018
2018_C33265,79,70,37,186,2018
2018_B33266,90,46,76,212,2018
2018_A33267,90,80,77,247,2018
2018_C33268,78,76,56,210,2018
2018_A33269,84,85,67,236,2018
2018_A33270,78,61,39,178,2018
2018_B33271,92,82,50,224,2018
2018_C33272,97,67,40,204,2018
2018_B33273,93,86,77,256,2018
2018_B33274,83,69,78,230,2018
2018_A33275,76,77,46,199,2018
2018_C33276,72,59,36,167,2018
2018_B33277,96,77,72,245,2018
2018_A33278,95,69,71,235,2018
2018_B33279,79,81,50,210,2018
2018_C33280,79,58,73,210,2018
2018_B33281,81,65,39,185,2018
2018_B33282,93,73,45,211,2018
2018_B33283,79,79,51,209,2018
2018_A33284,73,83,58,214,2018
2018_A33285,78,86,48,212,2018
2018_A33286,81,96,51,228,2018
2018_B33287,82,90,67,239,2018
2018_B33288,80,63,50,193,2018
2018_C33289,91,77,35,203,2018
2018_C33290,86,48,67,201,2018
2018_C33291,89,60,62,211,2018
2018_A33292,81,65,54,200,2018
2018_C33293,90,87,52,229,2018
2018_B33294,94,67,70,231,2018
2018_C33295,84,84,73,241,2018
2018_A33296,84,84,61,229,2018
2018_A33297,96,72,50,218,2018
2018_C33298,75,58,58,191,2018
2018_B33299,87,87,60,234,2018
2018_C33300,82,67,67,216,2018
2018_A33301,86,61,54,201,2018
2018_B33302,94,63,59,216,2018
2018_B33303,90,93,46,229,2018
2018_A33304,87,84,68,239,2018
2018_B33305,72,51,55,178,2018
2018_B33306,83,86,45,214,2018
2018_B33307,93,96,79,268,2018
2018_B33308,74,92,39,205,2018
2018_A33309,87,48,53,188,2018
2018_C33310,75,51,39,165,2018
2018_A33311,77,87,36,200,2018
2018_B33312,93,91,55,239,2018
2018_B33313,81,93,36,210,2018
2018_A33314,76,93,61,230,2018
2018_A33315,82,87,75,244,2018
2018_C33316,74,58,46,178,2018
2018_C33317,92,61,46,199,2018
2018_A33318,86,49,74,209,2018
2018_B33319,84,92,63,239,2018
2018_A33320,96,56,64,216,2018
2018_B33321,96,52,60,208,2018
2018_A33322,75,67,68,210,2018
2018_C33323,86,53,75,214,2018
2018_A33324,84,82,60,226,2018
2018_A33325,93,50,62,205,2018
2018_B33326,84,75,76,235,2018
2018_B33327,87,68,40,195,2018
2018_B33328,81,85,67,233,2018
2018_A33329,94,92,78,264,2018
2018_A33330,94,48,35,177,2018
2018_C33331,77,49,46,172,2018
2018_C33332,73,95,47,215,2018
2018_B33333,73,66,72,211,2018
2018_A33334,89,49,74,212,2018
2018_B33335,83,93,41,217,2018
2018_A33336,90,92,59,241,2018
2018_A33337,83,85,48,216,2018
2018_B33338,84,80,42,206,2018
2018_C33339,87,47,53,187,2018
2018_A33340,87,65,74,226,2018
2018_C33341,73,92,72,237,2018
2018_B33342,83,51,62,196,2018
2018_C33343,73,60,47,180,2018
2018_C33344,97,95,71,263,2018
2018_B33345,96,85,35,216,2018
2018_C33346,86,48,62,196,2018
2018_C33347,75,65,74,214,2018
2018_C33348,77,83,69,229,2018
2018_C33349,95,86,37,218,2018
2018_A33350,97,88,50,235,2018
2018_A33351,79,83,62,224,2018
2018_B33352,77,46,69,192,2018
2018_C33353,83,45,77,205,2018
2018_C33354,92,79,38,209,2018
2018_B33355,74,69,69,212,2018
2018_C33356,83,84,52,219,2018
2018_B33357,83,83,35,201,2018
2018_C33358,84,88,64,236,2018
2018_B33359,82,64,74,220,2018
2018_C33360,96,87,55,238,2018
2018_A33361,87,96,57,240,2018
2018_A33362,71,45,54,170,2018
2018_A33363,81,61,66,208,2018
2018_A33364,95,63,62,220,2018
2018_A33365,85,79,69,233,2018
2018_A33366,90,79,45,214,2018
2018_A33367,97,58,51,206,2018
2018_C33368,95,55,45,195,2018
2018_B33369,79,53,77,209,2018
2018_B33370,90,59,58,207,2018
2018_B33371,94,45,57,196,2018
2018_C33372,88,79,63,230,2018
2018_B33373,75,82,50,207,2018
2018_B33374,78,78,77,233,2018
2018_A33375,84,86,74,244,2018
2018_C33376,84,91,71,246,2018
2018_A33377,88,58,79,225,2018
2018_A33378,96,57,74,227,2018
2018_C33379,79,48,73,200,2018
2018_A33380,87,53,53,193,2018
2018_B33381,90,76,70,236,2018
2018_C33382,75,82,53,210,2018
2018_B33383,92,55,69,216,2018
2018_B33384,80,58,57,195,2018
2018_A33385,95,65,46,206,2018
2018_C33386,80,88,45,213,2018
2018_A33387,91,96,49,236,2018
2018_A33388,92,48,45,185,2018
2018_A33389,71,51,41,163,2018
2018_B33390,73,95,67,235,2018
2018_B33391,96,93,51,240,2018
2018_C33392,78,70,54,202,2018
2018_A33393,71,89,71,231,2018
2018_A33394,75,54,47,176,2018
2018_B33395,72,86,52,210,2018
2018_C33396,85,57,79,221,2018
2018_A33397,78,93,73,244,2018
2018_A33398,86,71,51,208,2018
2018_B33399,76,71,59,206,2018
2018_B33400,81,62,53,196,2018
2018_C33401,79,54,66,199,2018
2018_C33402,83,81,72,236,2018
2018_A33403,91,94,55,240,2018
2018_C33404,72,74,42,188,2018
2018_A33405,87,46,52,185,2018
2018_C33406,71,67,64,202,2018
2018_C33407,92,94,61,247,2018
2018_B33408,93,54,77,224,2018
2018_A33409,83,74,50,207,2018
2018_B33410,88,91,61,240,2018
2018_A33411,87,63,70,220,2018
2018_A33412,73,95,44,212,2018
2018_C33413,80,59,35,174,2018
2018_B33414,95,69,54,218,2018
2018_B33415,76,89,54,219,2018
2018_C33416,81,48,58,187,2018
2018_B33417,96,60,40,196,2018
2018_C33418,93,82,49,224,2018
2018_B33419,91,53,69,213,2018
2018_B33420,75,60,47,182,2018
2018_A33421,71,79,51,201,2018
2018_B33422,71,84,62,217,2018
2018_B33423,76,58,56,190,2018
2018_A33424,79,55,60,194,2018
2018_B33425,93,51,63,207,2018
2018_A33426,95,45,50,190,2018
2018_A33427,83,91,60,234,2018
2018_C33428,72,71,55,198,2018
2018_B33429,74,49,45,168,2018
2018_B33430,82,71,61,214,2018
2018_C33431,96,95,65,256,2018
2018_A33432,93,65,57,215,2018
2018_A33433,86,71,41,198,2018
2018_C33434,78,75,65,218,2018
2018_A33435,87,93,55,235,2018
2018_A33436,91,77,70,238,2018
2018_C33437,82,59,54,195,2018
2018_C33438,82,81,51,214,2018
2018_A33439,97,56,64,217,2018
2018_A33440,80,55,56,191,2018
2018_C33441,82,64,41,187,2018
2018_B33442,83,48,59,190,2018
2018_C33443,86,61,67,214,2018
2018_B33444,84,73,53,210,2018
2018_C33445,85,78,76,239,2018
2018_A33446,97,68,49,214,2018
2018_A33447,74,93,54,221,2018
2018_B33448,94,86,76,256,2018
2018_A33449,93,92,46,231,2018
2018_B33450,91,63,40,194,2018
2018_A33451,78,81,79,238,2018
2018_A33452,84,80,48,212,2018
2018_C33453,88,55,37,180,2018
2018_C33454,72,81,74,227,2018
2018_C33455,74,83,75,232,2018
2018_A33456,77,67,38,182,2018
2018_B33457,79,52,66,197,2018
2018_A33458,76,81,37,194,2018
2018_B33459,87,93,51,231,2018
2018_A33460,74,84,77,235,2018
2018_B33461,89,46,36,171,2018
2018_C33462,81,54,65,200,2018
2018_A33463,95,66,41,202,2018
2018_A33464,77,45,67,189,2018
2018_B33465,83,79,55,217,2018
2018_B33466,88,90,41,219,2018
2018_B33467,73,69,70,212,2018
2018_C33468,83,55,57,195,2018
2018_A33469,78,46,61,185,2018
2018_C33470,75,91,41,207,2018
2018_A33471,79,58,42,179,2018
2018_B33472,94,78,67,239,2018
2018_C33473,81,80,49,210,2018
2018_B33474,95,48,75,218,2018
2018_C33475,81,95,78,254,2018
2018_C33476,75,59,40,174,2018
2018_B33477,79,57,71,207,2018
2018_B33478,97,63,42,202,2018
2018_B33479,90,81,45,216,2018
2018_C33480,80,90,46,216,2018
2018_B33481,97,87,57,241,2018
2018_B33482,78,50,41,169,2018
2018_B33483,87,75,54,216,2018
2018_C33484,89,58,63,210,2018
2018_B33485,91,51,39,181,2018
2018_A33486,91,56,71,218,2018
2018_A33487,83,56,36,175,2018
2018_A33488,72,47,70,189,2018
2018_C33489,77,94,47,218,2018
2018_A33490,72,45,68,185,2018
2018_A33491,86,96,35,217,2018
2018_B33492,83,84,36,203,2018
2018_B33493,95,80,78,253,2018
2018_B33494,75,48,69,192,2018
2018_C33495,85,86,68,239,2018
2018_A33496,86,72,68,226,2018
2018_A33497,82,71,67,220,2018
2018_A33498,83,77,59,219,2018
2018_A33499,91,91,57,239,2018
2018_A33500,81,93,71,245,2018
2018_C33501,71,52,65,188,2018
2018_B33502,97,93,65,255,2018
2018_C33503,93,49,58,200,2018
2018_B33504,85,56,39,180,2018
2018_C33505,77,84,51,212,2018
2018_B33506,76,89,42,207,2018
2018_A33507,73,93,62,228,2018
2018_B33508,94,70,51,215,2018
2018_B33509,79,50,60,189,2018
2018_C33510,89,48,45,182,2018
2018_A33511,82,77,66,225,2018
2018_A33512,96,65,77,238,2018
2018_B33513,71,57,46,174,2018
2018_C33514,81,83,62,226,2018
2018_B33515,93,74,59,226,2018
2018_B33516,97,92,48,237,2018
2018_B33517,76,90,40,206,2018
2018_C33518,80,56,72,208,2018
2018_B33519,78,57,70,205,2018
2018_C33520,92,59,38,189,2018
2018_B33521,72,96,67,235,2018
2018_B33522,95,76,41,212,2018
2018_B33523,82,85,56,223,2018
2018_C33524,93,76,56,225,2018
2018_A33525,82,95,41,218,2018
2018_A33526,75,58,64,197,2018
2018_B33527,91,82,64,237,2018
2018_C33528,72,93,38,203,2018
2018_C33529,89,49,44,182,2018
2018_B33530,78,63,74,215,2018
2018_A33531,82,70,37,189,2018
2018_B33532,84,50,69,203,2018
2018_A33533,95,86,39,220,2018
2018_C33534,82,89,41,212,2018
2018_C33535,88,64,44,196,2018
2018_A33536,87,47,76,210,2018
2018_B33537,97,52,72,221,2018
2018_A33538,81,57,55,193,2018
2018_A33539,97,96,54,247,2018
2018_A33540,88,66,48,202,2018
2018_A33541,79,91,51,221,2018
2018_C33542,71,72,73,216,2018
2018_A33543,85,76,36,197,2018
2018_A33544,77,68,42,187,2018
2018_A33545,71,89,76,236,2018
2018_C33546,90,86,72,248,2018
2018_A33547,84,93,76,253,2018
2018_B33548,92,96,76,264,2018
2018_C33549,96,62,58,216,2018
2018_B33550,92,56,50,198,2018
2018_C33551,83,81,76,240,2018
2018_A33552,78,94,44,216,2018
2018_B33553,84,85,79,248,2018
2018_B33554,93,93,74,260,2018
2018_B33555,97,96,39,232,2018
2018_A33556,89,77,70,236,2018
2018_B33557,76,88,76,240,2018
2018_C33558,90,77,77,244,2018
2018_C33559,94,94,50,238,2018
2018_A33560,90,72,63,225,2018
2018_B33561,80,52,76,208,2018
2018_B33562,88,52,49,189,2018
2018_A33563,88,61,70,219,2018
2018_B33564,96,47,49,192,2018
2018_C33565,83,52,64,199,2018
2018_B33566,76,75,70,221,2018
2018_A33567,95,58,65,218,2018
2018_B33568,73,91,68,232,2018
2018_C33569,82,92,58,232,2018
2018_C33570,79,63,69,211,2018
2018_A33571,81,61,41,183,2018
2018_C33572,93,82,60,235,2018
2018_B33573,94,57,47,198,2018
2018_A33574,73,93,58,224,2018
2018_A33575,83,72,74,229,2018
2018_A33576,86,52,51,189,2018
2018_B33577,89,78,37,204,2018
2018_C33578,82,55,72,209,2018
2018_B33579,79,47,70,196,2018
2018_B33580,92,94,47,233,2018
2018_C33581,86,63,42,191,2018
2018_B33582,85,62,64,211,2018
2018_A33583,79,86,39,204,2018
2018_C33584,94,77,36,207,2018
2018_C33585,77,65,72,214,2018
2018_B33586,93,88,47,228,2018
2018_B33587,89,75,70,234,2018
2018_A33588,80,66,49,195,2018
2018_B33589,81,76,50,207,2018
2018_C33590,92,70,76,238,2018
2018_A33591,76,62,70,208,2018
2018_A33592,82,67,52,201,2018
2018_B33593,80,87,73,240,2018
2018_C33594,97,92,64,253,2018
2018_A33595,96,91,42,229,2018
2018_C33596,75,92,62,229,2018
2018_C33597,93,66,60,219,2018
2018_C33598,88,73,63,224,2018
2018_A33599,96,89,60,245,2018
2018_B33600,87,83,59,229,2018
2018_B33601,74,81,58,213,2018
2018_C33602,83,66,38,187,2018
2018_C33603,72,90,67,229,2018
2018_C33604,84,94,61,239,2018
2018_C33605,71,95,49,215,2018
2018_C33606,92,51,44,187,2018
2018_A33607,76,56,70,202,2018
2018_A33608,79,46,58,183,2018
2018_A33609,72,58,41,171,2018
2018_B33610,75,68,59,202,2018
2018_B33611,96,77,61,234,2018
2018_A33612,77,91,65,233,2018
2018_B33613,78,59,53,190,2018
2018_A33614,90,60,55,205,2018
2018_A33615,83,74,53,210,2018
2018_C33616,71,75,51,197,2018
2018_B33617,87,46,43,176,2018
2018_B33618,90,60,63,213,2018
2018_C33619,74,91,46,211,2018
2018_A33620,82,71,69,222,2018
2018_C33621,76,78,40,194,2018
2018_A33622,92,64,37,193,2018
2018_B33623,83,94,49,226,2018
2018_B33624,93,60,46,199,2018
2018_B33625,80,90,79,249,2018
2018_B33626,94,86,75,255,2018
2018_B33627,96,80,76,252,2018
2018_B33628,95,93,51,239,2018
2018_C33629,92,92,79,263,2018
2018_C33630,73,94,36,203,2018
2018_B33631,84,82,73,239,2018
2018_C33632,73,49,76,198,2018
2018_A33633,96,61,65,222,2018
2018_A33634,81,78,63,222,2018
2018_B33635,95,64,43,202,2018
2018_C33636,82,57,74,213,2018
2018_C33637,90,54,44,188,2018
2018_C33638,74,62,39,175,2018
2018_B33639,92,72,69,233,2018
2018_A33640,78,55,57,190,2018
2018_A33641,83,71,58,212,2018
2018_A33642,89,60,57,206,2018
2018_B33643,81,52,73,206,2018
2018_C33644,81,58,36,175,2018
2018_B33645,83,83,75,241,2018
2018_B33646,71,68,52,191,2018
2018_A33647,81,58,45,184,2018
2018_C33648,93,71,66,230,2018
2018_B33649,79,90,67,236,2018
2018_A33650,75,85,44,204,2018
2018_A33651,80,72,65,217,2018
2018_B33652,71,67,64,202,2018
2018_C33653,89,54,64,207,2018
2018_C33654,95,88,66,249,2018
2018_B33655,80,95,75,250,2018
2018_A33656,97,50,69,216,2018
2018_B33657,89,68,53,210,2018
2018_B33658,76,91,35,202,2018
2018_B33659,92,79,39,210,2018
2018_B33660,82,93,72,247,2018
2018_B33661,91,64,39,194,2018
2018_C33662,88,93,54,235,2018
2018_A33663,91,96,61,248,2018
2018_A33664,80,95,38,213,2018
2018_B33665,86,59,65,210,2018
2018_B33666,96,69,68,233,2018
2018_C33667,90,89,56,235,2018
2018_A33668,95,79,68,242,2018
2018_B33669,94,45,42,181,2018
2018_C33670,93,84,72,249,2018
2018_B33671,93,48,38,179,2018
2018_A33672,79,65,37,181,2018
2018_A33673,80,51,39,170,2018
2018_B33674,83,81,48,212,2018
2018_B33675,94,73,79,246,2018
2018_B33676,97,61,76,234,2018
2018_A33677,76,65,68,209,2018
2018_A33678,78,68,79,225,2018
2018_B33679,83,67,55,205,2018
2018_C33680,94,51,68,213,2018
2018_B33681,71,79,52,202,2018
2018_A33682,89,50,64,203,2018
2018_C33683,77,69,47,193,2018
2018_A33684,91,86,60,237,2018
2018_A33685,96,74,35,205,2018
2018_A33686,83,89,52,224,2018
2018_B33687,87,61,65,213,2018
2018_C33688,83,46,71,200,2018
2018_C33689,74,82,62,218,2018
2018_C33690,86,54,62,202,2018
2018_A33691,77,80,55,212,2018
2018_B33692,97,84,71,252,2018
2018_B33693,84,59,61,204,2018
2018_B33694,89,52,39,180,2018
2018_A33695,95,90,35,220,2018
2018_C33696,79,64,42,185,2018
2018_A33697,81,51,48,180,2018
2018_C33698,86,83,35,204,2018
2018_C33699,80,51,53,184,2018
2018_A33700,93,90,71,254,2018
2018_A33701,79,57,41,177,2018
2018_A33702,90,83,60,233,2018
2018_A33703,80,49,63,192,2018
2018_B33704,93,79,50,222,2018
2018_A33705,71,78,36,185,2018
2018_A33706,72,71,40,183,2018
2018_A33707,71,54,40,165,2018
2018_C33708,94,80,39,213,2018
2018_B33709,92,79,66,237,2018
2018_B33710,77,91,41,209,2018
2018_A33711,90,77,46,213,2018
2018_B33712,80,54,71,205,2018
2018_C33713,89,91,61,241,2018
2018_B33714,76,83,66,225,2018
2018_A33715,87,78,69,234,2018
2018_A33716,75,86,69,230,2018
2018_A33717,96,75,64,235,2018
2018_C33718,95,60,73,228,2018
2018_A33719,71,93,55,219,2018
2018_B33720,72,69,41,182,2018
2018_B33721,87,85,39,211,2018
2018_C33722,85,61,38,184,2018
2018_B33723,83,85,57,225,2018
2018_C33724,76,54,66,196,2018
2018_B33725,77,60,70,207,2018
2018_C33726,93,90,44,227,2018
2018_B33727,71,80,38,189,2018
2018_A33728,89,65,51,205,2018
2018_C33729,75,60,41,176,2018
2018_B33730,73,76,65,214,2018
2018_A33731,88,75,58,221,2018
2018_A33732,91,56,66,213,2018
2018_A33733,71,53,49,173,2018
2018_B33734,77,51,57,185,2018
2018_C33735,87,48,50,185,2018
2018_B33736,97,79,47,223,2018
2018_B33737,77,94,63,234,2018
2018_C33738,77,92,41,210,2018
2018_C33739,88,80,75,243,2018
2018_B33740,77,49,51,177,2018
2018_C33741,94,93,50,237,2018
2018_C33742,95,89,62,246,2018
2018_B33743,93,63,62,218,2018
2018_A33744,84,48,57,189,2018
2018_A33745,71,54,58,183,2018
2018_A33746,71,72,50,193,2018
2018_C33747,97,96,66,259,2018
2018_C33748,87,56,41,184,2018
2018_A33749,72,56,44,172,2018
2018_B33750,89,49,54,192,2018
2018_B33751,97,78,78,253,2018
2018_A33752,92,80,78,250,2018
2018_A33753,75,86,62,223,2018
2018_C33754,96,80,60,236,2018
2018_A33755,77,88,44,209,2018
2018_A33756,78,85,38,201,2018
2018_A33757,79,85,67,231,2018
2018_A33758,90,57,57,204,2018
2018_B33759,93,83,68,244,2018
2018_A33760,73,71,72,216,2018
2018_C33761,84,55,45,184,2018
2018_A33762,88,77,74,239,2018
2018_C33763,75,58,43,176,2018
2018_B33764,95,61,49,205,2018
2018_B33765,85,78,57,220,2018
2018_C33766,92,92,57,241,2018
2018_C33767,97,71,71,239,2018
2018_C33768,87,70,67,224,2018
2018_C33769,82,53,75,210,2018
2018_A33770,91,65,62,218,2018
2018_A33771,87,95,39,221,2018
2018_C33772,93,73,70,236,2018
2018_A33773,93,70,74,237,2018
2018_B33774,93,80,70,243,2018
2018_A33775,87,67,74,228,2018
2018_C33776,81,71,37,189,2018
2018_B33777,74,64,36,174,2018
2018_B33778,71,58,70,199,2018
2018_B33779,88,70,37,195,2018
2018_C33780,81,53,42,176,2018
2018_C33781,93,63,55,211,2018
2018_C33782,85,88,74,247,2018
2018_B33783,94,63,41,198,2018
2018_B33784,74,47,61,182,2018
2018_C33785,95,78,45,218,2018
2018_A33786,83,79,41,203,2018
2018_B33787,81,83,46,210,2018
2018_C33788,84,49,41,174,2018
2018_C33789,73,74,75,222,2018
2018_A33790,93,95,62,250,2018
2018_C33791,78,75,58,211,2018
2018_C33792,84,93,60,237,2018
2018_B33793,74,87,62,223,2018
2018_A33794,72,55,38,165,2018
2018_A33795,85,76,44,205,2018
2018_B33796,92,75,43,210,2018
2018_A33797,76,68,35,179,2018
2018_C33798,86,89,75,250,2018
2018_B33799,71,69,68,208,2018
2018_C33800,78,47,41,166,2018
2018_C33801,93,58,72,223,2018
2018_A33802,94,95,42,231,2018
2018_A33803,73,94,55,222,2018
2018_C33804,71,86,52,209,2018
2018_C33805,96,66,63,225,2018
2018_B33806,92,58,46,196,2018
2018_C33807,75,68,45,188,2018
2018_A33808,92,80,75,247,2018
2018_B33809,77,71,47,195,2018
2018_A33810,82,57,76,215,2018
2018_A33811,86,82,39,207,2018
2018_A33812,92,69,37,198,2018
2018_B33813,71,52,39,162,2018
2018_B33814,95,47,58,200,2018
2018_B33815,75,69,65,209,2018
2018_A33816,72,64,36,172,2018
2018_C33817,96,88,54,238,2018
2018_C33818,94,72,59,225,2018
2018_C33819,71,73,41,185,2018
2018_C33820,90,77,46,213,2018
2018_A33821,75,55,42,172,2018
2018_A33822,88,87,60,235,2018
2018_B33823,92,57,63,212,2018
2018_C33824,88,64,35,187,2018
2018_A33825,89,59,44,192,2018
2018_A33826,84,51,52,187,2018
2018_A33827,87,53,36,176,2018
2018_C33828,74,54,71,199,2018
2018_C33829,72,69,57,198,2018
2018_A33830,82,79,78,239,2018
2018_A33831,81,77,78,236,2018
2018_A33832,84,52,60,196,2018
2018_C33833,77,89,44,210,2018
2018_A33834,77,56,41,174,2018
2018_B33835,85,63,37,185,2018
2018_C33836,78,52,75,205,2018
2018_A33837,89,81,52,222,2018
2018_B33838,93,71,79,243,2018
2018_B33839,74,83,42,199,2018
2018_B33840,78,64,59,201,2018
2018_C33841,71,76,47,194,2018
2018_B33842,84,56,47,187,2018
2018_C33843,91,81,71,243,2018
2018_B33844,78,76,54,208,2018
2018_B33845,89,90,60,239,2018
2018_C33846,86,58,58,202,2018
2018_C33847,90,81,72,243,2018
2018_B33848,82,63,42,187,2018
2018_C33849,82,51,68,201,2018
2018_C33850,85,47,62,194,2018
2018_C33851,81,86,54,221,2018
2018_B33852,77,76,73,226,2018
2018_B33853,77,62,57,196,2018
2018_B33854,72,92,71,235,2018
2018_B33855,93,96,69,258,2018
2018_C33856,83,89,72,244,2018
2018_C33857,88,65,79,232,2018
2018_A33858,71,50,70,191,2018
2018_B33859,87,69,43,199,2018
2018_A33860,86,83,65,234,2018
2018_B33861,81,91,51,223,2018
2018_C33862,76,82,45,203,2018
2018_B33863,83,58,67,208,2018
2018_C33864,88,60,55,203,2018
2018_C33865,85,81,73,239,2018
2018_B33866,95,48,62,205,2018
2018_B33867,87,59,72,218,2018
2018_A33868,76,68,63,207,2018
2018_B33869,75,96,71,242,2018
2018_C33870,75,79,79,233,2018
2018_C33871,94,76,78,248,2018
2018_B33872,96,65,69,230,2018
2018_B33873,88,94,71,253,2018
2018_C33874,85,49,78,212,2018
2018_A33875,97,81,76,254,2018
2018_B33876,79,82,40,201,2018
2018_C33877,92,47,35,174,2018
2018_A33878,96,74,46,216,2018
2018_C33879,74,57,72,203,2018
2018_A33880,88,62,60,210,2018
2018_C33881,90,74,60,224,2018
2018_A33882,78,64,66,208,2018
2018_C33883,80,49,46,175,2018
2018_C33884,95,86,35,216,2018
2018_C33885,92,83,41,216,2018
2018_A33886,77,65,55,197,2018
2018_B33887,76,59,46,181,2018
2018_B33888,94,96,67,257,2018
2018_C33889,81,89,45,215,2018
2018_C33890,88,70,75,233,2018
2018_B33891,82,53,59,194,2018
2018_A33892,83,68,73,224,2018
2018_C33893,92,79,40,211,2018
2018_C33894,87,69,64,220,2018
2018_C33895,80,88,58,226,2018
2018_C33896,88,82,76,246,2018
2018_B33897,87,62,61,210,2018
2018_A33898,86,63,79,228,2018
2018_A33899,78,82,67,227,2018
2018_B33900,86,82,48,216,2018
2018_B33901,88,93,66,247,2018
2018_B33902,88,58,36,182,2018
2018_A33903,96,51,72,219,2018
2018_B33904,75,71,37,183,2018
2018_B33905,78,77,79,234,2018
2018_A33906,78,95,61,234,2018
2018_B33907,84,52,37,173,2018
2018_C33908,86,87,54,227,2018
2018_C33909,84,61,57,202,2018
2018_C33910,84,77,57,218,2018
2018_C33911,74,89,61,224,2018
2018_B33912,75,48,61,184,2018
2018_A33913,81,94,41,216,2018
2018_B33914,84,84,35,203,2018
2018_C33915,96,61,40,197,2018
2018_C33916,95,88,79,262,2018
2018_A33917,72,60,46,178,2018
2018_C33918,89,48,49,186,2018
2018_A33919,88,68,54,210,2018
2018_A33920,94,74,51,219,2018
2018_A33921,83,47,70,200,2018
2018_C33922,95,62,78,235,2018
2018_A33923,95,56,79,230,2018
2018_C33924,84,74,43,201,2018
2018_C33925,82,95,67,244,2018
2018_B33926,92,48,67,207,2018
2018_B33927,88,84,47,219,2018
2018_B33928,73,88,42,203,2018
2018_A33929,84,92,43,219,2018
2018_B33930,95,92,76,263,2018
2018_A33931,89,53,77,219,2018
2018_A33932,73,58,38,169,2018
2018_C33933,74,55,71,200,2018
2018_A33934,90,93,69,252,2018
2018_C33935,85,48,40,173,2018
2018_B33936,93,89,51,233,2018
2018_B33937,83,71,58,212,2018
2018_C33938,76,90,37,203,2018
2018_B33939,78,64,77,219,2018
2018_A33940,88,49,71,208,2018
2018_B33941,74,49,73,196,2018
2018_B33942,87,92,44,223,2018
2018_C33943,91,77,75,243,2018
2018_A33944,81,48,69,198,2018
2018_A33945,77,89,65,231,2018
2018_B33946,86,68,78,232,2018
2018_B33947,71,61,73,205,2018
2018_B33948,75,79,49,203,2018
2018_A33949,80,85,70,235,2018
2018_B33950,90,94,40,224,2018
2018_C33951,78,48,61,187,2018
2018_B33952,82,55,71,208,2018
2018_C33953,74,56,47,177,2018
2018_B33954,85,50,35,170,2018
2018_A33955,94,92,49,235,2018
2018_B33956,85,69,75,229,2018
2018_B33957,84,53,53,190,2018
2018_B33958,83,67,61,211,2018
2018_B33959,71,56,67,194,2018
2018_A33960,84,94,40,218,2018
2018_B33961,88,57,71,216,2018
2018_C33962,90,92,74,256,2018
2018_A33963,89,89,57,235,2018
2018_A33964,80,69,50,199,2018
2018_C33965,74,59,46,179,2018
2018_B33966,78,58,42,178,2018
2018_B33967,96,81,52,229,2018
2018_A33968,77,69,43,189,2018
2018_B33969,71,75,38,184,2018
2018_B33970,95,80,71,246,2018
2018_B33971,79,84,41,204,2018
2018_A33972,88,91,78,257,2018
2018_C33973,73,49,59,181,2018
2018_C33974,96,67,45,208,2018
2018_C33975,90,90,65,245,2018
2018_C33976,82,94,40,216,2018
2018_A33977,84,58,69,211,2018
2018_C33978,97,86,63,246,2018
2018_B33979,71,46,67,184,2018
2018_B33980,72,80,37,189,2018
2018_A33981,79,87,54,220,2018
2018_A33982,73,73,73,219,2018
2018_A33983,80,77,45,202,2018
2018_A33984,83,96,61,240,2018
2018_C33985,96,54,50,200,2018
2018_A33986,73,83,44,200,2018
2018_C33987,74,45,39,158,2018
2018_B33988,78,61,68,207,2018
2018_B33989,83,55,70,208,2018
2018_A33990,93,46,77,216,2018
2018_B33991,86,75,55,216,2018
2018_C33992,83,92,67,242,2018
2018_A33993,87,87,66,240,2018
2018_A33994,74,52,43,169,2018
2018_A33995,81,78,44,203,2018
2018_B33996,79,62,69,210,2018
2018_A33997,75,61,46,182,2018
2018_B33998,75,46,58,179,2018
2018_A33999,85,85,68,238,2018
2018_B34000,80,53,54,187,2018
2018_B34001,78,94,58,230,2018
2018_C34002,91,47,53,191,2018
2018_B34003,85,92,71,248,2018
2018_A34004,80,94,70,244,2018
2018_B34005,85,74,74,233,2018
2018_A34006,71,45,68,184,2018
2018_A34007,72,84,72,228,2018
2018_C34008,80,60,66,206,2018
2018_B34009,89,84,62,235,2018
2018_B34010,81,72,40,193,2018
2018_B34011,84,52,61,197,2018
2018_C34012,84,53,61,198,2018
2018_A34013,97,84,72,253,2018
2018_B34014,84,72,42,198,2018
2018_C34015,93,59,53,205,2018
2018_A34016,82,78,39,199,2018
2018_C34017,86,64,62,212,2018
2018_C34018,95,55,74,224,2018
2018_C34019,91,88,46,225,2018
2018_A34020,94,79,63,236,2018
2018_C34021,76,90,61,227,2018
2018_C34022,71,49,38,158,2018
2018_C34023,77,67,76,220,2018
2018_B34024,85,52,61,198,2018
2018_A34025,91,84,52,227,2018
2018_A34026,79,72,66,217,2018
2018_B34027,72,96,69,237,2018
2018_A34028,96,87,71,254,2018
2018_B34029,91,45,71,207,2018
2018_C34030,72,54,35,161,2018
2018_C34031,95,73,55,223,2018
2018_B34032,94,93,60,247,2018
2018_A34033,74,84,48,206,2018
2018_B34034,75,60,36,171,2018
2018_C34035,74,54,63,191,2018
2018_C34036,97,55,67,219,2018
2018_C34037,85,70,67,222,2018
2018_A34038,96,92,47,235,2018
2018_C34039,95,58,46,199,2018
2018_B34040,81,69,63,213,2018
2018_A34041,77,80,71,228,2018
2018_C34042,85,61,46,192,2018
2018_B34043,89,95,52,236,2018
2018_C34044,73,55,64,192,2018
2018_C34045,73,50,79,202,2018
2018_B34046,74,78,70,222,2018
2018_C34047,75,59,36,170,2018
2018_C34048,91,49,68,208,2018
2018_B34049,84,45,60,189,2018
2018_C34050,72,80,45,197,2018
2018_B34051,87,48,47,182,2018
2018_C34052,86,55,57,198,2018
2018_B34053,90,66,51,207,2018
2018_A34054,74,87,70,231,2018
2018_B34055,74,89,65,228,2018
2018_C34056,84,78,45,207,2018
2018_C34057,85,57,43,185,2018
2018_B34058,79,71,55,205,2018
2018_B34059,90,72,50,212,2018
2018_A34060,97,92,60,249,2018
2018_A34061,96,84,72,252,2018
2018_A34062,87,54,48,189,2018
2018_C34063,87,59,64,210,2018
2018_A34064,82,58,61,201,2018
2018_B34065,86,80,76,242,2018
2018_A34066,88,62,55,205,2018
2018_A34067,75,76,52,203,2018
2018_A34068,73,68,47,188,2018
2018_B34069,86,56,58,200,2018
2018_C34070,90,86,37,213,2018
2018_B34071,74,53,73,200,2018
2018_C34072,92,59,53,204,2018
2018_B34073,72,88,45,205,2018
2018_B34074,89,93,41,223,2018
2018_C34075,72,92,74,238,2018
2018_B34076,89,89,63,241,2018
2018_A34077,84,90,35,209,2018
2018_C34078,78,84,76,238,2018
2018_A34079,96,88,63,247,2018
2018_C34080,71,58,50,179,2018
2018_B34081,93,83,51,227,2018
2018_C34082,82,83,78,243,2018
2018_C34083,78,93,70,241,2018
2018_A34084,84,58,72,214,2018
2018_B34085,89,85,66,240,2018
2018_A34086,97,66,56,219,2018
2018_A34087,92,56,37,185,2018
2018_B34088,92,52,35,179,2018
2018_C34089,89,95,41,225,2018
2018_C34090,76,60,63,199,2018
2018_B34091,95,85,75,255,2018
2018_B34092,77,72,44,193,2018
2018_A34093,76,80,58,214,2018
2018_B34094,86,82,50,218,2018
2018_A34095,91,78,52,221,2018
2018_B34096,88,64,38,190,2018
2018_B34097,97,46,78,221,2018
2018_A34098,89,82,78,249,2018
2018_C34099,86,61,76,223,2018
2018_A34100,75,58,43,176,2018
2018_B34101,76,75,54,205,2018
2018_B34102,79,57,65,201,2018
2018_A34103,90,45,52,187,2018
2018_C34104,82,93,60,235,2018
2018_A34105,74,56,37,167,2018
2018_B34106,77,93,39,209,2018
2018_C34107,79,67,44,190,2018
2018_A34108,94,79,35,208,2018
2018_A34109,82,57,65,204,2018
2018_C34110,75,92,53,220,2018
2018_C34111,94,84,62,240,2018
2018_A34112,73,94,67,234,2018
2018_C34113,94,65,41,200,2018
2018_C34114,83,46,36,165,2018
2018_B34115,88,89,71,248,2018
2018_C34116,86,74,47,207,2018
2018_A34117,88,57,38,183,2018
2018_C34118,71,56,61,188,2018
2018_B34119,75,60,38,173,2018
2018_A34120,92,94,38,224,2018
2018_B34121,77,88,60,225,2018
2018_A34122,80,65,60,205,2018
2018_C34123,74,94,57,225,2018
2018_B34124,90,84,44,218,2018
2018_B34125,75,81,52,208,2018
2018_C34126,82,55,71,208,2018
2018_B34127,95,94,57,246,2018
2018_B34128,84,84,44,212,2018
2018_A34129,93,88,50,231,2018
2018_A34130,97,85,57,239,2018
2018_A34131,74,50,43,167,2018
2018_A34132,82,85,65,232,2018
2018_B34133,92,68,76,236,2018
2018_B34134,93,55,48,196,2018
2018_B34135,76,55,77,208,2018
2018_A34136,86,64,61,211,2018
2018_A34137,76,46,78,200,2018
2018_C34138,76,66,62,204,2018
2018_A34139,80,48,69,197,2018
2018_A34140,81,69,48,198,2018
2018_C34141,86,65,66,217,2018
2018_B34142,89,50,66,205,2018
2018_A34143,76,57,42,175,2018
2018_B34144,81,74,75,230,2018
2018_C34145,86,63,65,214,2018
2018_A34146,97,75,63,235,2018
2018_A34147,92,61,62,215,2018
2018_A34148,93,96,68,257,2018
2018_A34149,89,92,61,242,2018
2018_C34150,94,60,68,222,2018
2018_B34151,82,49,40,171,2018
2018_B34152,71,81,40,192,2018
2018_C34153,73,86,35,194,2018
2018_B34154,84,82,60,226,2018
2018_A34155,85,82,41,208,2018
2018_B34156,74,76,57,207,2018
2018_B34157,78,51,52,181,2018
2018_C34158,90,89,68,247,2018
2018_A34159,91,75,37,203,2018
2018_B34160,81,67,65,213,2018
2018_A34161,80,87,61,228,2018
2018_A34162,74,62,52,188,2018
2018_B34163,76,78,72,226,2018
2018_C34164,89,53,60,202,2018
2018_B34165,88,75,40,203,2018
2018_B34166,72,79,67,218,2018
2018_A34167,88,46,46,180,2018
2018_A34168,76,91,64,231,2018
2018_B34169,81,53,73,207,2018
2018_C34170,95,93,74,262,2018
2018_C34171,77,62,78,217,2018
2018_B34172,72,65,71,208,2018
2018_A34173,90,71,42,203,2018
2018_C34174,95,74,36,205,2018
2018_B34175,82,57,46,185,2018
2018_C34176,94,67,35,196,2018
2018_B34177,78,68,42,188,2018
2018_A34178,80,68,54,202,2018
2018_C34179,94,57,64,215,2018
2018_A34180,76,54,43,173,2018
2018_B34181,84,93,59,236,2018
2018_C34182,78,74,68,220,2018
2018_C34183,97,94,71,262,2018
2018_B34184,95,88,44,227,2018
2018_B34185,91,66,53,210,2018
2018_B34186,83,85,50,218,2018
2018_A34187,83,48,48,179,2018
2018_C34188,87,84,76,247,2018
2018_C34189,80,51,47,178,2018
2018_B34190,89,90,45,224,2018
2018_B34191,78,70,62,210,2018
2018_A34192,71,46,62,179,2018
2018_A34193,89,76,44,209,2018
2018_C34194,76,87,77,240,2018
2018_A34195,73,85,71,229,2018
2018_C34196,92,66,78,236,2018
2018_B34197,79,89,73,241,2018
2018_B34198,97,45,59,201,2018
2018_C34199,80,75,60,215,2018
2018_A34200,78,79,68,225,2018
2018_B34201,97,82,72,251,2018
2018_B34202,73,55,35,163,2018
2018_C34203,72,61,57,190,2018
2018_B34204,79,87,74,240,2018
2018_C34205,86,87,40,213,2018
2018_C34206,72,68,78,218,2018
2018_B34207,83,81,38,202,2018
2018_C34208,82,45,63,190,2018
2018_A34209,76,85,53,214,2018
2018_B34210,96,86,47,229,2018
2018_A34211,87,93,64,244,2018
2018_B34212,80,94,56,230,2018
2018_C34213,75,60,49,184,2018
2018_A34214,78,67,74,219,2018
2018_A34215,84,91,39,214,2018
2018_A34216,73,68,59,200,2018
2018_A34217,71,49,53,173,2018
2018_B34218,71,88,70,229,2018
2018_A34219,84,78,57,219,2018
2018_A34220,92,85,62,239,2018
2018_B34221,90,71,40,201,2018
2018_A34222,71,58,71,200,2018
2018_A34223,91,72,77,240,2018
2018_B34224,77,84,38,199,2018
2018_B34225,81,66,68,215,2018
2018_B34226,85,60,45,190,2018
2018_A34227,94,79,42,215,2018
2018_C34228,87,69,53,209,2018
2018_B34229,97,48,76,221,2018
2018_A34230,97,72,40,209,2018
2018_C34231,78,76,44,198,2018
2018_A34232,87,57,70,214,2018
2018_A34233,90,73,72,235,2018
2018_A34234,76,74,35,185,2018
2018_C34235,80,77,45,202,2018
2018_A34236,93,50,45,188,2018
2018_B34237,81,56,61,198,2018
2018_B34238,75,70,77,222,2018
2018_A34239,83,70,69,222,2018
2018_C34240,97,91,65,253,2018
2018_A34241,91,52,39,182,2018
2018_B34242,84,53,78,215,2018
2018_A34243,89,51,45,185,2018
2018_A34244,96,61,58,215,2018
2018_C34245,73,88,45,206,2018
2018_C34246,82,91,70,243,2018
2018_C34247,82,48,37,167,2018
2018_A34248,83,90,47,220,2018
2018_A34249,82,86,73,241,2018
2018_B34250,90,70,64,224,2018
2018_A34251,87,63,44,194,2018
